ID_KEC,nama_kota,nama_kecamatan,POSITIF,Dirawat,Sembuh,Meninggal,Self_Isolation,Kasus_Aktif,Tanggal
317506,JAKARTA TIMUR,CAKUNG,5131,105,4567,82,377,482,2021-01-01
317403,JAKARTA SELATAN,MAMPANG PRAPATAN,2562,51,2323,43,145,196,2021-01-01
317501,JAKARTA TIMUR,MATRAMAN,2766,62,2417,64,223,285,2021-01-01
317106,JAKARTA PUSAT,MENTENG,1543,33,1399,33,78,111,2021-01-01
317205,JAKARTA UTARA,PADEMANGAN,2117,40,1954,41,82,122,2021-01-01
317307,JAKARTA BARAT,PALMERAH,3562,89,3215,81,177,266,2021-01-01
317408,JAKARTA SELATAN,PANCORAN,2446,76,2156,40,174,250,2021-01-01
317404,JAKARTA SELATAN,PASAR MINGGU,4275,126,3693,80,376,502,2021-01-01
317505,JAKARTA TIMUR,PASAR REBO,2823,118,2485,43,177,295,2021-01-01
317201,JAKARTA UTARA,PENJARINGAN,3077,129,2702,58,188,317,2021-01-01
317410,JAKARTA SELATAN,PESANGGRAHAN,2873,82,2492,49,250,332,2021-01-01
317502,JAKARTA TIMUR,PULO GADUNG,3991,134,3535,75,247,381,2021-01-01
317102,JAKARTA PUSAT,SAWAH BESAR,1779,57,1622,40,60,117,2021-01-01
317104,JAKARTA PUSAT,SENEN,2145,66,1917,45,117,183,2021-01-01
317402,JAKARTA SELATAN,SETIA BUDI,2208,57,1996,40,115,172,2021-01-01
317303,JAKARTA BARAT,TAMAN SARI,1839,44,1677,29,89,133,2021-01-01
317304,JAKARTA BARAT,TAMBORA,2453,111,2186,64,92,203,2021-01-01
317107,JAKARTA PUSAT,TANAH ABANG,2942,84,2632,64,162,246,2021-01-01
317202,JAKARTA UTARA,TANJUNG PRIOK,5176,151,4611,99,315,466,2021-01-01
317401,JAKARTA SELATAN,TEBET,3276,74,2889,69,244,318,2021-01-01
317508,JAKARTA TIMUR,MAKASAR,3269,152,2858,53,206,358,2021-01-01
317504,JAKARTA TIMUR,KRAMAT JATI,3983,80,3543,81,279,359,2021-01-01
111111,Luar DKI & Proses Update,Luar DKI & Proses Update,143008,137,141294,1273,304,441,2021-01-01
310101,KAB.ADM.KEP.SERIBU,KEP. SERIBU UTARA,94,4,74,0,16,20,2021-01-01
317105,JAKARTA PUSAT,CEMPAKA PUTIH,2294,63,2055,38,138,201,2021-01-01
317301,JAKARTA BARAT,CENGKARENG,5837,227,5208,127,275,502,2021-01-01
317406,JAKARTA SELATAN,CILANDAK,3173,112,2790,49,222,334,2021-01-01
317204,JAKARTA UTARA,CILINCING,3761,59,3417,70,215,274,2021-01-01
317510,JAKARTA TIMUR,CIPAYUNG,3771,90,3040,40,601,691,2021-01-01
317509,JAKARTA TIMUR,CIRACAS,3456,109,2981,61,305,414,2021-01-01
317507,JAKARTA TIMUR,DUREN SAWIT,5473,138,4774,117,444,582,2021-01-01
317101,JAKARTA PUSAT,GAMBIR,1905,62,1712,34,97,159,2021-01-01
317302,JAKARTA BARAT,GROGOL PETAMBURAN,3361,159,2979,75,148,307,2021-01-01
317409,JAKARTA SELATAN,JAGAKARSA,3870,84,3369,61,356,440,2021-01-01
317203,JAKARTA UTARA,KOJA,4044,90,3651,77,226,316,2021-01-01
317108,JAKARTA PUSAT,JOHAR BARU,2082,42,1889,65,86,128,2021-01-01
317306,JAKARTA BARAT,KALI DERES,3177,114,2814,71,178,292,2021-01-01
317407,JAKARTA SELATAN,KEBAYORAN BARU,2427,70,2171,34,152,222,2021-01-01
317405,JAKARTA SELATAN,KEBAYORAN LAMA,3795,98,3402,73,222,320,2021-01-01
317305,JAKARTA BARAT,KEBON JERUK,4476,140,4003,94,239,379,2021-01-01
317206,JAKARTA UTARA,KELAPA GADING,2360,67,2116,42,135,202,2021-01-01
317103,JAKARTA PUSAT,KEMAYORAN,4129,103,3750,96,180,283,2021-01-01
317308,JAKARTA BARAT,KEMBANGAN,3563,117,3158,46,242,359,2021-01-01
310102,KAB.ADM.KEP.SERIBU,KEP. SERIBU SELATAN,77,0,67,1,9,9,2021-01-01
317503,JAKARTA TIMUR,JATINEGARA,4045,101,3659,63,222,323,2021-01-01
317505,JAKARTA TIMUR,PASAR REBO,2856,102,2523,43,188,290,2021-01-02
317404,JAKARTA SELATAN,PASAR MINGGU,4354,93,3778,80,403,496,2021-01-02
317408,JAKARTA SELATAN,PANCORAN,2497,65,2195,41,196,261,2021-01-02
317403,JAKARTA SELATAN,MAMPANG PRAPATAN,2609,42,2349,43,175,217,2021-01-02
317205,JAKARTA UTARA,PADEMANGAN,2130,35,1976,41,78,113,2021-01-02
317106,JAKARTA PUSAT,MENTENG,1561,25,1410,33,93,118,2021-01-02
317501,JAKARTA TIMUR,MATRAMAN,2789,52,2448,66,223,275,2021-01-02
317201,JAKARTA UTARA,PENJARINGAN,3105,117,2724,59,205,322,2021-01-02
317307,JAKARTA BARAT,PALMERAH,3601,83,3248,82,188,271,2021-01-02
317410,JAKARTA SELATAN,PESANGGRAHAN,2914,55,2540,49,270,325,2021-01-02
317303,JAKARTA BARAT,TAMAN SARI,1854,38,1686,29,101,139,2021-01-02
317102,JAKARTA PUSAT,SAWAH BESAR,1797,46,1637,40,74,120,2021-01-02
317104,JAKARTA PUSAT,SENEN,2171,43,1946,45,137,180,2021-01-02
317402,JAKARTA SELATAN,SETIA BUDI,2234,43,2033,40,118,161,2021-01-02
317304,JAKARTA BARAT,TAMBORA,2475,94,2209,64,108,202,2021-01-02
317107,JAKARTA PUSAT,TANAH ABANG,2959,59,2669,64,167,226,2021-01-02
317202,JAKARTA UTARA,TANJUNG PRIOK,5214,130,4655,99,330,460,2021-01-02
317401,JAKARTA SELATAN,TEBET,3321,50,2955,71,245,295,2021-01-02
111111,Luar DKI & Proses Update,Luar DKI & Proses Update,143008,137,141294,1273,304,441,2021-01-02
317508,JAKARTA TIMUR,MAKASAR,3349,132,2932,55,230,362,2021-01-02
317502,JAKARTA TIMUR,PULO GADUNG,4069,116,3603,76,274,390,2021-01-02
317504,JAKARTA TIMUR,KRAMAT JATI,4014,65,3605,82,262,327,2021-01-02
317203,JAKARTA UTARA,KOJA,4058,78,3705,77,198,276,2021-01-02
310101,KAB.ADM.KEP.SERIBU,KEP. SERIBU UTARA,96,4,74,0,18,22,2021-01-02
317105,JAKARTA PUSAT,CEMPAKA PUTIH,2342,44,2079,38,181,225,2021-01-02
317301,JAKARTA BARAT,CENGKARENG,5953,188,5267,130,368,556,2021-01-02
317406,JAKARTA SELATAN,CILANDAK,3228,55,2888,51,234,289,2021-01-02
317204,JAKARTA UTARA,CILINCING,3784,51,3431,71,231,282,2021-01-02
317510,JAKARTA TIMUR,CIPAYUNG,3799,73,3084,40,602,675,2021-01-02
317509,JAKARTA TIMUR,CIRACAS,3478,72,3050,61,295,367,2021-01-02
317507,JAKARTA TIMUR,DUREN SAWIT,5556,105,4867,119,465,570,2021-01-02
317101,JAKARTA PUSAT,GAMBIR,1919,44,1736,34,105,149,2021-01-02
317302,JAKARTA BARAT,GROGOL PETAMBURAN,3412,145,3006,75,186,331,2021-01-02
317409,JAKARTA SELATAN,JAGAKARSA,3948,63,3459,61,365,428,2021-01-02
317506,JAKARTA TIMUR,CAKUNG,5159,91,4605,82,381,472,2021-01-02
317108,JAKARTA PUSAT,JOHAR BARU,2091,25,1911,65,90,115,2021-01-02
317306,JAKARTA BARAT,KALI DERES,3230,88,2872,71,199,287,2021-01-02
317407,JAKARTA SELATAN,KEBAYORAN BARU,2453,45,2221,35,152,197,2021-01-02
317405,JAKARTA SELATAN,KEBAYORAN LAMA,3836,76,3460,73,227,303,2021-01-02
317305,JAKARTA BARAT,KEBON JERUK,4509,117,4040,94,258,375,2021-01-02
317206,JAKARTA UTARA,KELAPA GADING,2372,64,2136,44,128,192,2021-01-02
317103,JAKARTA PUSAT,KEMAYORAN,4144,78,3787,97,182,260,2021-01-02
317308,JAKARTA BARAT,KEMBANGAN,3622,90,3200,46,286,376,2021-01-02
310102,KAB.ADM.KEP.SERIBU,KEP. SERIBU SELATAN,77,0,67,1,9,9,2021-01-02
317503,JAKARTA TIMUR,JATINEGARA,4076,82,3703,63,228,310,2021-01-02
317404,JAKARTA SELATAN,PASAR MINGGU,4389,92,3828,80,389,481,2021-01-03
317408,JAKARTA SELATAN,PANCORAN,2533,63,2216,41,213,276,2021-01-03
317307,JAKARTA BARAT,PALMERAH,3621,82,3272,82,185,267,2021-01-03
317403,JAKARTA SELATAN,MAMPANG PRAPATAN,2633,39,2369,43,182,221,2021-01-03
317106,JAKARTA PUSAT,MENTENG,1573,26,1432,33,82,108,2021-01-03
317501,JAKARTA TIMUR,MATRAMAN,2806,49,2465,66,226,275,2021-01-03
317505,JAKARTA TIMUR,PASAR REBO,2882,91,2580,44,167,258,2021-01-03
317205,JAKARTA UTARA,PADEMANGAN,2155,37,1999,41,78,115,2021-01-03
317201,JAKARTA UTARA,PENJARINGAN,3146,121,2765,59,201,322,2021-01-03
317402,JAKARTA SELATAN,SETIA BUDI,2265,43,2043,40,139,182,2021-01-03
317502,JAKARTA TIMUR,PULO GADUNG,4111,111,3638,77,285,396,2021-01-03
317102,JAKARTA PUSAT,SAWAH BESAR,1818,48,1660,40,70,118,2021-01-03
317104,JAKARTA PUSAT,SENEN,2178,34,1998,46,100,134,2021-01-03
317303,JAKARTA BARAT,TAMAN SARI,1862,38,1699,29,96,134,2021-01-03
317304,JAKARTA BARAT,TAMBORA,2502,88,2243,64,107,195,2021-01-03
317107,JAKARTA PUSAT,TANAH ABANG,2977,57,2713,64,143,200,2021-01-03
317202,JAKARTA UTARA,TANJUNG PRIOK,5292,115,4715,99,363,478,2021-01-03
317401,JAKARTA SELATAN,TEBET,3369,65,2981,72,251,316,2021-01-03
317508,JAKARTA TIMUR,MAKASAR,3378,120,2957,55,246,366,2021-01-03
317410,JAKARTA SELATAN,PESANGGRAHAN,2979,52,2602,50,275,327,2021-01-03
317504,JAKARTA TIMUR,KRAMAT JATI,4051,59,3672,82,238,297,2021-01-03
111111,Luar DKI & Proses Update,Luar DKI & Proses Update,143008,137,141294,1273,304,441,2021-01-03
310101,KAB.ADM.KEP.SERIBU,KEP. SERIBU UTARA,98,4,74,0,20,24,2021-01-03
317506,JAKARTA TIMUR,CAKUNG,5293,87,4668,82,456,543,2021-01-03
317203,JAKARTA UTARA,KOJA,4086,71,3736,77,202,273,2021-01-03
317301,JAKARTA BARAT,CENGKARENG,6014,175,5315,130,394,569,2021-01-03
317406,JAKARTA SELATAN,CILANDAK,3264,53,2898,51,262,315,2021-01-03
317204,JAKARTA UTARA,CILINCING,3846,47,3484,71,244,291,2021-01-03
317510,JAKARTA TIMUR,CIPAYUNG,3866,72,3147,40,607,679,2021-01-03
317509,JAKARTA TIMUR,CIRACAS,3518,67,3087,61,303,370,2021-01-03
317507,JAKARTA TIMUR,DUREN SAWIT,5650,98,4932,120,500,598,2021-01-03
317101,JAKARTA PUSAT,GAMBIR,1927,41,1763,34,89,130,2021-01-03
317302,JAKARTA BARAT,GROGOL PETAMBURAN,3433,128,3036,75,194,322,2021-01-03
317105,JAKARTA PUSAT,CEMPAKA PUTIH,2360,41,2132,38,149,190,2021-01-03
317503,JAKARTA TIMUR,JATINEGARA,4133,82,3726,63,262,344,2021-01-03
317108,JAKARTA PUSAT,JOHAR BARU,2097,18,1924,65,90,108,2021-01-03
317306,JAKARTA BARAT,KALI DERES,3263,79,2923,72,189,268,2021-01-03
317407,JAKARTA SELATAN,KEBAYORAN BARU,2509,39,2239,35,196,235,2021-01-03
317405,JAKARTA SELATAN,KEBAYORAN LAMA,3910,78,3480,73,279,357,2021-01-03
317305,JAKARTA BARAT,KEBON JERUK,4558,111,4083,95,269,380,2021-01-03
317206,JAKARTA UTARA,KELAPA GADING,2417,61,2159,44,153,214,2021-01-03
317103,JAKARTA PUSAT,KEMAYORAN,4162,69,3834,98,161,230,2021-01-03
317308,JAKARTA BARAT,KEMBANGAN,3682,87,3257,46,292,379,2021-01-03
310102,KAB.ADM.KEP.SERIBU,KEP. SERIBU SELATAN,78,0,71,1,6,6,2021-01-03
317409,JAKARTA SELATAN,JAGAKARSA,4028,63,3497,61,407,470,2021-01-03
317505,JAKARTA TIMUR,PASAR REBO,2918,83,2612,46,177,260,2021-01-04
317404,JAKARTA SELATAN,PASAR MINGGU,4445,86,3897,80,382,468,2021-01-04
317408,JAKARTA SELATAN,PANCORAN,2582,65,2246,42,229,294,2021-01-04
317501,JAKARTA TIMUR,MATRAMAN,2836,52,2543,66,175,227,2021-01-04
317205,JAKARTA UTARA,PADEMANGAN,2177,42,2005,41,89,131,2021-01-04
317106,JAKARTA PUSAT,MENTENG,1616,21,1457,33,105,126,2021-01-04
317201,JAKARTA UTARA,PENJARINGAN,3174,120,2796,59,199,319,2021-01-04
317307,JAKARTA BARAT,PALMERAH,3675,92,3293,82,208,300,2021-01-04
317410,JAKARTA SELATAN,PESANGGRAHAN,3029,53,2652,50,274,327,2021-01-04
317304,JAKARTA BARAT,TAMBORA,2527,94,2255,64,114,208,2021-01-04
317102,JAKARTA PUSAT,SAWAH BESAR,1846,50,1676,40,80,130,2021-01-04
317104,JAKARTA PUSAT,SENEN,2222,33,2025,46,118,151,2021-01-04
317402,JAKARTA SELATAN,SETIA BUDI,2277,40,2083,40,114,154,2021-01-04
317303,JAKARTA BARAT,TAMAN SARI,1875,41,1709,29,96,137,2021-01-04
317107,JAKARTA PUSAT,TANAH ABANG,3003,55,2771,64,113,168,2021-01-04
317202,JAKARTA UTARA,TANJUNG PRIOK,5348,116,4769,99,364,480,2021-01-04
317401,JAKARTA SELATAN,TEBET,3423,69,3035,72,247,316,2021-01-04
111111,Luar DKI & Proses Update,Luar DKI & Proses Update,143008,137,141294,1273,304,441,2021-01-04
317403,JAKARTA SELATAN,MAMPANG PRAPATAN,2654,30,2409,43,172,202,2021-01-04
317502,JAKARTA TIMUR,PULO GADUNG,4179,98,3683,79,319,417,2021-01-04
317508,JAKARTA TIMUR,MAKASAR,3437,109,3027,55,246,355,2021-01-04
317504,JAKARTA TIMUR,KRAMAT JATI,4091,62,3757,82,190,252,2021-01-04
317203,JAKARTA UTARA,KOJA,4114,69,3757,77,211,280,2021-01-04
317506,JAKARTA TIMUR,CAKUNG,5340,90,4744,82,424,514,2021-01-04
317105,JAKARTA PUSAT,CEMPAKA PUTIH,2377,39,2164,38,136,175,2021-01-04
317406,JAKARTA SELATAN,CILANDAK,3309,53,2984,51,221,274,2021-01-04
317204,JAKARTA UTARA,CILINCING,3862,42,3497,71,252,294,2021-01-04
317510,JAKARTA TIMUR,CIPAYUNG,3904,70,3234,40,560,630,2021-01-04
317509,JAKARTA TIMUR,CIRACAS,3567,73,3164,62,268,341,2021-01-04
317507,JAKARTA TIMUR,DUREN SAWIT,5713,105,4995,122,491,596,2021-01-04
317101,JAKARTA PUSAT,GAMBIR,1960,44,1779,35,102,146,2021-01-04
317302,JAKARTA BARAT,GROGOL PETAMBURAN,3486,140,3081,75,190,330,2021-01-04
317409,JAKARTA SELATAN,JAGAKARSA,4072,59,3568,62,383,442,2021-01-04
317301,JAKARTA BARAT,CENGKARENG,6036,142,5390,133,371,513,2021-01-04
317108,JAKARTA PUSAT,JOHAR BARU,2109,16,1941,65,87,103,2021-01-04
317306,JAKARTA BARAT,KALI DERES,3280,65,2952,75,188,253,2021-01-04
317407,JAKARTA SELATAN,KEBAYORAN BARU,2555,46,2300,35,174,220,2021-01-04
317405,JAKARTA SELATAN,KEBAYORAN LAMA,3966,68,3547,73,278,346,2021-01-04
317305,JAKARTA BARAT,KEBON JERUK,4624,115,4163,95,251,366,2021-01-04
317206,JAKARTA UTARA,KELAPA GADING,2439,61,2189,44,145,206,2021-01-04
317103,JAKARTA PUSAT,KEMAYORAN,4232,64,3886,99,183,247,2021-01-04
317308,JAKARTA BARAT,KEMBANGAN,3725,78,3315,47,285,363,2021-01-04
310102,KAB.ADM.KEP.SERIBU,KEP. SERIBU SELATAN,78,0,73,1,4,4,2021-01-04
310101,KAB.ADM.KEP.SERIBU,KEP. SERIBU UTARA,101,4,75,0,22,26,2021-01-04
317503,JAKARTA TIMUR,JATINEGARA,4180,82,3765,64,269,351,2021-01-04
317201,JAKARTA UTARA,PENJARINGAN,3205,122,2809,59,215,337,2021-01-05
317505,JAKARTA TIMUR,PASAR REBO,2935,83,2640,46,166,249,2021-01-05
317404,JAKARTA SELATAN,PASAR MINGGU,4514,87,3928,82,417,504,2021-01-05
317205,JAKARTA UTARA,PADEMANGAN,2203,46,2015,41,101,147,2021-01-05
317307,JAKARTA BARAT,PALMERAH,3704,98,3294,83,229,327,2021-01-05
317410,JAKARTA SELATAN,PESANGGRAHAN,3044,58,2663,50,273,331,2021-01-05
317106,JAKARTA PUSAT,MENTENG,1622,23,1459,33,107,130,2021-01-05
317408,JAKARTA SELATAN,PANCORAN,2595,66,2255,42,232,298,2021-01-05
317502,JAKARTA TIMUR,PULO GADUNG,4263,101,3707,79,376,477,2021-01-05
317304,JAKARTA BARAT,TAMBORA,2569,94,2268,64,143,237,2021-01-05
317104,JAKARTA PUSAT,SENEN,2227,34,2028,46,119,153,2021-01-05
317402,JAKARTA SELATAN,SETIA BUDI,2318,43,2096,41,138,181,2021-01-05
317303,JAKARTA BARAT,TAMAN SARI,1894,45,1712,29,108,153,2021-01-05
317107,JAKARTA PUSAT,TANAH ABANG,3014,56,2774,64,120,176,2021-01-05
317202,JAKARTA UTARA,TANJUNG PRIOK,5394,122,4812,100,360,482,2021-01-05
317401,JAKARTA SELATAN,TEBET,3467,70,3042,72,283,353,2021-01-05
317501,JAKARTA TIMUR,MATRAMAN,2890,55,2555,66,214,269,2021-01-05
111111,Luar DKI & Proses Update,Luar DKI & Proses Update,143008,137,141294,1273,304,441,2021-01-05
317102,JAKARTA PUSAT,SAWAH BESAR,1859,50,1686,40,83,133,2021-01-05
317403,JAKARTA SELATAN,MAMPANG PRAPATAN,2680,34,2418,44,184,218,2021-01-05
317508,JAKARTA TIMUR,MAKASAR,3491,119,3097,55,220,339,2021-01-05
317504,JAKARTA TIMUR,KRAMAT JATI,4112,60,3773,82,197,257,2021-01-05
317204,JAKARTA UTARA,CILINCING,3879,44,3550,73,212,256,2021-01-05
317406,JAKARTA SELATAN,CILANDAK,3331,54,3004,51,222,276,2021-01-05
317301,JAKARTA BARAT,CENGKARENG,6114,152,5398,135,429,581,2021-01-05
317506,JAKARTA TIMUR,CAKUNG,5386,92,4765,82,447,539,2021-01-05
317510,JAKARTA TIMUR,CIPAYUNG,3959,78,3430,41,410,488,2021-01-05
317509,JAKARTA TIMUR,CIRACAS,3627,76,3227,64,260,336,2021-01-05
317507,JAKARTA TIMUR,DUREN SAWIT,5804,110,5045,123,526,636,2021-01-05
317101,JAKARTA PUSAT,GAMBIR,1962,43,1781,36,102,145,2021-01-05
317302,JAKARTA BARAT,GROGOL PETAMBURAN,3530,145,3088,76,221,366,2021-01-05
317409,JAKARTA SELATAN,JAGAKARSA,4100,64,3587,64,385,449,2021-01-05
317503,JAKARTA TIMUR,JATINEGARA,4196,86,3775,65,270,356,2021-01-05
317105,JAKARTA PUSAT,CEMPAKA PUTIH,2386,41,2168,38,139,180,2021-01-05
317306,JAKARTA BARAT,KALI DERES,3324,67,2960,76,221,288,2021-01-05
317108,JAKARTA PUSAT,JOHAR BARU,2120,22,1946,65,87,109,2021-01-05
317203,JAKARTA UTARA,KOJA,4152,70,3842,77,163,233,2021-01-05
310101,KAB.ADM.KEP.SERIBU,KEP. SERIBU UTARA,103,4,76,0,23,27,2021-01-05
317308,JAKARTA BARAT,KEMBANGAN,3777,94,3321,49,313,407,2021-01-05
310102,KAB.ADM.KEP.SERIBU,KEP. SERIBU SELATAN,82,0,73,1,8,8,2021-01-05
317206,JAKARTA UTARA,KELAPA GADING,2471,68,2202,44,157,225,2021-01-05
317305,JAKARTA BARAT,KEBON JERUK,4688,127,4178,95,288,415,2021-01-05
317405,JAKARTA SELATAN,KEBAYORAN LAMA,4002,72,3564,73,293,365,2021-01-05
317407,JAKARTA SELATAN,KEBAYORAN BARU,2590,48,2308,35,199,247,2021-01-05
317103,JAKARTA PUSAT,KEMAYORAN,4271,66,3903,99,203,269,2021-01-05
317106,JAKARTA PUSAT,MENTENG,1641,23,1474,33,111,134,2021-01-06
317205,JAKARTA UTARA,PADEMANGAN,2235,44,2021,41,129,173,2021-01-06
317410,JAKARTA SELATAN,PESANGGRAHAN,3069,57,2686,50,276,333,2021-01-06
317307,JAKARTA BARAT,PALMERAH,3752,96,3337,85,234,330,2021-01-06
317408,JAKARTA SELATAN,PANCORAN,2623,67,2287,42,227,294,2021-01-06
317404,JAKARTA SELATAN,PASAR MINGGU,4544,84,3978,82,400,484,2021-01-06
317505,JAKARTA TIMUR,PASAR REBO,2962,81,2652,46,183,264,2021-01-06
317201,JAKARTA UTARA,PENJARINGAN,3232,121,2833,60,218,339,2021-01-06
317502,JAKARTA TIMUR,PULO GADUNG,4303,100,3739,79,385,485,2021-01-06
317304,JAKARTA BARAT,TAMBORA,2598,92,2271,64,171,263,2021-01-06
317104,JAKARTA PUSAT,SENEN,2258,32,2041,46,139,171,2021-01-06
317402,JAKARTA SELATAN,SETIA BUDI,2345,42,2103,41,159,201,2021-01-06
317303,JAKARTA BARAT,TAMAN SARI,1905,47,1718,30,110,157,2021-01-06
317107,JAKARTA PUSAT,TANAH ABANG,3082,58,2798,64,162,220,2021-01-06
317202,JAKARTA UTARA,TANJUNG PRIOK,5433,119,4885,101,328,447,2021-01-06
317401,JAKARTA SELATAN,TEBET,3523,69,3076,73,305,374,2021-01-06
317501,JAKARTA TIMUR,MATRAMAN,2940,57,2561,66,256,313,2021-01-06
111111,Luar DKI & Proses Update,Luar DKI & Proses Update,143008,137,141294,1273,304,441,2021-01-06
317102,JAKARTA PUSAT,SAWAH BESAR,1889,50,1687,40,112,162,2021-01-06
317403,JAKARTA SELATAN,MAMPANG PRAPATAN,2727,38,2446,44,199,237,2021-01-06
317508,JAKARTA TIMUR,MAKASAR,3566,119,3105,56,286,405,2021-01-06
317504,JAKARTA TIMUR,KRAMAT JATI,4165,63,3787,84,231,294,2021-01-06
317506,JAKARTA TIMUR,CAKUNG,5446,92,4795,83,476,568,2021-01-06
317105,JAKARTA PUSAT,CEMPAKA PUTIH,2427,43,2187,38,159,202,2021-01-06
317406,JAKARTA SELATAN,CILANDAK,3357,55,3034,52,216,271,2021-01-06
317204,JAKARTA UTARA,CILINCING,3919,46,3575,74,224,270,2021-01-06
317510,JAKARTA TIMUR,CIPAYUNG,3998,80,3441,41,436,516,2021-01-06
317509,JAKARTA TIMUR,CIRACAS,3730,74,3249,65,342,416,2021-01-06
317507,JAKARTA TIMUR,DUREN SAWIT,5864,106,5080,123,555,661,2021-01-06
317101,JAKARTA PUSAT,GAMBIR,1985,45,1803,36,101,146,2021-01-06
317302,JAKARTA BARAT,GROGOL PETAMBURAN,3566,137,3102,76,251,388,2021-01-06
317409,JAKARTA SELATAN,JAGAKARSA,4164,63,3652,65,384,447,2021-01-06
317503,JAKARTA TIMUR,JATINEGARA,4331,83,3831,65,352,435,2021-01-06
317301,JAKARTA BARAT,CENGKARENG,6191,142,5427,135,487,629,2021-01-06
317306,JAKARTA BARAT,KALI DERES,3362,61,2996,76,229,290,2021-01-06
317407,JAKARTA SELATAN,KEBAYORAN BARU,2652,46,2328,35,243,289,2021-01-06
317405,JAKARTA SELATAN,KEBAYORAN LAMA,4082,69,3599,74,340,409,2021-01-06
317305,JAKARTA BARAT,KEBON JERUK,4738,126,4215,95,302,428,2021-01-06
317206,JAKARTA UTARA,KELAPA GADING,2534,70,2216,45,203,273,2021-01-06
317103,JAKARTA PUSAT,KEMAYORAN,4341,65,3934,99,243,308,2021-01-06
317308,JAKARTA BARAT,KEMBANGAN,3853,86,3338,51,378,464,2021-01-06
310102,KAB.ADM.KEP.SERIBU,KEP. SERIBU SELATAN,82,0,75,1,6,6,2021-01-06
310101,KAB.ADM.KEP.SERIBU,KEP. SERIBU UTARA,111,4,80,0,27,31,2021-01-06
317203,JAKARTA UTARA,KOJA,4182,68,3864,77,173,241,2021-01-06
317108,JAKARTA PUSAT,JOHAR BARU,2151,24,1971,65,91,115,2021-01-06
317201,JAKARTA UTARA,PENJARINGAN,3264,117,2877,60,210,327,2021-01-07
317505,JAKARTA TIMUR,PASAR REBO,3020,95,2685,46,194,289,2021-01-07
317307,JAKARTA BARAT,PALMERAH,3827,109,3353,85,280,389,2021-01-07
317408,JAKARTA SELATAN,PANCORAN,2692,81,2304,42,265,346,2021-01-07
317410,JAKARTA SELATAN,PESANGGRAHAN,3124,75,2693,50,306,381,2021-01-07
317205,JAKARTA UTARA,PADEMANGAN,2264,48,2034,41,141,189,2021-01-07
317404,JAKARTA SELATAN,PASAR MINGGU,4600,102,4008,84,406,508,2021-01-07
317502,JAKARTA TIMUR,PULO GADUNG,4343,113,3777,80,373,486,2021-01-07
317107,JAKARTA PUSAT,TANAH ABANG,3099,68,2801,65,165,233,2021-01-07
317104,JAKARTA PUSAT,SENEN,2276,46,2058,46,126,172,2021-01-07
317402,JAKARTA SELATAN,SETIA BUDI,2375,68,2110,41,156,224,2021-01-07
317303,JAKARTA BARAT,TAMAN SARI,1914,54,1723,31,106,160,2021-01-07
317304,JAKARTA BARAT,TAMBORA,2637,95,2288,64,190,285,2021-01-07
317202,JAKARTA UTARA,TANJUNG PRIOK,5473,119,4940,103,311,430,2021-01-07
317401,JAKARTA SELATAN,TEBET,3545,82,3087,73,303,385,2021-01-07
111111,Luar DKI & Proses Update,Luar DKI & Proses Update,143008,137,141294,1273,304,441,2021-01-07
317106,JAKARTA PUSAT,MENTENG,1649,24,1478,33,114,138,2021-01-07
317102,JAKARTA PUSAT,SAWAH BESAR,1908,50,1695,41,122,172,2021-01-07
317501,JAKARTA TIMUR,MATRAMAN,2973,69,2571,67,266,335,2021-01-07
317406,JAKARTA SELATAN,CILANDAK,3439,75,3042,52,270,345,2021-01-07
317508,JAKARTA TIMUR,MAKASAR,3640,173,3127,57,283,456,2021-01-07
317506,JAKARTA TIMUR,CAKUNG,5586,98,4908,84,496,594,2021-01-07
317105,JAKARTA PUSAT,CEMPAKA PUTIH,2439,48,2194,39,158,206,2021-01-07
317301,JAKARTA BARAT,CENGKARENG,6317,168,5498,136,515,683,2021-01-07
317403,JAKARTA SELATAN,MAMPANG PRAPATAN,2756,40,2466,44,206,246,2021-01-07
317204,JAKARTA UTARA,CILINCING,3935,51,3620,74,190,241,2021-01-07
317510,JAKARTA TIMUR,CIPAYUNG,4116,110,3460,41,505,615,2021-01-07
317509,JAKARTA TIMUR,CIRACAS,3819,101,3298,66,354,455,2021-01-07
317507,JAKARTA TIMUR,DUREN SAWIT,5906,118,5115,123,550,668,2021-01-07
317302,JAKARTA BARAT,GROGOL PETAMBURAN,3626,153,3123,76,274,427,2021-01-07
317409,JAKARTA SELATAN,JAGAKARSA,4255,89,3666,65,435,524,2021-01-07
317503,JAKARTA TIMUR,JATINEGARA,4368,96,3846,65,361,457,2021-01-07
317101,JAKARTA PUSAT,GAMBIR,2004,54,1813,36,101,155,2021-01-07
317306,JAKARTA BARAT,KALI DERES,3415,70,3031,76,238,308,2021-01-07
317504,JAKARTA TIMUR,KRAMAT JATI,4262,90,3799,84,289,379,2021-01-07
317203,JAKARTA UTARA,KOJA,4217,67,3910,77,163,230,2021-01-07
310101,KAB.ADM.KEP.SERIBU,KEP. SERIBU UTARA,111,2,89,0,20,22,2021-01-07
317108,JAKARTA PUSAT,JOHAR BARU,2163,32,1974,67,90,122,2021-01-07
317308,JAKARTA BARAT,KEMBANGAN,3947,108,3352,52,435,543,2021-01-07
310102,KAB.ADM.KEP.SERIBU,KEP. SERIBU SELATAN,91,0,76,1,14,14,2021-01-07
317206,JAKARTA UTARA,KELAPA GADING,2597,90,2243,45,219,309,2021-01-07
317305,JAKARTA BARAT,KEBON JERUK,4820,140,4227,95,358,498,2021-01-07
317405,JAKARTA SELATAN,KEBAYORAN LAMA,4126,81,3622,74,349,430,2021-01-07
317407,JAKARTA SELATAN,KEBAYORAN BARU,2693,66,2330,37,260,326,2021-01-07
317103,JAKARTA PUSAT,KEMAYORAN,4368,76,3939,99,254,330,2021-01-07
317205,JAKARTA UTARA,PADEMANGAN,2295,35,2058,41,161,196,2021-01-08
317410,JAKARTA SELATAN,PESANGGRAHAN,3169,55,2729,50,335,390,2021-01-08
317307,JAKARTA BARAT,PALMERAH,3882,110,3410,86,276,386,2021-01-08
317408,JAKARTA SELATAN,PANCORAN,2736,80,2331,42,283,363,2021-01-08
317404,JAKARTA SELATAN,PASAR MINGGU,4661,81,4054,85,441,522,2021-01-08
317505,JAKARTA TIMUR,PASAR REBO,3116,73,2738,46,259,332,2021-01-08
317201,JAKARTA UTARA,PENJARINGAN,3332,114,2932,60,226,340,2021-01-08
317502,JAKARTA TIMUR,PULO GADUNG,4413,95,3870,81,367,462,2021-01-08
111111,Luar DKI & Proses Update,Luar DKI & Proses Update,143008,137,141294,1273,304,441,2021-01-08
317104,JAKARTA PUSAT,SENEN,2294,43,2081,46,124,167,2021-01-08
317402,JAKARTA SELATAN,SETIA BUDI,2412,76,2133,41,162,238,2021-01-08
317303,JAKARTA BARAT,TAMAN SARI,1939,55,1744,31,109,164,2021-01-08
317304,JAKARTA BARAT,TAMBORA,2677,92,2329,65,191,283,2021-01-08
317107,JAKARTA PUSAT,TANAH ABANG,3142,50,2835,65,192,242,2021-01-08
317202,JAKARTA UTARA,TANJUNG PRIOK,5552,88,5000,104,360,448,2021-01-08
317401,JAKARTA SELATAN,TEBET,3576,68,3119,74,315,383,2021-01-08
317106,JAKARTA PUSAT,MENTENG,1658,18,1492,33,115,133,2021-01-08
317102,JAKARTA PUSAT,SAWAH BESAR,1938,41,1726,41,130,171,2021-01-08
317501,JAKARTA TIMUR,MATRAMAN,2995,56,2664,68,207,263,2021-01-08
317403,JAKARTA SELATAN,MAMPANG PRAPATAN,2778,30,2489,46,213,243,2021-01-08
317508,JAKARTA TIMUR,MAKASAR,3683,153,3176,58,296,449,2021-01-08
317506,JAKARTA TIMUR,CAKUNG,5654,92,4998,85,479,571,2021-01-08
317105,JAKARTA PUSAT,CEMPAKA PUTIH,2473,40,2212,39,182,222,2021-01-08
317301,JAKARTA BARAT,CENGKARENG,6394,154,5620,136,484,638,2021-01-08
317406,JAKARTA SELATAN,CILANDAK,3489,67,3075,53,294,361,2021-01-08
317510,JAKARTA TIMUR,CIPAYUNG,4216,83,3671,42,420,503,2021-01-08
317509,JAKARTA TIMUR,CIRACAS,3853,78,3341,67,367,445,2021-01-08
317507,JAKARTA TIMUR,DUREN SAWIT,6003,87,5175,127,614,701,2021-01-08
317101,JAKARTA PUSAT,GAMBIR,2030,39,1847,36,108,147,2021-01-08
317302,JAKARTA BARAT,GROGOL PETAMBURAN,3677,120,3215,76,266,386,2021-01-08
317409,JAKARTA SELATAN,JAGAKARSA,4347,101,3697,67,482,583,2021-01-08
317503,JAKARTA TIMUR,JATINEGARA,4410,73,3893,66,378,451,2021-01-08
317204,JAKARTA UTARA,CILINCING,3991,36,3667,76,212,248,2021-01-08
317306,JAKARTA BARAT,KALI DERES,3468,89,3059,76,244,333,2021-01-08
317108,JAKARTA PUSAT,JOHAR BARU,2175,37,1991,67,80,117,2021-01-08
317504,JAKARTA TIMUR,KRAMAT JATI,4324,78,3857,85,304,382,2021-01-08
317203,JAKARTA UTARA,KOJA,4294,61,3944,78,211,272,2021-01-08
310101,KAB.ADM.KEP.SERIBU,KEP. SERIBU UTARA,121,0,92,0,29,29,2021-01-08
317308,JAKARTA BARAT,KEMBANGAN,4016,101,3423,52,440,541,2021-01-08
310102,KAB.ADM.KEP.SERIBU,KEP. SERIBU SELATAN,93,0,76,1,16,16,2021-01-08
317206,JAKARTA UTARA,KELAPA GADING,2653,75,2296,45,237,312,2021-01-08
317305,JAKARTA BARAT,KEBON JERUK,4889,156,4279,95,359,515,2021-01-08
317405,JAKARTA SELATAN,KEBAYORAN LAMA,4249,91,3654,74,430,521,2021-01-08
317407,JAKARTA SELATAN,KEBAYORAN BARU,2728,56,2355,37,280,336,2021-01-08
317103,JAKARTA PUSAT,KEMAYORAN,4423,58,3984,99,282,340,2021-01-08
317307,JAKARTA BARAT,PALMERAH,3934,140,3472,87,235,375,2021-01-09
317408,JAKARTA SELATAN,PANCORAN,2768,88,2386,43,251,339,2021-01-09
317502,JAKARTA TIMUR,PULO GADUNG,4489,140,3900,82,367,507,2021-01-09
317404,JAKARTA SELATAN,PASAR MINGGU,4753,133,4177,85,358,491,2021-01-09
317505,JAKARTA TIMUR,PASAR REBO,3225,160,2766,47,252,412,2021-01-09
317201,JAKARTA UTARA,PENJARINGAN,3365,119,2990,61,195,314,2021-01-09
317410,JAKARTA SELATAN,PESANGGRAHAN,3230,92,2814,50,274,366,2021-01-09
317102,JAKARTA PUSAT,SAWAH BESAR,1963,56,1733,42,132,188,2021-01-09
317202,JAKARTA UTARA,TANJUNG PRIOK,5638,140,5053,105,340,480,2021-01-09
317402,JAKARTA SELATAN,SETIA BUDI,2452,102,2158,41,151,253,2021-01-09
317303,JAKARTA BARAT,TAMAN SARI,1959,54,1799,31,75,129,2021-01-09
317304,JAKARTA BARAT,TAMBORA,2685,91,2366,65,163,254,2021-01-09
317107,JAKARTA PUSAT,TANAH ABANG,3157,53,2869,65,170,223,2021-01-09
317401,JAKARTA SELATAN,TEBET,3600,67,3190,75,268,335,2021-01-09
317205,JAKARTA UTARA,PADEMANGAN,2323,51,2073,41,158,209,2021-01-09
111111,Luar DKI & Proses Update,Luar DKI & Proses Update,143008,137,141294,1273,304,441,2021-01-09
317104,JAKARTA PUSAT,SENEN,2305,44,2095,46,120,164,2021-01-09
317106,JAKARTA PUSAT,MENTENG,1668,19,1505,33,111,130,2021-01-09
317204,JAKARTA UTARA,CILINCING,4047,74,3681,77,215,289,2021-01-09
317403,JAKARTA SELATAN,MAMPANG PRAPATAN,2797,34,2512,46,205,239,2021-01-09
317506,JAKARTA TIMUR,CAKUNG,5729,137,5024,85,483,620,2021-01-09
317105,JAKARTA PUSAT,CEMPAKA PUTIH,2483,42,2252,39,150,192,2021-01-09
317301,JAKARTA BARAT,CENGKARENG,6471,158,5689,136,488,646,2021-01-09
317501,JAKARTA TIMUR,MATRAMAN,3055,91,2698,69,197,288,2021-01-09
317510,JAKARTA TIMUR,CIPAYUNG,4301,138,3721,42,400,538,2021-01-09
317509,JAKARTA TIMUR,CIRACAS,3918,111,3382,68,357,468,2021-01-09
317507,JAKARTA TIMUR,DUREN SAWIT,6112,160,5336,129,487,647,2021-01-09
317101,JAKARTA PUSAT,GAMBIR,2044,41,1867,36,100,141,2021-01-09
317302,JAKARTA BARAT,GROGOL PETAMBURAN,3727,130,3268,76,253,383,2021-01-09
317409,JAKARTA SELATAN,JAGAKARSA,4424,144,3793,67,420,564,2021-01-09
317503,JAKARTA TIMUR,JATINEGARA,4447,82,3963,67,335,417,2021-01-09
317108,JAKARTA PUSAT,JOHAR BARU,2190,45,2010,67,68,113,2021-01-09
317406,JAKARTA SELATAN,CILANDAK,3516,69,3108,53,286,355,2021-01-09
317407,JAKARTA SELATAN,KEBAYORAN BARU,2782,84,2387,37,274,358,2021-01-09
317405,JAKARTA SELATAN,KEBAYORAN LAMA,4310,109,3709,74,418,527,2021-01-09
317305,JAKARTA BARAT,KEBON JERUK,4946,173,4357,95,321,494,2021-01-09
317206,JAKARTA UTARA,KELAPA GADING,2682,95,2306,45,236,331,2021-01-09
317103,JAKARTA PUSAT,KEMAYORAN,4470,85,4025,99,261,346,2021-01-09
317308,JAKARTA BARAT,KEMBANGAN,4056,113,3502,54,387,500,2021-01-09
310102,KAB.ADM.KEP.SERIBU,KEP. SERIBU SELATAN,93,0,76,1,16,16,2021-01-09
310101,KAB.ADM.KEP.SERIBU,KEP. SERIBU UTARA,130,9,94,0,27,36,2021-01-09
317203,JAKARTA UTARA,KOJA,4327,83,3966,78,200,283,2021-01-09
317504,JAKARTA TIMUR,KRAMAT JATI,4412,138,3885,86,303,441,2021-01-09
317508,JAKARTA TIMUR,MAKASAR,3763,200,3194,58,311,511,2021-01-09
317306,JAKARTA BARAT,KALI DERES,3506,95,3093,77,241,336,2021-01-09
317410,JAKARTA SELATAN,PESANGGRAHAN,3263,89,2905,50,219,308,2021-01-10
317201,JAKARTA UTARA,PENJARINGAN,3431,101,3062,61,207,308,2021-01-10
317505,JAKARTA TIMUR,PASAR REBO,3275,152,2819,47,257,409,2021-01-10
317408,JAKARTA SELATAN,PANCORAN,2796,72,2475,44,205,277,2021-01-10
317502,JAKARTA TIMUR,PULO GADUNG,4547,131,4003,82,331,462,2021-01-10
317307,JAKARTA BARAT,PALMERAH,3984,128,3528,88,240,368,2021-01-10
317404,JAKARTA SELATAN,PASAR MINGGU,4866,130,4278,86,372,502,2021-01-10
317102,JAKARTA PUSAT,SAWAH BESAR,2017,53,1766,43,155,208,2021-01-10
317202,JAKARTA UTARA,TANJUNG PRIOK,5699,133,5161,108,297,430,2021-01-10
317402,JAKARTA SELATAN,SETIA BUDI,2483,86,2210,41,146,232,2021-01-10
317303,JAKARTA BARAT,TAMAN SARI,1983,57,1826,31,69,126,2021-01-10
317304,JAKARTA BARAT,TAMBORA,2713,83,2410,66,154,237,2021-01-10
317107,JAKARTA PUSAT,TANAH ABANG,3255,48,2901,65,241,289,2021-01-10
317401,JAKARTA SELATAN,TEBET,3660,54,3271,76,259,313,2021-01-10
317205,JAKARTA UTARA,PADEMANGAN,2342,44,2106,42,150,194,2021-01-10
111111,Luar DKI & Proses Update,Luar DKI & Proses Update,143008,137,141294,1273,304,441,2021-01-10
317104,JAKARTA PUSAT,SENEN,2367,45,2126,46,150,195,2021-01-10
317106,JAKARTA PUSAT,MENTENG,1717,14,1532,33,138,152,2021-01-10
317501,JAKARTA TIMUR,MATRAMAN,3115,90,2734,69,222,312,2021-01-10
317403,JAKARTA SELATAN,MAMPANG PRAPATAN,2832,28,2570,46,188,216,2021-01-10
317302,JAKARTA BARAT,GROGOL PETAMBURAN,3764,121,3344,77,222,343,2021-01-10
317101,JAKARTA PUSAT,GAMBIR,2085,39,1889,36,121,160,2021-01-10
317507,JAKARTA TIMUR,DUREN SAWIT,6192,158,5479,130,425,583,2021-01-10
317509,JAKARTA TIMUR,CIRACAS,3959,110,3420,69,360,470,2021-01-10
317204,JAKARTA UTARA,CILINCING,4071,68,3731,77,195,263,2021-01-10
317406,JAKARTA SELATAN,CILANDAK,3560,59,3185,56,260,319,2021-01-10
317301,JAKARTA BARAT,CENGKARENG,6566,147,5835,137,447,594,2021-01-10
317105,JAKARTA PUSAT,CEMPAKA PUTIH,2516,40,2305,40,131,171,2021-01-10
317506,JAKARTA TIMUR,CAKUNG,5813,132,5117,85,479,611,2021-01-10
317409,JAKARTA SELATAN,JAGAKARSA,4480,128,3938,67,347,475,2021-01-10
317503,JAKARTA TIMUR,JATINEGARA,4497,65,4033,67,332,397,2021-01-10
317108,JAKARTA PUSAT,JOHAR BARU,2228,44,2021,67,96,140,2021-01-10
317510,JAKARTA TIMUR,CIPAYUNG,4357,145,3811,42,359,504,2021-01-10
317407,JAKARTA SELATAN,KEBAYORAN BARU,2836,76,2420,37,303,379,2021-01-10
317306,JAKARTA BARAT,KALI DERES,3563,95,3163,78,227,322,2021-01-10
317508,JAKARTA TIMUR,MAKASAR,3818,174,3306,60,278,452,2021-01-10
317504,JAKARTA TIMUR,KRAMAT JATI,4514,130,3943,87,354,484,2021-01-10
317203,JAKARTA UTARA,KOJA,4361,81,3999,78,203,284,2021-01-10
310102,KAB.ADM.KEP.SERIBU,KEP. SERIBU SELATAN,94,0,76,1,17,17,2021-01-10
310101,KAB.ADM.KEP.SERIBU,KEP. SERIBU UTARA,133,9,96,0,28,37,2021-01-10
317103,JAKARTA PUSAT,KEMAYORAN,4560,79,4056,99,326,405,2021-01-10
317206,JAKARTA UTARA,KELAPA GADING,2716,94,2353,45,224,318,2021-01-10
317305,JAKARTA BARAT,KEBON JERUK,5047,177,4419,97,354,531,2021-01-10
317405,JAKARTA SELATAN,KEBAYORAN LAMA,4355,93,3791,76,395,488,2021-01-10
317308,JAKARTA BARAT,KEMBANGAN,4143,119,3588,56,380,499,2021-01-10
317408,JAKARTA SELATAN,PANCORAN,2825,66,2533,44,182,248,2021-01-11
317404,JAKARTA SELATAN,PASAR MINGGU,4934,126,4347,87,374,500,2021-01-11
317502,JAKARTA TIMUR,PULO GADUNG,4625,123,4094,83,325,448,2021-01-11
317505,JAKARTA TIMUR,PASAR REBO,3340,144,2857,48,291,435,2021-01-11
317201,JAKARTA UTARA,PENJARINGAN,3482,85,3109,62,226,311,2021-01-11
317410,JAKARTA SELATAN,PESANGGRAHAN,3349,84,2967,50,248,332,2021-01-11
317102,JAKARTA PUSAT,SAWAH BESAR,2031,43,1794,43,151,194,2021-01-11
317202,JAKARTA UTARA,TANJUNG PRIOK,5752,113,5238,109,292,405,2021-01-11
317402,JAKARTA SELATAN,SETIA BUDI,2548,91,2233,41,183,274,2021-01-11
317303,JAKARTA BARAT,TAMAN SARI,2006,46,1842,32,86,132,2021-01-11
317304,JAKARTA BARAT,TAMBORA,2770,71,2447,66,186,257,2021-01-11
317107,JAKARTA PUSAT,TANAH ABANG,3276,38,2930,67,241,279,2021-01-11
317401,JAKARTA SELATAN,TEBET,3719,37,3336,77,269,306,2021-01-11
111111,Luar DKI & Proses Update,Luar DKI & Proses Update,143008,137,141294,1273,304,441,2021-01-11
317307,JAKARTA BARAT,PALMERAH,4027,102,3588,91,246,348,2021-01-11
317104,JAKARTA PUSAT,SENEN,2374,40,2146,46,142,182,2021-01-11
317205,JAKARTA UTARA,PADEMANGAN,2402,38,2136,43,185,223,2021-01-11
317106,JAKARTA PUSAT,MENTENG,1730,12,1557,33,128,140,2021-01-11
317501,JAKARTA TIMUR,MATRAMAN,3172,79,2761,69,263,342,2021-01-11
317506,JAKARTA TIMUR,CAKUNG,5887,122,5230,86,449,571,2021-01-11
317105,JAKARTA PUSAT,CEMPAKA PUTIH,2537,35,2330,40,132,167,2021-01-11
317301,JAKARTA BARAT,CENGKARENG,6626,132,5898,138,458,590,2021-01-11
317406,JAKARTA SELATAN,CILANDAK,3623,59,3245,58,261,320,2021-01-11
317204,JAKARTA UTARA,CILINCING,4103,64,3785,78,176,240,2021-01-11
317510,JAKARTA TIMUR,CIPAYUNG,4413,141,3855,46,371,512,2021-01-11
317507,JAKARTA TIMUR,DUREN SAWIT,6285,139,5566,130,450,589,2021-01-11
317101,JAKARTA PUSAT,GAMBIR,2102,36,1907,36,123,159,2021-01-11
317302,JAKARTA BARAT,GROGOL PETAMBURAN,3822,101,3405,78,238,339,2021-01-11
317409,JAKARTA SELATAN,JAGAKARSA,4596,117,3992,70,417,534,2021-01-11
317503,JAKARTA TIMUR,JATINEGARA,4549,58,4107,67,317,375,2021-01-11
317108,JAKARTA PUSAT,JOHAR BARU,2236,42,2034,67,93,135,2021-01-11
317509,JAKARTA TIMUR,CIRACAS,4056,99,3487,70,400,499,2021-01-11
317407,JAKARTA SELATAN,KEBAYORAN BARU,2867,65,2506,38,258,323,2021-01-11
317306,JAKARTA BARAT,KALI DERES,3597,90,3199,79,229,319,2021-01-11
317403,JAKARTA SELATAN,MAMPANG PRAPATAN,2872,26,2604,46,196,222,2021-01-11
317508,JAKARTA TIMUR,MAKASAR,3885,164,3373,60,288,452,2021-01-11
317504,JAKARTA TIMUR,KRAMAT JATI,4622,125,3996,88,413,538,2021-01-11
317203,JAKARTA UTARA,KOJA,4428,75,4038,79,236,311,2021-01-11
310102,KAB.ADM.KEP.SERIBU,KEP. SERIBU SELATAN,96,0,77,1,18,18,2021-01-11
310101,KAB.ADM.KEP.SERIBU,KEP. SERIBU UTARA,141,9,101,0,31,40,2021-01-11
317308,JAKARTA BARAT,KEMBANGAN,4208,103,3637,56,412,515,2021-01-11
317103,JAKARTA PUSAT,KEMAYORAN,4601,79,4133,99,290,369,2021-01-11
317206,JAKARTA UTARA,KELAPA GADING,2754,83,2390,46,235,318,2021-01-11
317305,JAKARTA BARAT,KEBON JERUK,5111,141,4504,97,369,510,2021-01-11
317405,JAKARTA SELATAN,KEBAYORAN LAMA,4402,80,3886,77,359,439,2021-01-11
317404,JAKARTA SELATAN,PASAR MINGGU,5039,136,4375,87,441,577,2021-01-12
317102,JAKARTA PUSAT,SAWAH BESAR,2065,46,1816,43,160,206,2021-01-12
317201,JAKARTA UTARA,PENJARINGAN,3569,84,3136,62,287,371,2021-01-12
317410,JAKARTA SELATAN,PESANGGRAHAN,3410,78,2990,51,291,369,2021-01-12
317502,JAKARTA TIMUR,PULO GADUNG,4704,126,4124,83,371,497,2021-01-12
317505,JAKARTA TIMUR,PASAR REBO,3436,150,2877,49,360,510,2021-01-12
317104,JAKARTA PUSAT,SENEN,2390,45,2180,48,117,162,2021-01-12
317401,JAKARTA SELATAN,TEBET,3830,39,3358,77,356,395,2021-01-12
317303,JAKARTA BARAT,TAMAN SARI,2027,43,1853,32,99,142,2021-01-12
317304,JAKARTA BARAT,TAMBORA,2816,71,2469,68,208,279,2021-01-12
317107,JAKARTA PUSAT,TANAH ABANG,3345,49,2950,67,279,328,2021-01-12
317202,JAKARTA UTARA,TANJUNG PRIOK,5868,118,5265,110,375,493,2021-01-12
317408,JAKARTA SELATAN,PANCORAN,2882,76,2544,44,218,294,2021-01-12
111111,Luar DKI & Proses Update,Luar DKI & Proses Update,143008,137,141294,1273,304,441,2021-01-12
317402,JAKARTA SELATAN,SETIA BUDI,2589,93,2251,41,204,297,2021-01-12
317307,JAKARTA BARAT,PALMERAH,4058,101,3618,93,246,347,2021-01-12
317205,JAKARTA UTARA,PADEMANGAN,2432,35,2144,43,210,245,2021-01-12
317510,JAKARTA TIMUR,CIPAYUNG,4498,137,3914,47,400,537,2021-01-12
317503,JAKARTA TIMUR,JATINEGARA,4598,59,4123,68,348,407,2021-01-12
317409,JAKARTA SELATAN,JAGAKARSA,4667,117,4021,71,458,575,2021-01-12
317302,JAKARTA BARAT,GROGOL PETAMBURAN,3852,105,3440,79,228,333,2021-01-12
317101,JAKARTA PUSAT,GAMBIR,2126,34,1931,36,125,159,2021-01-12
317507,JAKARTA TIMUR,DUREN SAWIT,6431,139,5663,132,497,636,2021-01-12
317509,JAKARTA TIMUR,CIRACAS,4130,102,3545,72,411,513,2021-01-12
317204,JAKARTA UTARA,CILINCING,4143,62,3791,80,210,272,2021-01-12
317406,JAKARTA SELATAN,CILANDAK,3701,58,3268,59,316,374,2021-01-12
317301,JAKARTA BARAT,CENGKARENG,6768,136,5969,138,525,661,2021-01-12
317105,JAKARTA PUSAT,CEMPAKA PUTIH,2551,33,2345,41,132,165,2021-01-12
317506,JAKARTA TIMUR,CAKUNG,5949,124,5282,86,457,581,2021-01-12
317108,JAKARTA PUSAT,JOHAR BARU,2258,37,2044,68,109,146,2021-01-12
317306,JAKARTA BARAT,KALI DERES,3680,97,3236,81,266,363,2021-01-12
317106,JAKARTA PUSAT,MENTENG,1766,11,1589,33,133,144,2021-01-12
317405,JAKARTA SELATAN,KEBAYORAN LAMA,4477,78,3918,77,404,482,2021-01-12
317407,JAKARTA SELATAN,KEBAYORAN BARU,2962,68,2549,39,306,374,2021-01-12
317501,JAKARTA TIMUR,MATRAMAN,3196,77,2777,69,273,350,2021-01-12
317403,JAKARTA SELATAN,MAMPANG PRAPATAN,2925,21,2616,46,242,263,2021-01-12
317508,JAKARTA TIMUR,MAKASAR,3970,155,3397,63,355,510,2021-01-12
317504,JAKARTA TIMUR,KRAMAT JATI,4685,127,4009,89,460,587,2021-01-12
310101,KAB.ADM.KEP.SERIBU,KEP. SERIBU UTARA,141,9,101,0,31,40,2021-01-12
317203,JAKARTA UTARA,KOJA,4458,78,4052,80,248,326,2021-01-12
310102,KAB.ADM.KEP.SERIBU,KEP. SERIBU SELATAN,96,0,77,1,18,18,2021-01-12
317308,JAKARTA BARAT,KEMBANGAN,4253,92,3718,57,386,478,2021-01-12
317103,JAKARTA PUSAT,KEMAYORAN,4687,90,4156,100,341,431,2021-01-12
317206,JAKARTA UTARA,KELAPA GADING,2797,76,2424,46,251,327,2021-01-12
317305,JAKARTA BARAT,KEBON JERUK,5179,143,4564,98,374,517,2021-01-12
317502,JAKARTA TIMUR,PULO GADUNG,4768,130,4223,83,332,462,2021-01-13
317408,JAKARTA SELATAN,PANCORAN,2942,74,2579,44,245,319,2021-01-13
317505,JAKARTA TIMUR,PASAR REBO,3531,150,2914,51,416,566,2021-01-13
317201,JAKARTA UTARA,PENJARINGAN,3612,88,3169,62,293,381,2021-01-13
317410,JAKARTA SELATAN,PESANGGRAHAN,3444,76,3016,53,299,375,2021-01-13
317404,JAKARTA SELATAN,PASAR MINGGU,5156,136,4461,87,472,608,2021-01-13
317102,JAKARTA PUSAT,SAWAH BESAR,2076,49,1846,43,138,187,2021-01-13
317401,JAKARTA SELATAN,TEBET,3878,39,3432,78,329,368,2021-01-13
317402,JAKARTA SELATAN,SETIA BUDI,2629,91,2307,42,189,280,2021-01-13
317303,JAKARTA BARAT,TAMAN SARI,2048,45,1874,32,97,142,2021-01-13
317304,JAKARTA BARAT,TAMBORA,2838,74,2510,68,186,260,2021-01-13
317107,JAKARTA PUSAT,TANAH ABANG,3358,47,3016,69,226,273,2021-01-13
317202,JAKARTA UTARA,TANJUNG PRIOK,5930,124,5326,111,369,493,2021-01-13
317307,JAKARTA BARAT,PALMERAH,4151,106,3666,94,285,391,2021-01-13
111111,Luar DKI & Proses Update,Luar DKI & Proses Update,143008,137,141294,1273,304,441,2021-01-13
317104,JAKARTA PUSAT,SENEN,2403,44,2213,48,98,142,2021-01-13
317205,JAKARTA UTARA,PADEMANGAN,2447,34,2194,45,174,208,2021-01-13
317504,JAKARTA TIMUR,KRAMAT JATI,4789,130,4076,89,494,624,2021-01-13
317501,JAKARTA TIMUR,MATRAMAN,3267,77,2867,69,254,331,2021-01-13
317506,JAKARTA TIMUR,CAKUNG,6085,126,5348,86,525,651,2021-01-13
317105,JAKARTA PUSAT,CEMPAKA PUTIH,2562,32,2387,41,102,134,2021-01-13
317301,JAKARTA BARAT,CENGKARENG,6862,145,6050,142,525,670,2021-01-13
317406,JAKARTA SELATAN,CILANDAK,3734,49,3301,62,322,371,2021-01-13
317204,JAKARTA UTARA,CILINCING,4224,62,3844,81,237,299,2021-01-13
317510,JAKARTA TIMUR,CIPAYUNG,4629,146,3956,47,480,626,2021-01-13
317509,JAKARTA TIMUR,CIRACAS,4168,101,3656,72,339,440,2021-01-13
317507,JAKARTA TIMUR,DUREN SAWIT,6566,139,5735,133,559,698,2021-01-13
317101,JAKARTA PUSAT,GAMBIR,2133,33,1955,36,109,142,2021-01-13
317302,JAKARTA BARAT,GROGOL PETAMBURAN,3919,107,3492,80,240,347,2021-01-13
317106,JAKARTA PUSAT,MENTENG,1772,9,1612,33,118,127,2021-01-13
317503,JAKARTA TIMUR,JATINEGARA,4662,55,4260,71,276,331,2021-01-13
317108,JAKARTA PUSAT,JOHAR BARU,2273,33,2077,68,95,128,2021-01-13
317409,JAKARTA SELATAN,JAGAKARSA,4801,113,4099,73,516,629,2021-01-13
317407,JAKARTA SELATAN,KEBAYORAN BARU,3000,59,2618,40,283,342,2021-01-13
317403,JAKARTA SELATAN,MAMPANG PRAPATAN,2961,16,2680,48,217,233,2021-01-13
317508,JAKARTA TIMUR,MAKASAR,4086,155,3508,63,360,515,2021-01-13
317306,JAKARTA BARAT,KALI DERES,3751,104,3280,82,285,389,2021-01-13
310101,KAB.ADM.KEP.SERIBU,KEP. SERIBU UTARA,142,9,103,0,30,39,2021-01-13
310102,KAB.ADM.KEP.SERIBU,KEP. SERIBU SELATAN,96,0,80,1,15,15,2021-01-13
317203,JAKARTA UTARA,KOJA,4606,86,4108,80,332,418,2021-01-13
317103,JAKARTA PUSAT,KEMAYORAN,4727,97,4250,101,279,376,2021-01-13
317206,JAKARTA UTARA,KELAPA GADING,2853,76,2486,47,244,320,2021-01-13
317305,JAKARTA BARAT,KEBON JERUK,5267,153,4636,101,377,530,2021-01-13
317405,JAKARTA SELATAN,KEBAYORAN LAMA,4532,69,4007,81,375,444,2021-01-13
317308,JAKARTA BARAT,KEMBANGAN,4365,109,3795,58,403,512,2021-01-13
317404,JAKARTA SELATAN,PASAR MINGGU,5259,166,4495,88,510,676,2021-01-14
317102,JAKARTA PUSAT,SAWAH BESAR,2091,50,1866,44,131,181,2021-01-14
317505,JAKARTA TIMUR,PASAR REBO,3615,170,2948,52,445,615,2021-01-14
317201,JAKARTA UTARA,PENJARINGAN,3666,83,3207,62,314,397,2021-01-14
317410,JAKARTA SELATAN,PESANGGRAHAN,3498,86,3055,53,304,390,2021-01-14
317502,JAKARTA TIMUR,PULO GADUNG,4840,154,4253,85,348,502,2021-01-14
317104,JAKARTA PUSAT,SENEN,2435,56,2220,48,111,167,2021-01-14
317408,JAKARTA SELATAN,PANCORAN,2996,79,2636,46,235,314,2021-01-14
317303,JAKARTA BARAT,TAMAN SARI,2088,47,1886,32,123,170,2021-01-14
317304,JAKARTA BARAT,TAMBORA,2889,75,2555,69,190,265,2021-01-14
317107,JAKARTA PUSAT,TANAH ABANG,3380,54,3045,69,212,266,2021-01-14
317202,JAKARTA UTARA,TANJUNG PRIOK,5999,135,5348,113,403,538,2021-01-14
317401,JAKARTA SELATAN,TEBET,3942,42,3450,79,371,413,2021-01-14
111111,Luar DKI & Proses Update,Luar DKI & Proses Update,143008,137,141294,1273,304,441,2021-01-14
317402,JAKARTA SELATAN,SETIA BUDI,2665,101,2318,42,204,305,2021-01-14
317307,JAKARTA BARAT,PALMERAH,4193,121,3684,96,292,413,2021-01-14
317509,JAKARTA TIMUR,CIRACAS,4283,109,3701,72,401,510,2021-01-14
317106,JAKARTA PUSAT,MENTENG,1815,15,1624,33,143,158,2021-01-14
317506,JAKARTA TIMUR,CAKUNG,6202,134,5460,87,521,655,2021-01-14
317105,JAKARTA PUSAT,CEMPAKA PUTIH,2643,40,2408,41,154,194,2021-01-14
317301,JAKARTA BARAT,CENGKARENG,6948,139,6180,146,483,622,2021-01-14
317406,JAKARTA SELATAN,CILANDAK,3804,66,3350,63,325,391,2021-01-14
317204,JAKARTA UTARA,CILINCING,4279,66,3869,81,263,329,2021-01-14
317510,JAKARTA TIMUR,CIPAYUNG,4716,147,4034,49,486,633,2021-01-14
317507,JAKARTA TIMUR,DUREN SAWIT,6651,165,5768,135,583,748,2021-01-14
317101,JAKARTA PUSAT,GAMBIR,2152,29,1968,36,119,148,2021-01-14
317302,JAKARTA BARAT,GROGOL PETAMBURAN,3979,122,3520,80,257,379,2021-01-14
317409,JAKARTA SELATAN,JAGAKARSA,4899,128,4169,73,529,657,2021-01-14
317503,JAKARTA TIMUR,JATINEGARA,4760,70,4305,72,313,383,2021-01-14
317108,JAKARTA PUSAT,JOHAR BARU,2295,42,2082,68,103,145,2021-01-14
317306,JAKARTA BARAT,KALI DERES,3796,107,3327,82,280,387,2021-01-14
317205,JAKARTA UTARA,PADEMANGAN,2474,44,2223,45,162,206,2021-01-14
317405,JAKARTA SELATAN,KEBAYORAN LAMA,4632,99,4030,81,422,521,2021-01-14
317407,JAKARTA SELATAN,KEBAYORAN BARU,3057,77,2636,41,303,380,2021-01-14
317403,JAKARTA SELATAN,MAMPANG PRAPATAN,3013,25,2711,48,229,254,2021-01-14
317508,JAKARTA TIMUR,MAKASAR,4192,152,3562,64,414,566,2021-01-14
317504,JAKARTA TIMUR,KRAMAT JATI,4876,135,4137,91,513,648,2021-01-14
317203,JAKARTA UTARA,KOJA,4732,104,4126,81,421,525,2021-01-14
310101,KAB.ADM.KEP.SERIBU,KEP. SERIBU UTARA,146,9,106,0,31,40,2021-01-14
317501,JAKARTA TIMUR,MATRAMAN,3320,92,2889,73,266,358,2021-01-14
317308,JAKARTA BARAT,KEMBANGAN,4424,112,3837,60,415,527,2021-01-14
317103,JAKARTA PUSAT,KEMAYORAN,4880,102,4283,102,393,495,2021-01-14
317206,JAKARTA UTARA,KELAPA GADING,2930,78,2535,48,269,347,2021-01-14
317305,JAKARTA BARAT,KEBON JERUK,5347,151,4718,102,376,527,2021-01-14
310102,KAB.ADM.KEP.SERIBU,KEP. SERIBU SELATAN,106,1,87,1,17,18,2021-01-14
317404,JAKARTA SELATAN,PASAR MINGGU,5318,196,4553,90,479,675,2021-01-15
317505,JAKARTA TIMUR,PASAR REBO,3668,185,3053,52,378,563,2021-01-15
317201,JAKARTA UTARA,PENJARINGAN,3702,74,3258,62,308,382,2021-01-15
317410,JAKARTA SELATAN,PESANGGRAHAN,3536,98,3093,55,290,388,2021-01-15
317502,JAKARTA TIMUR,PULO GADUNG,4924,160,4309,87,368,528,2021-01-15
317102,JAKARTA PUSAT,SAWAH BESAR,2115,59,1888,44,124,183,2021-01-15
317104,JAKARTA PUSAT,SENEN,2480,86,2240,48,106,192,2021-01-15
317304,JAKARTA BARAT,TAMBORA,2940,94,2581,70,195,289,2021-01-15
317303,JAKARTA BARAT,TAMAN SARI,2109,54,1898,32,125,179,2021-01-15
317107,JAKARTA PUSAT,TANAH ABANG,3411,70,3062,69,210,280,2021-01-15
317202,JAKARTA UTARA,TANJUNG PRIOK,6081,143,5431,113,394,537,2021-01-15
317401,JAKARTA SELATAN,TEBET,3976,62,3482,79,353,415,2021-01-15
111111,Luar DKI & Proses Update,Luar DKI & Proses Update,143008,137,141294,1273,304,441,2021-01-15
317402,JAKARTA SELATAN,SETIA BUDI,2692,97,2344,44,207,304,2021-01-15
317408,JAKARTA SELATAN,PANCORAN,3022,77,2668,46,231,308,2021-01-15
317307,JAKARTA BARAT,PALMERAH,4253,133,3760,96,264,397,2021-01-15
317205,JAKARTA UTARA,PADEMANGAN,2511,64,2244,46,157,221,2021-01-15
317506,JAKARTA TIMUR,CAKUNG,6270,152,5542,90,486,638,2021-01-15
317105,JAKARTA PUSAT,CEMPAKA PUTIH,2666,41,2425,42,158,199,2021-01-15
317301,JAKARTA BARAT,CENGKARENG,7000,152,6222,151,475,627,2021-01-15
317406,JAKARTA SELATAN,CILANDAK,3847,97,3404,63,283,380,2021-01-15
317204,JAKARTA UTARA,CILINCING,4334,76,3907,81,270,346,2021-01-15
317510,JAKARTA TIMUR,CIPAYUNG,4815,156,4157,50,452,608,2021-01-15
317509,JAKARTA TIMUR,CIRACAS,4343,113,3770,74,386,499,2021-01-15
317101,JAKARTA PUSAT,GAMBIR,2202,43,1980,36,143,186,2021-01-15
317302,JAKARTA BARAT,GROGOL PETAMBURAN,4078,154,3585,81,258,412,2021-01-15
317409,JAKARTA SELATAN,JAGAKARSA,4948,139,4220,73,516,655,2021-01-15
317503,JAKARTA TIMUR,JATINEGARA,4797,81,4328,73,315,396,2021-01-15
317108,JAKARTA PUSAT,JOHAR BARU,2330,52,2095,68,115,167,2021-01-15
317306,JAKARTA BARAT,KALI DERES,3817,99,3358,82,278,377,2021-01-15
317507,JAKARTA TIMUR,DUREN SAWIT,6734,183,5819,139,593,776,2021-01-15
317405,JAKARTA SELATAN,KEBAYORAN LAMA,4701,112,4081,82,426,538,2021-01-15
317407,JAKARTA SELATAN,KEBAYORAN BARU,3100,78,2666,41,315,393,2021-01-15
317501,JAKARTA TIMUR,MATRAMAN,3427,135,2903,76,313,448,2021-01-15
317403,JAKARTA SELATAN,MAMPANG PRAPATAN,3060,59,2724,48,229,288,2021-01-15
317508,JAKARTA TIMUR,MAKASAR,4238,158,3602,64,414,572,2021-01-15
317504,JAKARTA TIMUR,KRAMAT JATI,4956,167,4227,91,471,638,2021-01-15
317203,JAKARTA UTARA,KOJA,4810,103,4203,81,423,526,2021-01-15
317106,JAKARTA PUSAT,MENTENG,1847,30,1627,33,157,187,2021-01-15
310102,KAB.ADM.KEP.SERIBU,KEP. SERIBU SELATAN,106,1,91,1,13,14,2021-01-15
317308,JAKARTA BARAT,KEMBANGAN,4465,120,3925,61,359,479,2021-01-15
317103,JAKARTA PUSAT,KEMAYORAN,4947,125,4309,102,411,536,2021-01-15
317206,JAKARTA UTARA,KELAPA GADING,2973,70,2600,48,255,325,2021-01-15
317305,JAKARTA BARAT,KEBON JERUK,5401,154,4761,103,383,537,2021-01-15
310101,KAB.ADM.KEP.SERIBU,KEP. SERIBU UTARA,148,9,121,0,18,27,2021-01-15
317404,JAKARTA SELATAN,PASAR MINGGU,5406,158,4631,91,526,684,2021-01-16
317505,JAKARTA TIMUR,PASAR REBO,3725,99,3161,52,413,512,2021-01-16
317201,JAKARTA UTARA,PENJARINGAN,3755,80,3283,62,330,410,2021-01-16
317410,JAKARTA SELATAN,PESANGGRAHAN,3660,72,3156,56,376,448,2021-01-16
317502,JAKARTA TIMUR,PULO GADUNG,4991,119,4385,87,400,519,2021-01-16
317102,JAKARTA PUSAT,SAWAH BESAR,2131,46,1910,45,130,176,2021-01-16
317104,JAKARTA PUSAT,SENEN,2503,85,2252,48,118,203,2021-01-16
317304,JAKARTA BARAT,TAMBORA,2974,96,2604,71,203,299,2021-01-16
317303,JAKARTA BARAT,TAMAN SARI,2131,64,1910,33,124,188,2021-01-16
317107,JAKARTA PUSAT,TANAH ABANG,3453,66,3077,69,241,307,2021-01-16
317202,JAKARTA UTARA,TANJUNG PRIOK,6286,111,5501,114,560,671,2021-01-16
317401,JAKARTA SELATAN,TEBET,4031,62,3509,80,380,442,2021-01-16
111111,Luar DKI & Proses Update,Luar DKI & Proses Update,143008,137,141294,1273,304,441,2021-01-16
317402,JAKARTA SELATAN,SETIA BUDI,2724,75,2395,45,209,284,2021-01-16
317408,JAKARTA SELATAN,PANCORAN,3057,68,2701,47,241,309,2021-01-16
317507,JAKARTA TIMUR,DUREN SAWIT,6850,133,5942,145,630,763,2021-01-16
317205,JAKARTA UTARA,PADEMANGAN,2545,58,2269,46,172,230,2021-01-16
317506,JAKARTA TIMUR,CAKUNG,6374,150,5609,92,523,673,2021-01-16
317105,JAKARTA PUSAT,CEMPAKA PUTIH,2761,41,2437,43,240,281,2021-01-16
317301,JAKARTA BARAT,CENGKARENG,7053,140,6267,151,495,635,2021-01-16
317406,JAKARTA SELATAN,CILANDAK,3913,89,3431,64,329,418,2021-01-16
317204,JAKARTA UTARA,CILINCING,4397,52,3944,81,320,372,2021-01-16
317510,JAKARTA TIMUR,CIPAYUNG,4956,109,4229,50,568,677,2021-01-16
317509,JAKARTA TIMUR,CIRACAS,4415,83,3823,76,433,516,2021-01-16
317307,JAKARTA BARAT,PALMERAH,4327,109,3818,97,303,412,2021-01-16
317302,JAKARTA BARAT,GROGOL PETAMBURAN,4152,157,3615,81,299,456,2021-01-16
317409,JAKARTA SELATAN,JAGAKARSA,5046,90,4326,74,556,646,2021-01-16
317503,JAKARTA TIMUR,JATINEGARA,4859,94,4351,75,339,433,2021-01-16
317108,JAKARTA PUSAT,JOHAR BARU,2364,42,2114,68,140,182,2021-01-16
317306,JAKARTA BARAT,KALI DERES,3852,93,3393,84,282,375,2021-01-16
317101,JAKARTA PUSAT,GAMBIR,2219,45,1998,36,140,185,2021-01-16
317405,JAKARTA SELATAN,KEBAYORAN LAMA,4829,101,4195,84,449,550,2021-01-16
317106,JAKARTA PUSAT,MENTENG,1875,36,1630,33,176,212,2021-01-16
317407,JAKARTA SELATAN,KEBAYORAN BARU,3175,66,2722,41,346,412,2021-01-16
317403,JAKARTA SELATAN,MAMPANG PRAPATAN,3086,63,2737,48,238,301,2021-01-16
317508,JAKARTA TIMUR,MAKASAR,4279,119,3670,66,424,543,2021-01-16
317504,JAKARTA TIMUR,KRAMAT JATI,5055,110,4306,91,548,658,2021-01-16
317203,JAKARTA UTARA,KOJA,4958,89,4242,81,546,635,2021-01-16
317501,JAKARTA TIMUR,MATRAMAN,3516,102,2955,76,383,485,2021-01-16
310102,KAB.ADM.KEP.SERIBU,KEP. SERIBU SELATAN,108,1,91,1,15,16,2021-01-16
317308,JAKARTA BARAT,KEMBANGAN,4530,116,3965,64,385,501,2021-01-16
317103,JAKARTA PUSAT,KEMAYORAN,5100,132,4356,102,510,642,2021-01-16
317206,JAKARTA UTARA,KELAPA GADING,3073,75,2624,48,326,401,2021-01-16
317305,JAKARTA BARAT,KEBON JERUK,5550,136,4800,103,511,647,2021-01-16
310101,KAB.ADM.KEP.SERIBU,KEP. SERIBU UTARA,151,0,130,0,21,21,2021-01-16
317505,JAKARTA TIMUR,PASAR REBO,3794,116,3211,55,412,528,2021-01-17
317201,JAKARTA UTARA,PENJARINGAN,3832,84,3371,62,315,399,2021-01-17
317410,JAKARTA SELATAN,PESANGGRAHAN,3696,74,3201,57,364,438,2021-01-17
317502,JAKARTA TIMUR,PULO GADUNG,5048,136,4467,87,358,494,2021-01-17
317102,JAKARTA PUSAT,SAWAH BESAR,2161,50,1968,45,98,148,2021-01-17
317104,JAKARTA PUSAT,SENEN,2545,91,2308,48,98,189,2021-01-17
317107,JAKARTA PUSAT,TANAH ABANG,3475,71,3185,69,150,221,2021-01-17
317303,JAKARTA BARAT,TAMAN SARI,2181,68,1948,33,132,200,2021-01-17
317304,JAKARTA BARAT,TAMBORA,3017,108,2640,72,197,305,2021-01-17
317202,JAKARTA UTARA,TANJUNG PRIOK,6338,127,5576,117,518,645,2021-01-17
317401,JAKARTA SELATAN,TEBET,4088,73,3598,80,337,410,2021-01-17
111111,Luar DKI & Proses Update,Luar DKI & Proses Update,143008,137,141294,1273,304,441,2021-01-17
317402,JAKARTA SELATAN,SETIA BUDI,2829,77,2472,45,235,312,2021-01-17
317404,JAKARTA SELATAN,PASAR MINGGU,5447,155,4764,93,435,590,2021-01-17
317101,JAKARTA PUSAT,GAMBIR,2251,49,2046,37,119,168,2021-01-17
317307,JAKARTA BARAT,PALMERAH,4362,119,3882,98,263,382,2021-01-17
317506,JAKARTA TIMUR,CAKUNG,6435,158,5733,94,450,608,2021-01-17
317105,JAKARTA PUSAT,CEMPAKA PUTIH,2820,46,2478,44,252,298,2021-01-17
317301,JAKARTA BARAT,CENGKARENG,7180,150,6413,151,466,616,2021-01-17
317406,JAKARTA SELATAN,CILANDAK,3953,92,3498,64,299,391,2021-01-17
317408,JAKARTA SELATAN,PANCORAN,3110,87,2760,48,215,302,2021-01-17
317204,JAKARTA UTARA,CILINCING,4454,49,3989,82,334,383,2021-01-17
317510,JAKARTA TIMUR,CIPAYUNG,4994,108,4303,50,533,641,2021-01-17
317509,JAKARTA TIMUR,CIRACAS,4455,97,3874,77,407,504,2021-01-17
317302,JAKARTA BARAT,GROGOL PETAMBURAN,4256,155,3684,82,335,490,2021-01-17
317409,JAKARTA SELATAN,JAGAKARSA,5174,109,4479,76,510,619,2021-01-17
317503,JAKARTA TIMUR,JATINEGARA,4934,106,4448,75,305,411,2021-01-17
317108,JAKARTA PUSAT,JOHAR BARU,2398,45,2154,68,131,176,2021-01-17
317306,JAKARTA BARAT,KALI DERES,3977,94,3503,85,295,389,2021-01-17
317407,JAKARTA SELATAN,KEBAYORAN BARU,3232,76,2780,42,334,410,2021-01-17
317507,JAKARTA TIMUR,DUREN SAWIT,6923,157,6042,146,578,735,2021-01-17
317305,JAKARTA BARAT,KEBON JERUK,5682,132,4988,104,458,590,2021-01-17
317205,JAKARTA UTARA,PADEMANGAN,2575,69,2294,47,165,234,2021-01-17
317405,JAKARTA SELATAN,KEBAYORAN LAMA,4885,112,4266,85,422,534,2021-01-17
317501,JAKARTA TIMUR,MATRAMAN,3535,113,3021,76,325,438,2021-01-17
317403,JAKARTA SELATAN,MAMPANG PRAPATAN,3137,68,2820,49,200,268,2021-01-17
317508,JAKARTA TIMUR,MAKASAR,4324,120,3742,67,395,515,2021-01-17
317504,JAKARTA TIMUR,KRAMAT JATI,5109,122,4431,91,465,587,2021-01-17
317106,JAKARTA PUSAT,MENTENG,1903,38,1691,34,140,178,2021-01-17
310101,KAB.ADM.KEP.SERIBU,KEP. SERIBU UTARA,152,0,132,0,20,20,2021-01-17
310102,KAB.ADM.KEP.SERIBU,KEP. SERIBU SELATAN,110,1,92,1,16,17,2021-01-17
317308,JAKARTA BARAT,KEMBANGAN,4658,119,4118,66,355,474,2021-01-17
317103,JAKARTA PUSAT,KEMAYORAN,5136,149,4452,102,433,582,2021-01-17
317206,JAKARTA UTARA,KELAPA GADING,3114,84,2658,48,324,408,2021-01-17
317203,JAKARTA UTARA,KOJA,5030,99,4278,82,571,670,2021-01-17
317201,JAKARTA UTARA,PENJARINGAN,3859,78,3449,63,269,347,2021-01-18
317410,JAKARTA SELATAN,PESANGGRAHAN,3740,69,3294,58,319,388,2021-01-18
317502,JAKARTA TIMUR,PULO GADUNG,5121,134,4535,88,364,498,2021-01-18
317102,JAKARTA PUSAT,SAWAH BESAR,2181,46,1985,45,105,151,2021-01-18
317104,JAKARTA PUSAT,SENEN,2576,89,2327,48,112,201,2021-01-18
317402,JAKARTA SELATAN,SETIA BUDI,2853,71,2548,45,189,260,2021-01-18
317107,JAKARTA PUSAT,TANAH ABANG,3537,68,3208,69,192,260,2021-01-18
317304,JAKARTA BARAT,TAMBORA,3042,106,2701,72,163,269,2021-01-18
317202,JAKARTA UTARA,TANJUNG PRIOK,6409,119,5638,117,535,654,2021-01-18
317401,JAKARTA SELATAN,TEBET,4172,67,3658,82,365,432,2021-01-18
111111,Luar DKI & Proses Update,Luar DKI & Proses Update,143008,137,141294,1273,304,441,2021-01-18
317505,JAKARTA TIMUR,PASAR REBO,3851,103,3281,56,411,514,2021-01-18
317303,JAKARTA BARAT,TAMAN SARI,2188,55,1986,34,113,168,2021-01-18
317404,JAKARTA SELATAN,PASAR MINGGU,5509,141,4850,93,425,566,2021-01-18
317408,JAKARTA SELATAN,PANCORAN,3133,87,2798,48,200,287,2021-01-18
317307,JAKARTA BARAT,PALMERAH,4382,118,3905,98,261,379,2021-01-18
317506,JAKARTA TIMUR,CAKUNG,6530,150,5797,98,485,635,2021-01-18
317105,JAKARTA PUSAT,CEMPAKA PUTIH,2837,43,2496,46,252,295,2021-01-18
317301,JAKARTA BARAT,CENGKARENG,7225,142,6462,153,468,610,2021-01-18
317406,JAKARTA SELATAN,CILANDAK,4006,91,3581,65,269,360,2021-01-18
317204,JAKARTA UTARA,CILINCING,4512,43,4017,83,369,412,2021-01-18
317510,JAKARTA TIMUR,CIPAYUNG,5113,103,4366,50,594,697,2021-01-18
317509,JAKARTA TIMUR,CIRACAS,4508,94,3981,78,355,449,2021-01-18
317507,JAKARTA TIMUR,DUREN SAWIT,7035,145,6156,146,588,733,2021-01-18
317101,JAKARTA PUSAT,GAMBIR,2261,46,2060,38,117,163,2021-01-18
317409,JAKARTA SELATAN,JAGAKARSA,5233,101,4603,77,452,553,2021-01-18
317503,JAKARTA TIMUR,JATINEGARA,5006,104,4502,77,323,427,2021-01-18
317108,JAKARTA PUSAT,JOHAR BARU,2415,45,2174,68,128,173,2021-01-18
317306,JAKARTA BARAT,KALI DERES,3992,90,3543,85,274,364,2021-01-18
317407,JAKARTA SELATAN,KEBAYORAN BARU,3278,74,2823,42,339,413,2021-01-18
317302,JAKARTA BARAT,GROGOL PETAMBURAN,4294,148,3748,82,316,464,2021-01-18
317106,JAKARTA PUSAT,MENTENG,1936,36,1702,35,163,199,2021-01-18
317205,JAKARTA UTARA,PADEMANGAN,2600,69,2345,49,137,206,2021-01-18
317405,JAKARTA SELATAN,KEBAYORAN LAMA,4965,117,4316,86,446,563,2021-01-18
317501,JAKARTA TIMUR,MATRAMAN,3569,111,3091,77,290,401,2021-01-18
317403,JAKARTA SELATAN,MAMPANG PRAPATAN,3167,71,2864,49,183,254,2021-01-18
317508,JAKARTA TIMUR,MAKASAR,4386,116,3801,67,402,518,2021-01-18
317203,JAKARTA UTARA,KOJA,5082,96,4300,83,603,699,2021-01-18
317504,JAKARTA TIMUR,KRAMAT JATI,5188,112,4545,92,439,551,2021-01-18
310102,KAB.ADM.KEP.SERIBU,KEP. SERIBU SELATAN,110,1,95,1,13,14,2021-01-18
317308,JAKARTA BARAT,KEMBANGAN,4681,116,4169,68,328,444,2021-01-18
317103,JAKARTA PUSAT,KEMAYORAN,5281,155,4495,103,528,683,2021-01-18
317206,JAKARTA UTARA,KELAPA GADING,3157,80,2694,48,335,415,2021-01-18
317305,JAKARTA BARAT,KEBON JERUK,5730,130,5073,104,423,553,2021-01-18
310101,KAB.ADM.KEP.SERIBU,KEP. SERIBU UTARA,154,0,137,0,17,17,2021-01-18
317104,JAKARTA PUSAT,SENEN,2594,88,2353,48,105,193,2021-01-19
317410,JAKARTA SELATAN,PESANGGRAHAN,3785,64,3371,58,292,356,2021-01-19
317502,JAKARTA TIMUR,PULO GADUNG,5166,125,4649,88,304,429,2021-01-19
317102,JAKARTA PUSAT,SAWAH BESAR,2212,44,2025,45,98,142,2021-01-19
317402,JAKARTA SELATAN,SETIA BUDI,2873,70,2607,45,151,221,2021-01-19
111111,Luar DKI & Proses Update,Luar DKI & Proses Update,143008,137,141294,1273,304,441,2021-01-19
317304,JAKARTA BARAT,TAMBORA,3060,109,2764,72,115,224,2021-01-19
317107,JAKARTA PUSAT,TANAH ABANG,3574,57,3283,69,165,222,2021-01-19
317202,JAKARTA UTARA,TANJUNG PRIOK,6498,112,5774,117,495,607,2021-01-19
317401,JAKARTA SELATAN,TEBET,4244,68,3779,84,313,381,2021-01-19
317201,JAKARTA UTARA,PENJARINGAN,3903,92,3549,63,199,291,2021-01-19
317303,JAKARTA BARAT,TAMAN SARI,2212,54,2010,34,114,168,2021-01-19
317505,JAKARTA TIMUR,PASAR REBO,3900,94,3459,56,291,385,2021-01-19
317404,JAKARTA SELATAN,PASAR MINGGU,5617,130,4998,94,395,525,2021-01-19
317408,JAKARTA SELATAN,PANCORAN,3168,77,2865,48,178,255,2021-01-19
317103,JAKARTA PUSAT,KEMAYORAN,5327,141,4607,103,476,617,2021-01-19
317206,JAKARTA UTARA,KELAPA GADING,3234,90,2761,48,335,425,2021-01-19
317305,JAKARTA BARAT,KEBON JERUK,5821,130,5158,105,428,558,2021-01-19
317405,JAKARTA SELATAN,KEBAYORAN LAMA,5025,119,4416,86,404,523,2021-01-19
317407,JAKARTA SELATAN,KEBAYORAN BARU,3309,71,2928,43,267,338,2021-01-19
317306,JAKARTA BARAT,KALI DERES,4058,84,3642,85,247,331,2021-01-19
317108,JAKARTA PUSAT,JOHAR BARU,2432,44,2193,68,127,171,2021-01-19
317503,JAKARTA TIMUR,JATINEGARA,5066,95,4577,77,317,412,2021-01-19
317409,JAKARTA SELATAN,JAGAKARSA,5380,97,4691,77,515,612,2021-01-19
317302,JAKARTA BARAT,GROGOL PETAMBURAN,4361,146,3801,82,332,478,2021-01-19
317507,JAKARTA TIMUR,DUREN SAWIT,7217,144,6316,148,609,753,2021-01-19
317509,JAKARTA TIMUR,CIRACAS,4537,88,4072,79,298,386,2021-01-19
317510,JAKARTA TIMUR,CIPAYUNG,5218,93,4492,51,582,675,2021-01-19
317204,JAKARTA UTARA,CILINCING,4573,42,4081,84,366,408,2021-01-19
317101,JAKARTA PUSAT,GAMBIR,2296,46,2099,38,113,159,2021-01-19
317106,JAKARTA PUSAT,MENTENG,1948,38,1725,35,150,188,2021-01-19
317307,JAKARTA BARAT,PALMERAH,4407,111,3972,98,226,337,2021-01-19
317205,JAKARTA UTARA,PADEMANGAN,2632,66,2408,49,109,175,2021-01-19
317406,JAKARTA SELATAN,CILANDAK,4067,91,3668,65,243,334,2021-01-19
317501,JAKARTA TIMUR,MATRAMAN,3601,108,3165,78,250,358,2021-01-19
317403,JAKARTA SELATAN,MAMPANG PRAPATAN,3195,71,2921,49,154,225,2021-01-19
317508,JAKARTA TIMUR,MAKASAR,4427,115,3913,69,330,445,2021-01-19
317203,JAKARTA UTARA,KOJA,5139,85,4436,83,535,620,2021-01-19
317504,JAKARTA TIMUR,KRAMAT JATI,5250,113,4661,94,382,495,2021-01-19
310102,KAB.ADM.KEP.SERIBU,KEP. SERIBU SELATAN,110,1,95,1,13,14,2021-01-19
317308,JAKARTA BARAT,KEMBANGAN,4742,103,4240,68,331,434,2021-01-19
317506,JAKARTA TIMUR,CAKUNG,6646,143,5891,101,511,654,2021-01-19
317105,JAKARTA PUSAT,CEMPAKA PUTIH,2879,43,2519,46,271,314,2021-01-19
317301,JAKARTA BARAT,CENGKARENG,7280,133,6648,155,344,477,2021-01-19
310101,KAB.ADM.KEP.SERIBU,KEP. SERIBU UTARA,162,0,142,0,20,20,2021-01-19
317104,JAKARTA PUSAT,SENEN,2613,93,2360,48,112,205,2021-01-20
317410,JAKARTA SELATAN,PESANGGRAHAN,3866,64,3382,59,361,425,2021-01-20
317502,JAKARTA TIMUR,PULO GADUNG,5300,129,4665,89,417,546,2021-01-20
317102,JAKARTA PUSAT,SAWAH BESAR,2245,45,2030,46,124,169,2021-01-20
317402,JAKARTA SELATAN,SETIA BUDI,2927,75,2618,46,188,263,2021-01-20
111111,Luar DKI & Proses Update,Luar DKI & Proses Update,143008,137,141294,1273,304,441,2021-01-20
317304,JAKARTA BARAT,TAMBORA,3095,109,2780,72,134,243,2021-01-20
317107,JAKARTA PUSAT,TANAH ABANG,3592,59,3298,70,165,224,2021-01-20
317202,JAKARTA UTARA,TANJUNG PRIOK,6602,115,5789,118,580,695,2021-01-20
317401,JAKARTA SELATAN,TEBET,4283,73,3793,84,333,406,2021-01-20
317201,JAKARTA UTARA,PENJARINGAN,3988,92,3561,63,272,364,2021-01-20
317303,JAKARTA BARAT,TAMAN SARI,2270,55,2017,34,164,219,2021-01-20
317505,JAKARTA TIMUR,PASAR REBO,3940,101,3480,56,303,404,2021-01-20
317404,JAKARTA SELATAN,PASAR MINGGU,5723,152,5029,94,448,600,2021-01-20
317408,JAKARTA SELATAN,PANCORAN,3234,83,2877,49,225,308,2021-01-20
317506,JAKARTA TIMUR,CAKUNG,6770,152,6018,103,497,649,2021-01-20
317105,JAKARTA PUSAT,CEMPAKA PUTIH,2907,54,2524,46,283,337,2021-01-20
317301,JAKARTA BARAT,CENGKARENG,7463,135,6723,158,447,582,2021-01-20
317406,JAKARTA SELATAN,CILANDAK,4128,99,3689,67,273,372,2021-01-20
317204,JAKARTA UTARA,CILINCING,4610,47,4145,84,334,381,2021-01-20
317510,JAKARTA TIMUR,CIPAYUNG,5250,103,4595,53,499,602,2021-01-20
317509,JAKARTA TIMUR,CIRACAS,4645,100,4098,79,368,468,2021-01-20
317507,JAKARTA TIMUR,DUREN SAWIT,7307,152,6436,149,570,722,2021-01-20
317101,JAKARTA PUSAT,GAMBIR,2311,48,2100,39,124,172,2021-01-20
317409,JAKARTA SELATAN,JAGAKARSA,5489,121,4807,77,484,605,2021-01-20
317503,JAKARTA TIMUR,JATINEGARA,5142,101,4633,77,331,432,2021-01-20
317108,JAKARTA PUSAT,JOHAR BARU,2453,44,2208,71,130,174,2021-01-20
317306,JAKARTA BARAT,KALI DERES,4107,85,3698,85,239,324,2021-01-20
317407,JAKARTA SELATAN,KEBAYORAN BARU,3349,74,2962,44,269,343,2021-01-20
317302,JAKARTA BARAT,GROGOL PETAMBURAN,4443,149,3858,82,354,503,2021-01-20
317305,JAKARTA BARAT,KEBON JERUK,5945,131,5228,106,480,611,2021-01-20
317307,JAKARTA BARAT,PALMERAH,4483,116,4052,100,215,331,2021-01-20
317205,JAKARTA UTARA,PADEMANGAN,2681,67,2419,49,146,213,2021-01-20
317405,JAKARTA SELATAN,KEBAYORAN LAMA,5086,127,4460,87,412,539,2021-01-20
317501,JAKARTA TIMUR,MATRAMAN,3639,109,3180,79,271,380,2021-01-20
317403,JAKARTA SELATAN,MAMPANG PRAPATAN,3257,74,2927,49,207,281,2021-01-20
317508,JAKARTA TIMUR,MAKASAR,4458,126,3975,70,287,413,2021-01-20
317504,JAKARTA TIMUR,KRAMAT JATI,5285,117,4677,95,396,513,2021-01-20
317106,JAKARTA PUSAT,MENTENG,1960,38,1728,35,159,197,2021-01-20
310101,KAB.ADM.KEP.SERIBU,KEP. SERIBU UTARA,164,0,141,1,22,22,2021-01-20
310102,KAB.ADM.KEP.SERIBU,KEP. SERIBU SELATAN,114,1,95,1,17,18,2021-01-20
317308,JAKARTA BARAT,KEMBANGAN,4875,104,4334,68,369,473,2021-01-20
317103,JAKARTA PUSAT,KEMAYORAN,5369,158,4630,104,477,635,2021-01-20
317206,JAKARTA UTARA,KELAPA GADING,3297,96,2808,48,345,441,2021-01-20
317203,JAKARTA UTARA,KOJA,5168,86,4510,84,488,574,2021-01-20
317502,JAKARTA TIMUR,PULO GADUNG,5403,119,4746,90,448,567,2021-01-21
317102,JAKARTA PUSAT,SAWAH BESAR,2288,54,2040,46,148,202,2021-01-21
317104,JAKARTA PUSAT,SENEN,2638,82,2388,48,120,202,2021-01-21
317402,JAKARTA SELATAN,SETIA BUDI,2969,85,2651,46,187,272,2021-01-21
317303,JAKARTA BARAT,TAMAN SARI,2302,50,2045,34,173,223,2021-01-21
317202,JAKARTA UTARA,TANJUNG PRIOK,6728,126,5866,118,618,744,2021-01-21
317107,JAKARTA PUSAT,TANAH ABANG,3604,64,3317,70,153,217,2021-01-21
317401,JAKARTA SELATAN,TEBET,4294,72,3853,85,284,356,2021-01-21
111111,Luar DKI & Proses Update,Luar DKI & Proses Update,143008,137,141294,1273,304,441,2021-01-21
317410,JAKARTA SELATAN,PESANGGRAHAN,3937,69,3434,59,375,444,2021-01-21
317304,JAKARTA BARAT,TAMBORA,3111,94,2805,72,140,234,2021-01-21
317201,JAKARTA UTARA,PENJARINGAN,4044,87,3598,63,296,383,2021-01-21
317409,JAKARTA SELATAN,JAGAKARSA,5558,124,4874,78,482,606,2021-01-21
317404,JAKARTA SELATAN,PASAR MINGGU,5811,139,5150,96,426,565,2021-01-21
317506,JAKARTA TIMUR,CAKUNG,6837,174,6108,106,449,623,2021-01-21
317105,JAKARTA PUSAT,CEMPAKA PUTIH,2937,55,2574,46,262,317,2021-01-21
317301,JAKARTA BARAT,CENGKARENG,7537,129,6777,159,472,601,2021-01-21
317406,JAKARTA SELATAN,CILANDAK,4141,104,3742,67,228,332,2021-01-21
317204,JAKARTA UTARA,CILINCING,4635,43,4182,85,325,368,2021-01-21
317510,JAKARTA TIMUR,CIPAYUNG,5307,101,4629,54,523,624,2021-01-21
317509,JAKARTA TIMUR,CIRACAS,4735,109,4139,81,406,515,2021-01-21
317507,JAKARTA TIMUR,DUREN SAWIT,7455,157,6501,150,647,804,2021-01-21
317101,JAKARTA PUSAT,GAMBIR,2340,60,2114,39,127,187,2021-01-21
317302,JAKARTA BARAT,GROGOL PETAMBURAN,4455,133,3907,82,333,466,2021-01-21
317503,JAKARTA TIMUR,JATINEGARA,5168,98,4668,78,324,422,2021-01-21
317108,JAKARTA PUSAT,JOHAR BARU,2488,45,2223,71,149,194,2021-01-21
317306,JAKARTA BARAT,KALI DERES,4157,65,3741,86,265,330,2021-01-21
317407,JAKARTA SELATAN,KEBAYORAN BARU,3374,68,2997,44,265,333,2021-01-21
317405,JAKARTA SELATAN,KEBAYORAN LAMA,5153,123,4520,88,422,545,2021-01-21
317505,JAKARTA TIMUR,PASAR REBO,3945,100,3535,57,253,353,2021-01-21
317205,JAKARTA UTARA,PADEMANGAN,2693,66,2439,49,139,205,2021-01-21
317408,JAKARTA SELATAN,PANCORAN,3284,85,2951,50,198,283,2021-01-21
317307,JAKARTA BARAT,PALMERAH,4537,113,4095,102,227,340,2021-01-21
317305,JAKARTA BARAT,KEBON JERUK,6036,140,5288,106,502,642,2021-01-21
317106,JAKARTA PUSAT,MENTENG,1999,41,1768,35,155,196,2021-01-21
317501,JAKARTA TIMUR,MATRAMAN,3654,108,3230,80,236,344,2021-01-21
317403,JAKARTA SELATAN,MAMPANG PRAPATAN,3341,75,2976,49,241,316,2021-01-21
317504,JAKARTA TIMUR,KRAMAT JATI,5343,115,4764,97,367,482,2021-01-21
317508,JAKARTA TIMUR,MAKASAR,4506,118,4080,71,237,355,2021-01-21
310101,KAB.ADM.KEP.SERIBU,KEP. SERIBU UTARA,158,0,141,1,16,16,2021-01-21
310102,KAB.ADM.KEP.SERIBU,KEP. SERIBU SELATAN,115,0,101,1,13,13,2021-01-21
317308,JAKARTA BARAT,KEMBANGAN,4896,83,4380,68,365,448,2021-01-21
317103,JAKARTA PUSAT,KEMAYORAN,5422,161,4713,107,441,602,2021-01-21
317206,JAKARTA UTARA,KELAPA GADING,3294,78,2868,48,300,378,2021-01-21
317203,JAKARTA UTARA,KOJA,5234,74,4636,85,439,513,2021-01-21
317402,JAKARTA SELATAN,SETIA BUDI,2989,90,2673,46,180,270,2021-01-22
317502,JAKARTA TIMUR,PULO GADUNG,5451,133,4809,93,416,549,2021-01-22
317102,JAKARTA PUSAT,SAWAH BESAR,2338,62,2055,46,175,237,2021-01-22
317104,JAKARTA PUSAT,SENEN,2659,91,2398,49,121,212,2021-01-22
317303,JAKARTA BARAT,TAMAN SARI,2328,54,2078,36,160,214,2021-01-22
111111,Luar DKI & Proses Update,Luar DKI & Proses Update,143008,137,141294,1273,304,441,2021-01-22
317107,JAKARTA PUSAT,TANAH ABANG,3641,70,3321,70,180,250,2021-01-22
317202,JAKARTA UTARA,TANJUNG PRIOK,6875,177,5907,120,671,848,2021-01-22
317401,JAKARTA SELATAN,TEBET,4390,77,3896,87,330,407,2021-01-22
317410,JAKARTA SELATAN,PESANGGRAHAN,3974,73,3470,59,372,445,2021-01-22
317304,JAKARTA BARAT,TAMBORA,3175,111,2831,72,161,272,2021-01-22
317201,JAKARTA UTARA,PENJARINGAN,4097,98,3642,63,294,392,2021-01-22
317505,JAKARTA TIMUR,PASAR REBO,4002,115,3578,57,252,367,2021-01-22
317404,JAKARTA SELATAN,PASAR MINGGU,5996,142,5203,97,554,696,2021-01-22
317506,JAKARTA TIMUR,CAKUNG,6971,187,6155,108,521,708,2021-01-22
317105,JAKARTA PUSAT,CEMPAKA PUTIH,2966,63,2613,47,243,306,2021-01-22
317301,JAKARTA BARAT,CENGKARENG,7611,169,6819,162,461,630,2021-01-22
317406,JAKARTA SELATAN,CILANDAK,4247,102,3775,67,303,405,2021-01-22
317204,JAKARTA UTARA,CILINCING,4709,52,4238,85,334,386,2021-01-22
317510,JAKARTA TIMUR,CIPAYUNG,5461,106,4745,55,555,661,2021-01-22
317509,JAKARTA TIMUR,CIRACAS,4869,115,4253,81,420,535,2021-01-22
317507,JAKARTA TIMUR,DUREN SAWIT,7582,201,6577,151,653,854,2021-01-22
317101,JAKARTA PUSAT,GAMBIR,2376,70,2127,40,139,209,2021-01-22
317302,JAKARTA BARAT,GROGOL PETAMBURAN,4557,160,3956,82,359,519,2021-01-22
317503,JAKARTA TIMUR,JATINEGARA,5273,121,4737,78,337,458,2021-01-22
317108,JAKARTA PUSAT,JOHAR BARU,2524,48,2239,71,166,214,2021-01-22
317306,JAKARTA BARAT,KALI DERES,4230,85,3751,86,308,393,2021-01-22
317407,JAKARTA SELATAN,KEBAYORAN BARU,3441,76,3029,45,291,367,2021-01-22
317405,JAKARTA SELATAN,KEBAYORAN LAMA,5221,146,4582,89,404,550,2021-01-22
317409,JAKARTA SELATAN,JAGAKARSA,5849,132,4928,80,709,841,2021-01-22
317206,JAKARTA UTARA,KELAPA GADING,3350,90,2916,49,295,385,2021-01-22
317408,JAKARTA SELATAN,PANCORAN,3336,100,2983,50,203,303,2021-01-22
317307,JAKARTA BARAT,PALMERAH,4576,141,4125,103,207,348,2021-01-22
317205,JAKARTA UTARA,PADEMANGAN,2755,72,2464,49,170,242,2021-01-22
317305,JAKARTA BARAT,KEBON JERUK,6127,166,5334,107,520,686,2021-01-22
317106,JAKARTA PUSAT,MENTENG,2036,41,1785,35,175,216,2021-01-22
317501,JAKARTA TIMUR,MATRAMAN,3716,116,3257,83,260,376,2021-01-22
317508,JAKARTA TIMUR,MAKASAR,4655,133,4145,72,305,438,2021-01-22
317403,JAKARTA SELATAN,MAMPANG PRAPATAN,3439,76,3019,52,292,368,2021-01-22
317203,JAKARTA UTARA,KOJA,5304,85,4708,88,423,508,2021-01-22
310101,KAB.ADM.KEP.SERIBU,KEP. SERIBU UTARA,172,0,147,1,24,24,2021-01-22
310102,KAB.ADM.KEP.SERIBU,KEP. SERIBU SELATAN,133,0,106,1,26,26,2021-01-22
317308,JAKARTA BARAT,KEMBANGAN,4998,109,4406,69,414,523,2021-01-22
317103,JAKARTA PUSAT,KEMAYORAN,5518,174,4800,107,437,611,2021-01-22
317504,JAKARTA TIMUR,KRAMAT JATI,5457,130,4837,99,391,521,2021-01-22
317402,JAKARTA SELATAN,SETIA BUDI,3090,79,2705,47,259,338,2021-01-23
317102,JAKARTA PUSAT,SAWAH BESAR,2354,44,2082,46,182,226,2021-01-23
317104,JAKARTA PUSAT,SENEN,2682,54,2444,50,134,188,2021-01-23
317303,JAKARTA BARAT,TAMAN SARI,2361,42,2101,36,182,224,2021-01-23
111111,Luar DKI & Proses Update,Luar DKI & Proses Update,143008,137,141294,1273,304,441,2021-01-23
317107,JAKARTA PUSAT,TANAH ABANG,3679,49,3382,70,178,227,2021-01-23
317202,JAKARTA UTARA,TANJUNG PRIOK,7054,137,6056,122,739,876,2021-01-23
317401,JAKARTA SELATAN,TEBET,4419,59,3951,88,321,380,2021-01-23
317502,JAKARTA TIMUR,PULO GADUNG,5533,103,4891,93,446,549,2021-01-23
317304,JAKARTA BARAT,TAMBORA,3227,69,2890,73,195,264,2021-01-23
317410,JAKARTA SELATAN,PESANGGRAHAN,4056,56,3521,61,418,474,2021-01-23
317503,JAKARTA TIMUR,JATINEGARA,5344,83,4807,78,376,459,2021-01-23
317505,JAKARTA TIMUR,PASAR REBO,4047,93,3653,57,244,337,2021-01-23
317407,JAKARTA SELATAN,KEBAYORAN BARU,3516,62,3074,46,334,396,2021-01-23
317306,JAKARTA BARAT,KALI DERES,4314,67,3800,87,360,427,2021-01-23
317201,JAKARTA UTARA,PENJARINGAN,4181,83,3694,64,340,423,2021-01-23
317409,JAKARTA SELATAN,JAGAKARSA,5900,111,5042,83,664,775,2021-01-23
317302,JAKARTA BARAT,GROGOL PETAMBURAN,4645,109,4038,83,415,524,2021-01-23
317101,JAKARTA PUSAT,GAMBIR,2394,49,2166,40,139,188,2021-01-23
317405,JAKARTA SELATAN,KEBAYORAN LAMA,5323,122,4674,90,437,559,2021-01-23
317507,JAKARTA TIMUR,DUREN SAWIT,7703,161,6699,151,692,853,2021-01-23
317510,JAKARTA TIMUR,CIPAYUNG,5499,77,4903,55,464,541,2021-01-23
317204,JAKARTA UTARA,CILINCING,4771,39,4315,85,332,371,2021-01-23
317406,JAKARTA SELATAN,CILANDAK,4289,76,3860,68,285,361,2021-01-23
317301,JAKARTA BARAT,CENGKARENG,7716,133,6896,162,525,658,2021-01-23
317105,JAKARTA PUSAT,CEMPAKA PUTIH,3027,52,2715,47,213,265,2021-01-23
317506,JAKARTA TIMUR,CAKUNG,7053,118,6281,109,545,663,2021-01-23
317509,JAKARTA TIMUR,CIRACAS,4956,96,4336,81,443,539,2021-01-23
317305,JAKARTA BARAT,KEBON JERUK,6217,143,5507,108,459,602,2021-01-23
317108,JAKARTA PUSAT,JOHAR BARU,2569,30,2278,72,189,219,2021-01-23
317103,JAKARTA PUSAT,KEMAYORAN,5637,125,4918,108,486,611,2021-01-23
317404,JAKARTA SELATAN,PASAR MINGGU,6068,108,5300,100,560,668,2021-01-23
317408,JAKARTA SELATAN,PANCORAN,3412,87,3027,51,247,334,2021-01-23
317307,JAKARTA BARAT,PALMERAH,4667,105,4179,105,278,383,2021-01-23
317206,JAKARTA UTARA,KELAPA GADING,3389,67,3015,51,256,323,2021-01-23
317106,JAKARTA PUSAT,MENTENG,2047,28,1819,35,165,193,2021-01-23
317501,JAKARTA TIMUR,MATRAMAN,3742,62,3367,84,229,291,2021-01-23
317403,JAKARTA SELATAN,MAMPANG PRAPATAN,3494,45,3061,53,335,380,2021-01-23
317205,JAKARTA UTARA,PADEMANGAN,2782,55,2506,51,170,225,2021-01-23
317504,JAKARTA TIMUR,KRAMAT JATI,5506,93,4901,99,413,506,2021-01-23
317203,JAKARTA UTARA,KOJA,5348,59,4866,88,335,394,2021-01-23
310101,KAB.ADM.KEP.SERIBU,KEP. SERIBU UTARA,187,0,148,1,38,38,2021-01-23
310102,KAB.ADM.KEP.SERIBU,KEP. SERIBU SELATAN,158,0,108,1,49,49,2021-01-23
317308,JAKARTA BARAT,KEMBANGAN,5148,88,4489,70,501,589,2021-01-23
317508,JAKARTA TIMUR,MAKASAR,4753,109,4190,74,380,489,2021-01-23
317102,JAKARTA PUSAT,SAWAH BESAR,2368,50,2106,46,166,216,2021-01-24
317104,JAKARTA PUSAT,SENEN,2707,49,2483,50,125,174,2021-01-24
317402,JAKARTA SELATAN,SETIA BUDI,3158,76,2724,47,311,387,2021-01-24
317303,JAKARTA BARAT,TAMAN SARI,2411,51,2112,39,209,260,2021-01-24
317202,JAKARTA UTARA,TANJUNG PRIOK,7280,130,6190,123,837,967,2021-01-24
317107,JAKARTA PUSAT,TANAH ABANG,3708,50,3394,71,193,243,2021-01-24
317401,JAKARTA SELATAN,TEBET,4448,55,3981,92,320,375,2021-01-24
111111,Luar DKI & Proses Update,Luar DKI & Proses Update,143008,137,141294,1273,304,441,2021-01-24
317502,JAKARTA TIMUR,PULO GADUNG,5623,134,4921,94,474,608,2021-01-24
317304,JAKARTA BARAT,TAMBORA,3290,70,2898,74,248,318,2021-01-24
317410,JAKARTA SELATAN,PESANGGRAHAN,4098,57,3614,62,365,422,2021-01-24
317503,JAKARTA TIMUR,JATINEGARA,5435,127,4819,78,411,538,2021-01-24
317505,JAKARTA TIMUR,PASAR REBO,4100,99,3708,58,235,334,2021-01-24
317301,JAKARTA BARAT,CENGKARENG,7846,146,6918,163,619,765,2021-01-24
317406,JAKARTA SELATAN,CILANDAK,4365,75,3869,69,352,427,2021-01-24
317204,JAKARTA UTARA,CILINCING,4809,42,4319,86,362,404,2021-01-24
317510,JAKARTA TIMUR,CIPAYUNG,5550,73,4923,56,498,571,2021-01-24
317509,JAKARTA TIMUR,CIRACAS,5041,94,4347,82,518,612,2021-01-24
317507,JAKARTA TIMUR,DUREN SAWIT,7908,264,6736,152,756,1020,2021-01-24
317101,JAKARTA PUSAT,GAMBIR,2426,51,2178,40,157,208,2021-01-24
317302,JAKARTA BARAT,GROGOL PETAMBURAN,4706,97,4095,84,430,527,2021-01-24
317409,JAKARTA SELATAN,JAGAKARSA,6057,103,5062,84,808,911,2021-01-24
317108,JAKARTA PUSAT,JOHAR BARU,2605,30,2294,73,208,238,2021-01-24
317306,JAKARTA BARAT,KALI DERES,4395,68,3820,87,420,488,2021-01-24
317407,JAKARTA SELATAN,KEBAYORAN BARU,3554,44,3139,47,324,368,2021-01-24
317405,JAKARTA SELATAN,KEBAYORAN LAMA,5419,119,4750,90,460,579,2021-01-24
317305,JAKARTA BARAT,KEBON JERUK,6344,142,5530,109,563,705,2021-01-24
317206,JAKARTA UTARA,KELAPA GADING,3441,60,3034,51,296,356,2021-01-24
317103,JAKARTA PUSAT,KEMAYORAN,5763,125,5007,110,521,646,2021-01-24
317308,JAKARTA BARAT,KEMBANGAN,5266,94,4537,71,564,658,2021-01-24
310102,KAB.ADM.KEP.SERIBU,KEP. SERIBU SELATAN,165,0,108,1,56,56,2021-01-24
310101,KAB.ADM.KEP.SERIBU,KEP. SERIBU UTARA,190,0,150,1,39,39,2021-01-24
317203,JAKARTA UTARA,KOJA,5379,61,4877,89,352,413,2021-01-24
317504,JAKARTA TIMUR,KRAMAT JATI,5574,95,4977,101,401,496,2021-01-24
317105,JAKARTA PUSAT,CEMPAKA PUTIH,3066,49,2726,48,243,292,2021-01-24
317506,JAKARTA TIMUR,CAKUNG,7194,203,6297,110,584,787,2021-01-24
317201,JAKARTA UTARA,PENJARINGAN,4235,85,3714,65,371,456,2021-01-24
317205,JAKARTA UTARA,PADEMANGAN,2836,61,2511,52,212,273,2021-01-24
317408,JAKARTA SELATAN,PANCORAN,3492,89,3035,52,316,405,2021-01-24
317307,JAKARTA BARAT,PALMERAH,4722,93,4239,106,284,377,2021-01-24
317106,JAKARTA PUSAT,MENTENG,2067,35,1840,36,156,191,2021-01-24
317501,JAKARTA TIMUR,MATRAMAN,3782,66,3434,85,197,263,2021-01-24
317403,JAKARTA SELATAN,MAMPANG PRAPATAN,3544,37,3072,53,382,419,2021-01-24
317508,JAKARTA TIMUR,MAKASAR,4899,110,4214,76,499,609,2021-01-24
317404,JAKARTA SELATAN,PASAR MINGGU,6199,103,5323,101,672,775,2021-01-24
317506,JAKARTA TIMUR,CAKUNG,7236,190,6341,112,593,783,2021-01-25
317105,JAKARTA PUSAT,CEMPAKA PUTIH,3084,40,2778,49,217,257,2021-01-25
317301,JAKARTA BARAT,CENGKARENG,7889,132,7023,166,568,700,2021-01-25
317406,JAKARTA SELATAN,CILANDAK,4436,72,3905,70,389,461,2021-01-25
317204,JAKARTA UTARA,CILINCING,4890,44,4393,86,367,411,2021-01-25
317510,JAKARTA TIMUR,CIPAYUNG,5663,63,5044,56,500,563,2021-01-25
317507,JAKARTA TIMUR,DUREN SAWIT,8026,253,6807,155,811,1064,2021-01-25
317101,JAKARTA PUSAT,GAMBIR,2441,48,2210,40,143,191,2021-01-25
317302,JAKARTA BARAT,GROGOL PETAMBURAN,4731,85,4180,84,382,467,2021-01-25
317409,JAKARTA SELATAN,JAGAKARSA,6209,86,5120,86,917,1003,2021-01-25
317503,JAKARTA TIMUR,JATINEGARA,5491,115,4855,79,442,557,2021-01-25
317108,JAKARTA PUSAT,JOHAR BARU,2608,30,2328,75,175,205,2021-01-25
111111,Luar DKI & Proses Update,Luar DKI & Proses Update,143008,137,141294,1273,304,441,2021-01-25
317306,JAKARTA BARAT,KALI DERES,4422,63,3896,87,376,439,2021-01-25
317407,JAKARTA SELATAN,KEBAYORAN BARU,3573,36,3195,48,294,330,2021-01-25
317405,JAKARTA SELATAN,KEBAYORAN LAMA,5461,111,4839,93,418,529,2021-01-25
317509,JAKARTA TIMUR,CIRACAS,5115,79,4405,86,545,624,2021-01-25
317401,JAKARTA SELATAN,TEBET,4503,47,4061,92,303,350,2021-01-25
317305,JAKARTA BARAT,KEBON JERUK,6367,125,5587,109,546,671,2021-01-25
317107,JAKARTA PUSAT,TANAH ABANG,3755,40,3450,71,194,234,2021-01-25
317206,JAKARTA UTARA,KELAPA GADING,3482,57,3071,51,303,360,2021-01-25
317103,JAKARTA PUSAT,KEMAYORAN,5809,115,5136,110,448,563,2021-01-25
317308,JAKARTA BARAT,KEMBANGAN,5285,81,4596,72,536,617,2021-01-25
310102,KAB.ADM.KEP.SERIBU,KEP. SERIBU SELATAN,165,0,110,1,54,54,2021-01-25
310101,KAB.ADM.KEP.SERIBU,KEP. SERIBU UTARA,190,0,152,1,37,37,2021-01-25
317203,JAKARTA UTARA,KOJA,5473,59,4956,89,369,428,2021-01-25
317504,JAKARTA TIMUR,KRAMAT JATI,5683,76,5066,103,438,514,2021-01-25
317508,JAKARTA TIMUR,MAKASAR,4961,104,4263,77,517,621,2021-01-25
317202,JAKARTA UTARA,TANJUNG PRIOK,7314,116,6252,126,820,936,2021-01-25
317501,JAKARTA TIMUR,MATRAMAN,3843,63,3457,84,239,302,2021-01-25
317106,JAKARTA PUSAT,MENTENG,2101,31,1869,36,165,196,2021-01-25
317205,JAKARTA UTARA,PADEMANGAN,2852,57,2537,52,206,263,2021-01-25
317403,JAKARTA SELATAN,MAMPANG PRAPATAN,3576,40,3096,53,387,427,2021-01-25
317408,JAKARTA SELATAN,PANCORAN,3518,77,3064,54,323,400,2021-01-25
317304,JAKARTA BARAT,TAMBORA,3316,56,2932,74,254,310,2021-01-25
317303,JAKARTA BARAT,TAMAN SARI,2424,47,2145,40,192,239,2021-01-25
317307,JAKARTA BARAT,PALMERAH,4751,82,4259,106,304,386,2021-01-25
317104,JAKARTA PUSAT,SENEN,2732,41,2517,50,124,165,2021-01-25
317102,JAKARTA PUSAT,SAWAH BESAR,2389,45,2120,46,178,223,2021-01-25
317402,JAKARTA SELATAN,SETIA BUDI,3170,80,2769,49,272,352,2021-01-25
317410,JAKARTA SELATAN,PESANGGRAHAN,4132,54,3655,63,360,414,2021-01-25
317201,JAKARTA UTARA,PENJARINGAN,4254,78,3777,65,334,412,2021-01-25
317505,JAKARTA TIMUR,PASAR REBO,4236,83,3772,59,322,405,2021-01-25
317404,JAKARTA SELATAN,PASAR MINGGU,6285,106,5372,103,704,810,2021-01-25
317502,JAKARTA TIMUR,PULO GADUNG,5660,129,4965,94,472,601,2021-01-25
317102,JAKARTA PUSAT,SAWAH BESAR,2421,43,2136,47,195,238,2021-01-26
111111,Luar DKI & Proses Update,Luar DKI & Proses Update,143008,137,141294,1273,304,441,2021-01-26
317401,JAKARTA SELATAN,TEBET,4567,45,4102,92,328,373,2021-01-26
317202,JAKARTA UTARA,TANJUNG PRIOK,7439,112,6359,126,842,954,2021-01-26
317107,JAKARTA PUSAT,TANAH ABANG,3796,42,3482,72,200,242,2021-01-26
317304,JAKARTA BARAT,TAMBORA,3356,47,2961,75,273,320,2021-01-26
317303,JAKARTA BARAT,TAMAN SARI,2428,44,2166,40,178,222,2021-01-26
317402,JAKARTA SELATAN,SETIA BUDI,3191,69,2803,49,270,339,2021-01-26
317104,JAKARTA PUSAT,SENEN,2789,38,2537,54,160,198,2021-01-26
317502,JAKARTA TIMUR,PULO GADUNG,5680,121,5047,95,417,538,2021-01-26
317403,JAKARTA SELATAN,MAMPANG PRAPATAN,3582,37,3131,53,361,398,2021-01-26
317201,JAKARTA UTARA,PENJARINGAN,4303,62,3823,65,353,415,2021-01-26
317306,JAKARTA BARAT,KALI DERES,4434,58,3962,88,326,384,2021-01-26
317410,JAKARTA SELATAN,PESANGGRAHAN,4194,52,3703,64,375,427,2021-01-26
317503,JAKARTA TIMUR,JATINEGARA,5507,116,4926,79,386,502,2021-01-26
317409,JAKARTA SELATAN,JAGAKARSA,6229,81,5281,87,780,861,2021-01-26
317302,JAKARTA BARAT,GROGOL PETAMBURAN,4784,78,4233,84,389,467,2021-01-26
317101,JAKARTA PUSAT,GAMBIR,2468,52,2233,40,143,195,2021-01-26
317407,JAKARTA SELATAN,KEBAYORAN BARU,3604,34,3243,51,276,310,2021-01-26
317507,JAKARTA TIMUR,DUREN SAWIT,8058,240,6924,161,733,973,2021-01-26
317510,JAKARTA TIMUR,CIPAYUNG,5679,58,5154,58,409,467,2021-01-26
317204,JAKARTA UTARA,CILINCING,4913,46,4480,86,301,347,2021-01-26
317406,JAKARTA SELATAN,CILANDAK,4448,61,3943,70,374,435,2021-01-26
317301,JAKARTA BARAT,CENGKARENG,8018,124,7076,167,651,775,2021-01-26
317105,JAKARTA PUSAT,CEMPAKA PUTIH,3100,37,2802,49,212,249,2021-01-26
317506,JAKARTA TIMUR,CAKUNG,7272,189,6455,113,515,704,2021-01-26
317509,JAKARTA TIMUR,CIRACAS,5125,70,4446,87,522,592,2021-01-26
317405,JAKARTA SELATAN,KEBAYORAN LAMA,5487,104,4886,96,401,505,2021-01-26
317108,JAKARTA PUSAT,JOHAR BARU,2616,27,2349,75,165,192,2021-01-26
317206,JAKARTA UTARA,KELAPA GADING,3496,51,3130,51,264,315,2021-01-26
317505,JAKARTA TIMUR,PASAR REBO,4248,82,3792,60,314,396,2021-01-26
317404,JAKARTA SELATAN,PASAR MINGGU,6299,97,5494,104,604,701,2021-01-26
317408,JAKARTA SELATAN,PANCORAN,3585,72,3097,55,361,433,2021-01-26
317305,JAKARTA BARAT,KEBON JERUK,6387,113,5678,109,487,600,2021-01-26
317205,JAKARTA UTARA,PADEMANGAN,2896,52,2571,52,221,273,2021-01-26
317106,JAKARTA PUSAT,MENTENG,2119,28,1902,36,153,181,2021-01-26
317501,JAKARTA TIMUR,MATRAMAN,3859,62,3478,86,233,295,2021-01-26
317307,JAKARTA BARAT,PALMERAH,4847,82,4288,107,370,452,2021-01-26
317504,JAKARTA TIMUR,KRAMAT JATI,5705,72,5135,103,395,467,2021-01-26
317203,JAKARTA UTARA,KOJA,5489,55,5047,90,297,352,2021-01-26
310101,KAB.ADM.KEP.SERIBU,KEP. SERIBU UTARA,193,0,160,1,32,32,2021-01-26
310102,KAB.ADM.KEP.SERIBU,KEP. SERIBU SELATAN,176,0,110,2,64,64,2021-01-26
317308,JAKARTA BARAT,KEMBANGAN,5313,78,4631,73,531,609,2021-01-26
317103,JAKARTA PUSAT,KEMAYORAN,5892,112,5205,111,464,576,2021-01-26
317508,JAKARTA TIMUR,MAKASAR,4997,96,4335,78,488,584,2021-01-26
111111,Luar DKI & Proses Update,Luar DKI & Proses Update,143008,137,141294,1273,304,441,2021-01-27
317401,JAKARTA SELATAN,TEBET,4585,40,4131,92,322,362,2021-01-27
317202,JAKARTA UTARA,TANJUNG PRIOK,7577,111,6398,126,942,1053,2021-01-27
317107,JAKARTA PUSAT,TANAH ABANG,3813,41,3503,73,196,237,2021-01-27
317304,JAKARTA BARAT,TAMBORA,3372,47,2983,75,267,314,2021-01-27
317303,JAKARTA BARAT,TAMAN SARI,2460,43,2189,41,187,230,2021-01-27
317402,JAKARTA SELATAN,SETIA BUDI,3214,61,2825,49,279,340,2021-01-27
317104,JAKARTA PUSAT,SENEN,2804,38,2544,54,168,206,2021-01-27
317102,JAKARTA PUSAT,SAWAH BESAR,2429,43,2163,48,175,218,2021-01-27
317502,JAKARTA TIMUR,PULO GADUNG,5701,115,5145,96,345,460,2021-01-27
317201,JAKARTA UTARA,PENJARINGAN,4315,59,3846,66,344,403,2021-01-27
317306,JAKARTA BARAT,KALI DERES,4485,56,3988,88,353,409,2021-01-27
317410,JAKARTA SELATAN,PESANGGRAHAN,4211,52,3736,65,358,410,2021-01-27
317503,JAKARTA TIMUR,JATINEGARA,5523,111,5012,79,321,432,2021-01-27
317409,JAKARTA SELATAN,JAGAKARSA,6256,61,5341,88,766,827,2021-01-27
317302,JAKARTA BARAT,GROGOL PETAMBURAN,4830,69,4268,86,407,476,2021-01-27
317101,JAKARTA PUSAT,GAMBIR,2474,50,2247,40,137,187,2021-01-27
317407,JAKARTA SELATAN,KEBAYORAN BARU,3622,35,3277,52,258,293,2021-01-27
317507,JAKARTA TIMUR,DUREN SAWIT,8080,231,7112,162,575,806,2021-01-27
317510,JAKARTA TIMUR,CIPAYUNG,5691,48,5185,58,400,448,2021-01-27
317204,JAKARTA UTARA,CILINCING,4952,43,4499,87,323,366,2021-01-27
317406,JAKARTA SELATAN,CILANDAK,4476,59,3971,70,376,435,2021-01-27
317301,JAKARTA BARAT,CENGKARENG,8147,121,7124,169,733,854,2021-01-27
317105,JAKARTA PUSAT,CEMPAKA PUTIH,3110,23,2826,49,212,235,2021-01-27
317506,JAKARTA TIMUR,CAKUNG,7285,175,6592,113,405,580,2021-01-27
317509,JAKARTA TIMUR,CIRACAS,5142,56,4542,87,457,513,2021-01-27
317405,JAKARTA SELATAN,KEBAYORAN LAMA,5519,96,4924,97,402,498,2021-01-27
317108,JAKARTA PUSAT,JOHAR BARU,2621,25,2362,75,159,184,2021-01-27
317206,JAKARTA UTARA,KELAPA GADING,3543,35,3174,51,283,318,2021-01-27
317505,JAKARTA TIMUR,PASAR REBO,4269,70,3827,61,311,381,2021-01-27
317404,JAKARTA SELATAN,PASAR MINGGU,6333,76,5556,106,595,671,2021-01-27
317408,JAKARTA SELATAN,PANCORAN,3625,60,3130,56,379,439,2021-01-27
317307,JAKARTA BARAT,PALMERAH,4899,79,4316,108,396,475,2021-01-27
317305,JAKARTA BARAT,KEBON JERUK,6441,112,5728,109,492,604,2021-01-27
317106,JAKARTA PUSAT,MENTENG,2127,29,1912,38,148,177,2021-01-27
317501,JAKARTA TIMUR,MATRAMAN,3863,57,3502,86,218,275,2021-01-27
317403,JAKARTA SELATAN,MAMPANG PRAPATAN,3623,31,3149,53,390,421,2021-01-27
317205,JAKARTA UTARA,PADEMANGAN,2955,51,2579,52,273,324,2021-01-27
317504,JAKARTA TIMUR,KRAMAT JATI,5718,63,5168,104,383,446,2021-01-27
317203,JAKARTA UTARA,KOJA,5505,54,5063,90,298,352,2021-01-27
310101,KAB.ADM.KEP.SERIBU,KEP. SERIBU UTARA,195,0,160,1,34,34,2021-01-27
310102,KAB.ADM.KEP.SERIBU,KEP. SERIBU SELATAN,178,0,110,2,66,66,2021-01-27
317308,JAKARTA BARAT,KEMBANGAN,5397,79,4661,73,584,663,2021-01-27
317103,JAKARTA PUSAT,KEMAYORAN,5929,102,5239,111,477,579,2021-01-27
317508,JAKARTA TIMUR,MAKASAR,5009,89,4363,78,479,568,2021-01-27
317104,JAKARTA PUSAT,SENEN,2825,40,2569,54,162,202,2021-01-28
111111,Luar DKI & Proses Update,Luar DKI & Proses Update,143008,137,141294,1273,304,441,2021-01-28
317401,JAKARTA SELATAN,TEBET,4694,40,4165,95,394,434,2021-01-28
317202,JAKARTA UTARA,TANJUNG PRIOK,7649,103,6510,127,909,1012,2021-01-28
317107,JAKARTA PUSAT,TANAH ABANG,3859,44,3522,73,220,264,2021-01-28
317304,JAKARTA BARAT,TAMBORA,3401,48,3014,75,264,312,2021-01-28
317303,JAKARTA BARAT,TAMAN SARI,2495,45,2239,43,168,213,2021-01-28
317402,JAKARTA SELATAN,SETIA BUDI,3269,71,2877,50,271,342,2021-01-28
317102,JAKARTA PUSAT,SAWAH BESAR,2458,30,2213,50,165,195,2021-01-28
317502,JAKARTA TIMUR,PULO GADUNG,5749,120,5211,97,321,441,2021-01-28
317410,JAKARTA SELATAN,PESANGGRAHAN,4326,56,3811,66,393,449,2021-01-28
317405,JAKARTA SELATAN,KEBAYORAN LAMA,5671,96,4979,100,496,592,2021-01-28
317306,JAKARTA BARAT,KALI DERES,4554,57,4033,89,375,432,2021-01-28
317108,JAKARTA PUSAT,JOHAR BARU,2674,24,2381,75,194,218,2021-01-28
317503,JAKARTA TIMUR,JATINEGARA,5562,120,5056,80,306,426,2021-01-28
317409,JAKARTA SELATAN,JAGAKARSA,6306,63,5411,89,743,806,2021-01-28
317302,JAKARTA BARAT,GROGOL PETAMBURAN,4859,76,4353,86,344,420,2021-01-28
317101,JAKARTA PUSAT,GAMBIR,2509,43,2269,40,157,200,2021-01-28
317507,JAKARTA TIMUR,DUREN SAWIT,8168,252,7173,164,579,831,2021-01-28
317509,JAKARTA TIMUR,CIRACAS,5261,61,4585,87,528,589,2021-01-28
317510,JAKARTA TIMUR,CIPAYUNG,5722,50,5215,59,398,448,2021-01-28
317204,JAKARTA UTARA,CILINCING,4981,41,4537,87,316,357,2021-01-28
317406,JAKARTA SELATAN,CILANDAK,4516,58,4027,70,361,419,2021-01-28
317301,JAKARTA BARAT,CENGKARENG,8187,118,7297,170,602,720,2021-01-28
317105,JAKARTA PUSAT,CEMPAKA PUTIH,3150,26,2852,49,223,249,2021-01-28
317506,JAKARTA TIMUR,CAKUNG,7395,167,6660,114,454,621,2021-01-28
317305,JAKARTA BARAT,KEBON JERUK,6536,114,5853,113,456,570,2021-01-28
317206,JAKARTA UTARA,KELAPA GADING,3603,35,3236,52,280,315,2021-01-28
317407,JAKARTA SELATAN,KEBAYORAN BARU,3677,37,3292,53,295,332,2021-01-28
317308,JAKARTA BARAT,KEMBANGAN,5514,82,4801,74,557,639,2021-01-28
317201,JAKARTA UTARA,PENJARINGAN,4362,67,3938,67,290,357,2021-01-28
317505,JAKARTA TIMUR,PASAR REBO,4301,74,3867,62,298,372,2021-01-28
317404,JAKARTA SELATAN,PASAR MINGGU,6393,76,5635,108,574,650,2021-01-28
317408,JAKARTA SELATAN,PANCORAN,3688,65,3195,56,372,437,2021-01-28
317307,JAKARTA BARAT,PALMERAH,4962,83,4381,111,387,470,2021-01-28
317103,JAKARTA PUSAT,KEMAYORAN,6040,122,5267,114,537,659,2021-01-28
317106,JAKARTA PUSAT,MENTENG,2141,27,1927,38,149,176,2021-01-28
317501,JAKARTA TIMUR,MATRAMAN,3900,62,3533,86,219,281,2021-01-28
317205,JAKARTA UTARA,PADEMANGAN,2967,39,2641,55,232,271,2021-01-28
317403,JAKARTA SELATAN,MAMPANG PRAPATAN,3694,34,3211,53,396,430,2021-01-28
317508,JAKARTA TIMUR,MAKASAR,5083,101,4403,79,500,601,2021-01-28
317504,JAKARTA TIMUR,KRAMAT JATI,5754,69,5203,107,375,444,2021-01-28
317203,JAKARTA UTARA,KOJA,5604,61,5119,92,332,393,2021-01-28
310101,KAB.ADM.KEP.SERIBU,KEP. SERIBU UTARA,210,0,162,1,47,47,2021-01-28
310102,KAB.ADM.KEP.SERIBU,KEP. SERIBU SELATAN,188,0,113,2,73,73,2021-01-28
317402,JAKARTA SELATAN,SETIA BUDI,3428,64,2961,50,353,417,2021-01-29
317401,JAKARTA SELATAN,TEBET,4746,42,4223,95,386,428,2021-01-29
317202,JAKARTA UTARA,TANJUNG PRIOK,7824,104,6598,128,994,1098,2021-01-29
317107,JAKARTA PUSAT,TANAH ABANG,3894,34,3548,73,239,273,2021-01-29
317304,JAKARTA BARAT,TAMBORA,3495,49,3058,78,310,359,2021-01-29
317303,JAKARTA BARAT,TAMAN SARI,2535,49,2260,44,182,231,2021-01-29
111111,Luar DKI & Proses Update,Luar DKI & Proses Update,143008,137,141294,1273,304,441,2021-01-29
317104,JAKARTA PUSAT,SENEN,2861,47,2584,55,175,222,2021-01-29
317407,JAKARTA SELATAN,KEBAYORAN BARU,3718,30,3329,54,305,335,2021-01-29
317502,JAKARTA TIMUR,PULO GADUNG,5783,113,5298,98,274,387,2021-01-29
317102,JAKARTA PUSAT,SAWAH BESAR,2489,34,2257,50,148,182,2021-01-29
317306,JAKARTA BARAT,KALI DERES,4696,53,4065,90,488,541,2021-01-29
317108,JAKARTA PUSAT,JOHAR BARU,2732,25,2412,76,219,244,2021-01-29
317503,JAKARTA TIMUR,JATINEGARA,5593,115,5084,81,313,428,2021-01-29
317409,JAKARTA SELATAN,JAGAKARSA,6490,55,5581,89,765,820,2021-01-29
317302,JAKARTA BARAT,GROGOL PETAMBURAN,4972,66,4388,86,432,498,2021-01-29
317101,JAKARTA PUSAT,GAMBIR,2558,41,2285,41,191,232,2021-01-29
317507,JAKARTA TIMUR,DUREN SAWIT,8247,234,7296,166,551,785,2021-01-29
317509,JAKARTA TIMUR,CIRACAS,5311,60,4655,90,506,566,2021-01-29
317510,JAKARTA TIMUR,CIPAYUNG,5828,57,5255,59,457,514,2021-01-29
317204,JAKARTA UTARA,CILINCING,5037,59,4548,87,343,402,2021-01-29
317406,JAKARTA SELATAN,CILANDAK,4610,45,4132,70,363,408,2021-01-29
317301,JAKARTA BARAT,CENGKARENG,8233,96,7374,172,591,687,2021-01-29
317105,JAKARTA PUSAT,CEMPAKA PUTIH,3173,28,2899,49,197,225,2021-01-29
317506,JAKARTA TIMUR,CAKUNG,7459,174,6744,117,424,598,2021-01-29
317305,JAKARTA BARAT,KEBON JERUK,6677,102,5906,113,556,658,2021-01-29
317206,JAKARTA UTARA,KELAPA GADING,3636,37,3260,52,287,324,2021-01-29
317405,JAKARTA SELATAN,KEBAYORAN LAMA,5731,91,5067,101,472,563,2021-01-29
317308,JAKARTA BARAT,KEMBANGAN,5632,81,4860,76,615,696,2021-01-29
317410,JAKARTA SELATAN,PESANGGRAHAN,4368,46,3870,67,385,431,2021-01-29
317201,JAKARTA UTARA,PENJARINGAN,4402,68,3964,67,303,371,2021-01-29
317505,JAKARTA TIMUR,PASAR REBO,4369,76,3895,62,336,412,2021-01-29
317404,JAKARTA SELATAN,PASAR MINGGU,6540,82,5757,110,591,673,2021-01-29
317103,JAKARTA PUSAT,KEMAYORAN,6098,134,5302,115,547,681,2021-01-29
317307,JAKARTA BARAT,PALMERAH,5071,70,4422,111,468,538,2021-01-29
317205,JAKARTA UTARA,PADEMANGAN,3005,47,2663,55,240,287,2021-01-29
317106,JAKARTA PUSAT,MENTENG,2176,30,1963,38,145,175,2021-01-29
317408,JAKARTA SELATAN,PANCORAN,3757,71,3228,58,400,471,2021-01-29
317403,JAKARTA SELATAN,MAMPANG PRAPATAN,3840,28,3285,53,474,502,2021-01-29
317508,JAKARTA TIMUR,MAKASAR,5144,106,4431,79,528,634,2021-01-29
317504,JAKARTA TIMUR,KRAMAT JATI,5855,74,5236,109,436,510,2021-01-29
317203,JAKARTA UTARA,KOJA,5653,76,5143,92,342,418,2021-01-29
310101,KAB.ADM.KEP.SERIBU,KEP. SERIBU UTARA,217,0,164,1,52,52,2021-01-29
310102,KAB.ADM.KEP.SERIBU,KEP. SERIBU SELATAN,191,0,114,2,75,75,2021-01-29
317501,JAKARTA TIMUR,MATRAMAN,3925,61,3552,87,225,286,2021-01-29
111111,Luar DKI & Proses Update,Luar DKI & Proses Update,143008,137,141294,1273,304,441,2021-01-30
317402,JAKARTA SELATAN,SETIA BUDI,3436,53,2983,50,350,403,2021-01-30
317401,JAKARTA SELATAN,TEBET,4899,28,4287,95,489,517,2021-01-30
317202,JAKARTA UTARA,TANJUNG PRIOK,7911,78,6714,128,991,1069,2021-01-30
317107,JAKARTA PUSAT,TANAH ABANG,3986,27,3560,74,325,352,2021-01-30
317304,JAKARTA BARAT,TAMBORA,3536,32,3120,79,305,337,2021-01-30
317303,JAKARTA BARAT,TAMAN SARI,2546,37,2283,44,182,219,2021-01-30
317104,JAKARTA PUSAT,SENEN,2906,42,2597,56,211,253,2021-01-30
317103,JAKARTA PUSAT,KEMAYORAN,6299,117,5350,118,714,831,2021-01-30
317502,JAKARTA TIMUR,PULO GADUNG,5895,86,5359,98,352,438,2021-01-30
317407,JAKARTA SELATAN,KEBAYORAN BARU,3846,18,3393,56,379,397,2021-01-30
317305,JAKARTA BARAT,KEBON JERUK,6799,95,6010,113,581,676,2021-01-30
317206,JAKARTA UTARA,KELAPA GADING,3649,22,3298,52,277,299,2021-01-30
317307,JAKARTA BARAT,PALMERAH,5115,47,4459,111,498,545,2021-01-30
317308,JAKARTA BARAT,KEMBANGAN,5711,63,4953,76,619,682,2021-01-30
310102,KAB.ADM.KEP.SERIBU,KEP. SERIBU SELATAN,195,0,132,2,61,61,2021-01-30
310101,KAB.ADM.KEP.SERIBU,KEP. SERIBU UTARA,221,0,170,1,50,50,2021-01-30
317203,JAKARTA UTARA,KOJA,5672,59,5216,92,305,364,2021-01-30
317504,JAKARTA TIMUR,KRAMAT JATI,5977,55,5287,112,523,578,2021-01-30
317508,JAKARTA TIMUR,MAKASAR,5197,83,4576,79,459,542,2021-01-30
317403,JAKARTA SELATAN,MAMPANG PRAPATAN,3884,25,3386,53,420,445,2021-01-30
317501,JAKARTA TIMUR,MATRAMAN,4030,53,3581,87,309,362,2021-01-30
317106,JAKARTA PUSAT,MENTENG,2216,27,1973,38,178,205,2021-01-30
317205,JAKARTA UTARA,PADEMANGAN,3018,35,2705,55,223,258,2021-01-30
317102,JAKARTA PUSAT,SAWAH BESAR,2536,20,2276,50,190,210,2021-01-30
317306,JAKARTA BARAT,KALI DERES,4767,44,4130,94,499,543,2021-01-30
317108,JAKARTA PUSAT,JOHAR BARU,2814,15,2449,76,274,289,2021-01-30
317405,JAKARTA SELATAN,KEBAYORAN LAMA,5852,69,5125,102,556,625,2021-01-30
317409,JAKARTA SELATAN,JAGAKARSA,6515,38,5760,90,627,665,2021-01-30
317410,JAKARTA SELATAN,PESANGGRAHAN,4525,40,3899,68,518,558,2021-01-30
317201,JAKARTA UTARA,PENJARINGAN,4464,50,4031,67,316,366,2021-01-30
317505,JAKARTA TIMUR,PASAR REBO,4486,59,3952,64,411,470,2021-01-30
317404,JAKARTA SELATAN,PASAR MINGGU,6576,70,5887,111,508,578,2021-01-30
317408,JAKARTA SELATAN,PANCORAN,3769,60,3272,58,379,439,2021-01-30
317503,JAKARTA TIMUR,JATINEGARA,5653,94,5184,83,292,386,2021-01-30
317105,JAKARTA PUSAT,CEMPAKA PUTIH,3288,58,2924,49,257,315,2021-01-30
317301,JAKARTA BARAT,CENGKARENG,8341,80,7430,174,657,737,2021-01-30
317506,JAKARTA TIMUR,CAKUNG,7635,162,6862,117,494,656,2021-01-30
317204,JAKARTA UTARA,CILINCING,5079,47,4622,87,323,370,2021-01-30
317510,JAKARTA TIMUR,CIPAYUNG,6071,48,5363,60,600,648,2021-01-30
317509,JAKARTA TIMUR,CIRACAS,5403,48,4775,92,488,536,2021-01-30
317507,JAKARTA TIMUR,DUREN SAWIT,8446,195,7429,167,655,850,2021-01-30
317101,JAKARTA PUSAT,GAMBIR,2585,37,2330,41,177,214,2021-01-30
317302,JAKARTA BARAT,GROGOL PETAMBURAN,5064,50,4487,86,441,491,2021-01-30
317406,JAKARTA SELATAN,CILANDAK,4694,36,4188,71,399,435,2021-01-30
111111,Luar DKI & Proses Update,Luar DKI & Proses Update,143008,137,141294,1273,304,441,2021-02-01
317303,JAKARTA BARAT,TAMAN SARI,2591,50,2324,44,173,223,2021-02-01
317401,JAKARTA SELATAN,TEBET,5017,63,4384,97,473,536,2021-02-01
317202,JAKARTA UTARA,TANJUNG PRIOK,8109,110,7001,129,869,979,2021-02-01
317107,JAKARTA PUSAT,TANAH ABANG,4074,51,3649,74,300,351,2021-02-01
317304,JAKARTA BARAT,TAMBORA,3619,71,3206,80,262,333,2021-02-01
317402,JAKARTA SELATAN,SETIA BUDI,3530,52,3147,53,278,330,2021-02-01
317103,JAKARTA PUSAT,KEMAYORAN,6407,132,5564,119,592,724,2021-02-01
317102,JAKARTA PUSAT,SAWAH BESAR,2609,36,2333,50,190,226,2021-02-01
317405,JAKARTA SELATAN,KEBAYORAN LAMA,6017,113,5285,103,516,629,2021-02-01
317305,JAKARTA BARAT,KEBON JERUK,6943,137,6210,120,476,613,2021-02-01
317206,JAKARTA UTARA,KELAPA GADING,3800,34,3376,58,332,366,2021-02-01
317308,JAKARTA BARAT,KEMBANGAN,5924,103,5137,77,607,710,2021-02-01
310102,KAB.ADM.KEP.SERIBU,KEP. SERIBU SELATAN,197,0,157,2,38,38,2021-02-01
310101,KAB.ADM.KEP.SERIBU,KEP. SERIBU UTARA,223,0,186,1,36,36,2021-02-01
317203,JAKARTA UTARA,KOJA,5876,120,5285,94,377,497,2021-02-01
317504,JAKARTA TIMUR,KRAMAT JATI,6135,99,5451,116,469,568,2021-02-01
317508,JAKARTA TIMUR,MAKASAR,5407,182,4802,81,342,524,2021-02-01
317104,JAKARTA PUSAT,SENEN,2969,44,2645,57,223,267,2021-02-01
317403,JAKARTA SELATAN,MAMPANG PRAPATAN,3993,60,3471,54,408,468,2021-02-01
317501,JAKARTA TIMUR,MATRAMAN,4170,76,3679,88,327,403,2021-02-01
317106,JAKARTA PUSAT,MENTENG,2255,37,2022,39,157,194,2021-02-01
317205,JAKARTA UTARA,PADEMANGAN,3090,48,2746,57,239,287,2021-02-01
317307,JAKARTA BARAT,PALMERAH,5223,86,4596,113,428,514,2021-02-01
317306,JAKARTA BARAT,KALI DERES,4908,98,4253,97,460,558,2021-02-01
317108,JAKARTA PUSAT,JOHAR BARU,2856,29,2502,77,248,277,2021-02-01
317407,JAKARTA SELATAN,KEBAYORAN BARU,3923,44,3503,56,320,364,2021-02-01
317409,JAKARTA SELATAN,JAGAKARSA,6858,136,5963,93,666,802,2021-02-01
317502,JAKARTA TIMUR,PULO GADUNG,6143,123,5494,99,427,550,2021-02-01
317410,JAKARTA SELATAN,PESANGGRAHAN,4683,78,4017,69,519,597,2021-02-01
317201,JAKARTA UTARA,PENJARINGAN,4598,86,4146,67,299,385,2021-02-01
317505,JAKARTA TIMUR,PASAR REBO,4644,95,4035,65,449,544,2021-02-01
317404,JAKARTA SELATAN,PASAR MINGGU,6883,140,6086,115,542,682,2021-02-01
317503,JAKARTA TIMUR,JATINEGARA,5909,122,5297,87,403,525,2021-02-01
317105,JAKARTA PUSAT,CEMPAKA PUTIH,3335,61,3038,51,185,246,2021-02-01
317301,JAKARTA BARAT,CENGKARENG,8551,141,7596,179,635,776,2021-02-01
317506,JAKARTA TIMUR,CAKUNG,7872,248,6991,118,515,763,2021-02-01
317406,JAKARTA SELATAN,CILANDAK,4964,128,4318,71,447,575,2021-02-01
317204,JAKARTA UTARA,CILINCING,5352,153,4721,88,390,543,2021-02-01
317510,JAKARTA TIMUR,CIPAYUNG,6269,86,5495,64,624,710,2021-02-01
317509,JAKARTA TIMUR,CIRACAS,5548,92,4947,93,416,508,2021-02-01
317507,JAKARTA TIMUR,DUREN SAWIT,8823,304,7633,171,715,1019,2021-02-01
317101,JAKARTA PUSAT,GAMBIR,2640,39,2382,41,178,217,2021-02-01
317302,JAKARTA BARAT,GROGOL PETAMBURAN,5217,76,4614,90,437,513,2021-02-01
317408,JAKARTA SELATAN,PANCORAN,3864,74,3385,58,347,421,2021-02-01
317303,JAKARTA BARAT,TAMAN SARI,2609,52,2382,44,131,183,2021-02-02
111111,Luar DKI & Proses Update,Luar DKI & Proses Update,143008,137,141294,1273,304,441,2021-02-02
317401,JAKARTA SELATAN,TEBET,5089,63,4478,98,450,513,2021-02-02
317202,JAKARTA UTARA,TANJUNG PRIOK,8265,112,7240,129,784,896,2021-02-02
317107,JAKARTA PUSAT,TANAH ABANG,4111,51,3693,75,292,343,2021-02-02
317304,JAKARTA BARAT,TAMBORA,3631,64,3259,80,228,292,2021-02-02
317402,JAKARTA SELATAN,SETIA BUDI,3577,46,3221,54,256,302,2021-02-02
317104,JAKARTA PUSAT,SENEN,3014,47,2663,57,247,294,2021-02-02
317102,JAKARTA PUSAT,SAWAH BESAR,2644,36,2345,50,213,249,2021-02-02
317405,JAKARTA SELATAN,KEBAYORAN LAMA,6109,106,5452,104,447,553,2021-02-02
317407,JAKARTA SELATAN,KEBAYORAN BARU,4006,43,3545,56,362,405,2021-02-02
317306,JAKARTA BARAT,KALI DERES,5001,95,4423,97,386,481,2021-02-02
317108,JAKARTA PUSAT,JOHAR BARU,2885,29,2568,77,211,240,2021-02-02
317503,JAKARTA TIMUR,JATINEGARA,5971,119,5330,87,435,554,2021-02-02
317409,JAKARTA SELATAN,JAGAKARSA,7016,135,6107,94,680,815,2021-02-02
317302,JAKARTA BARAT,GROGOL PETAMBURAN,5319,80,4696,90,453,533,2021-02-02
317206,JAKARTA UTARA,KELAPA GADING,3824,31,3472,58,263,294,2021-02-02
317101,JAKARTA PUSAT,GAMBIR,2669,36,2412,41,180,216,2021-02-02
317509,JAKARTA TIMUR,CIRACAS,5644,88,5116,94,346,434,2021-02-02
317510,JAKARTA TIMUR,CIPAYUNG,6392,90,5591,65,646,736,2021-02-02
317204,JAKARTA UTARA,CILINCING,5448,143,4820,92,393,536,2021-02-02
317406,JAKARTA SELATAN,CILANDAK,5048,125,4388,71,464,589,2021-02-02
317301,JAKARTA BARAT,CENGKARENG,8707,141,7734,181,651,792,2021-02-02
317105,JAKARTA PUSAT,CEMPAKA PUTIH,3342,57,3061,52,172,229,2021-02-02
317506,JAKARTA TIMUR,CAKUNG,8030,245,7115,120,550,795,2021-02-02
317507,JAKARTA TIMUR,DUREN SAWIT,8986,298,7736,172,780,1078,2021-02-02
317103,JAKARTA PUSAT,KEMAYORAN,6477,134,5729,120,494,628,2021-02-02
317305,JAKARTA BARAT,KEBON JERUK,7013,138,6305,122,448,586,2021-02-02
310102,KAB.ADM.KEP.SERIBU,KEP. SERIBU SELATAN,198,0,165,2,31,31,2021-02-02
317502,JAKARTA TIMUR,PULO GADUNG,6214,122,5553,102,437,559,2021-02-02
317410,JAKARTA SELATAN,PESANGGRAHAN,4760,77,4117,71,495,572,2021-02-02
317201,JAKARTA UTARA,PENJARINGAN,4631,85,4213,67,266,351,2021-02-02
317505,JAKARTA TIMUR,PASAR REBO,4716,96,4126,68,426,522,2021-02-02
317404,JAKARTA SELATAN,PASAR MINGGU,7016,133,6209,116,558,691,2021-02-02
317308,JAKARTA BARAT,KEMBANGAN,6104,104,5398,77,525,629,2021-02-02
317307,JAKARTA BARAT,PALMERAH,5281,82,4686,114,399,481,2021-02-02
317205,JAKARTA UTARA,PADEMANGAN,3152,46,2827,57,222,268,2021-02-02
317408,JAKARTA SELATAN,PANCORAN,3955,68,3501,59,327,395,2021-02-02
317501,JAKARTA TIMUR,MATRAMAN,4201,74,3759,89,279,353,2021-02-02
317403,JAKARTA SELATAN,MAMPANG PRAPATAN,4067,57,3618,57,335,392,2021-02-02
317508,JAKARTA TIMUR,MAKASAR,5505,185,4898,82,340,525,2021-02-02
317504,JAKARTA TIMUR,KRAMAT JATI,6209,99,5521,118,471,570,2021-02-02
317203,JAKARTA UTARA,KOJA,5943,121,5460,95,267,388,2021-02-02
310101,KAB.ADM.KEP.SERIBU,KEP. SERIBU UTARA,235,1,194,1,39,40,2021-02-02
317106,JAKARTA PUSAT,MENTENG,2273,37,2038,39,159,196,2021-02-02
111111,Luar DKI & Proses Update,Luar DKI & Proses Update,143008,137,141294,1273,304,441,2021-02-03
317304,JAKARTA BARAT,TAMBORA,3738,54,3349,81,254,308,2021-02-03
317401,JAKARTA SELATAN,TEBET,5121,59,4486,99,477,536,2021-02-03
317202,JAKARTA UTARA,TANJUNG PRIOK,8526,97,7354,133,942,1039,2021-02-03
317107,JAKARTA PUSAT,TANAH ABANG,4165,46,3704,75,340,386,2021-02-03
317303,JAKARTA BARAT,TAMAN SARI,2646,32,2408,44,162,194,2021-02-03
317402,JAKARTA SELATAN,SETIA BUDI,3647,42,3250,54,301,343,2021-02-03
317104,JAKARTA PUSAT,SENEN,3053,37,2674,58,284,321,2021-02-03
317206,JAKARTA UTARA,KELAPA GADING,3891,24,3486,58,323,347,2021-02-03
317103,JAKARTA PUSAT,KEMAYORAN,6602,97,5770,120,615,712,2021-02-03
317308,JAKARTA BARAT,KEMBANGAN,6161,91,5424,78,568,659,2021-02-03
310102,KAB.ADM.KEP.SERIBU,KEP. SERIBU SELATAN,206,0,165,2,39,39,2021-02-03
310101,KAB.ADM.KEP.SERIBU,KEP. SERIBU UTARA,274,1,226,1,46,47,2021-02-03
317203,JAKARTA UTARA,KOJA,5990,105,5480,95,310,415,2021-02-03
317504,JAKARTA TIMUR,KRAMAT JATI,6302,92,5533,120,557,649,2021-02-03
317305,JAKARTA BARAT,KEBON JERUK,7118,129,6326,123,540,669,2021-02-03
317508,JAKARTA TIMUR,MAKASAR,5563,172,4924,82,385,557,2021-02-03
317501,JAKARTA TIMUR,MATRAMAN,4279,53,3780,90,356,409,2021-02-03
317106,JAKARTA PUSAT,MENTENG,2308,28,2048,41,191,219,2021-02-03
317205,JAKARTA UTARA,PADEMANGAN,3215,38,2861,58,258,296,2021-02-03
317307,JAKARTA BARAT,PALMERAH,5402,75,4735,115,477,552,2021-02-03
317408,JAKARTA SELATAN,PANCORAN,3992,61,3532,59,340,401,2021-02-03
317404,JAKARTA SELATAN,PASAR MINGGU,7125,138,6226,116,645,783,2021-02-03
317505,JAKARTA TIMUR,PASAR REBO,4800,80,4156,68,496,576,2021-02-03
317403,JAKARTA SELATAN,MAMPANG PRAPATAN,4133,50,3627,60,396,446,2021-02-03
317407,JAKARTA SELATAN,KEBAYORAN BARU,4045,52,3551,56,386,438,2021-02-03
317405,JAKARTA SELATAN,KEBAYORAN LAMA,6156,102,5474,104,476,578,2021-02-03
317108,JAKARTA PUSAT,JOHAR BARU,2901,26,2576,77,222,248,2021-02-03
317102,JAKARTA PUSAT,SAWAH BESAR,2680,26,2358,50,246,272,2021-02-03
317502,JAKARTA TIMUR,PULO GADUNG,6320,74,5610,103,533,607,2021-02-03
317410,JAKARTA SELATAN,PESANGGRAHAN,4805,72,4137,73,523,595,2021-02-03
317201,JAKARTA UTARA,PENJARINGAN,4688,75,4238,68,307,382,2021-02-03
317506,JAKARTA TIMUR,CAKUNG,8145,145,7220,122,658,803,2021-02-03
317105,JAKARTA PUSAT,CEMPAKA PUTIH,3384,58,3075,52,199,257,2021-02-03
317306,JAKARTA BARAT,KALI DERES,5064,85,4440,100,439,524,2021-02-03
317406,JAKARTA SELATAN,CILANDAK,5161,134,4403,73,551,685,2021-02-03
317301,JAKARTA BARAT,CENGKARENG,8798,114,7770,181,733,847,2021-02-03
317510,JAKARTA TIMUR,CIPAYUNG,6503,87,5609,65,742,829,2021-02-03
317509,JAKARTA TIMUR,CIRACAS,5788,88,5125,96,479,567,2021-02-03
317507,JAKARTA TIMUR,DUREN SAWIT,9152,184,7865,174,929,1113,2021-02-03
317101,JAKARTA PUSAT,GAMBIR,2693,24,2436,41,192,216,2021-02-03
317302,JAKARTA BARAT,GROGOL PETAMBURAN,5381,74,4709,93,505,579,2021-02-03
317409,JAKARTA SELATAN,JAGAKARSA,7189,138,6117,94,840,978,2021-02-03
317503,JAKARTA TIMUR,JATINEGARA,6049,67,5397,89,496,563,2021-02-03
317204,JAKARTA UTARA,CILINCING,5522,136,4834,92,460,596,2021-02-03
111111,Luar DKI & Proses Update,Luar DKI & Proses Update,143008,137,141294,1273,304,441,2021-02-04
317304,JAKARTA BARAT,TAMBORA,3839,64,3410,81,284,348,2021-02-04
317401,JAKARTA SELATAN,TEBET,5176,76,4572,100,428,504,2021-02-04
317202,JAKARTA UTARA,TANJUNG PRIOK,8639,124,7499,134,882,1006,2021-02-04
317107,JAKARTA PUSAT,TANAH ABANG,4190,51,3775,75,289,340,2021-02-04
317303,JAKARTA BARAT,TAMAN SARI,2694,39,2430,44,181,220,2021-02-04
317402,JAKARTA SELATAN,SETIA BUDI,3706,47,3272,57,330,377,2021-02-04
317104,JAKARTA PUSAT,SENEN,3069,39,2759,58,213,252,2021-02-04
317405,JAKARTA SELATAN,KEBAYORAN LAMA,6241,111,5540,105,485,596,2021-02-04
317407,JAKARTA SELATAN,KEBAYORAN BARU,4082,57,3604,56,365,422,2021-02-04
317306,JAKARTA BARAT,KALI DERES,5168,102,4482,100,484,586,2021-02-04
317108,JAKARTA PUSAT,JOHAR BARU,2929,29,2585,77,238,267,2021-02-04
317503,JAKARTA TIMUR,JATINEGARA,6099,78,5471,90,460,538,2021-02-04
317409,JAKARTA SELATAN,JAGAKARSA,7313,150,6278,98,787,937,2021-02-04
317302,JAKARTA BARAT,GROGOL PETAMBURAN,5471,84,4790,95,502,586,2021-02-04
317206,JAKARTA UTARA,KELAPA GADING,3986,32,3523,60,371,403,2021-02-04
317101,JAKARTA PUSAT,GAMBIR,2718,33,2472,41,172,205,2021-02-04
317509,JAKARTA TIMUR,CIRACAS,5826,91,5156,96,483,574,2021-02-04
317510,JAKARTA TIMUR,CIPAYUNG,6550,95,5691,65,699,794,2021-02-04
317204,JAKARTA UTARA,CILINCING,5644,153,4869,92,530,683,2021-02-04
317406,JAKARTA SELATAN,CILANDAK,5236,142,4493,73,528,670,2021-02-04
317301,JAKARTA BARAT,CENGKARENG,8937,125,7972,182,658,783,2021-02-04
317105,JAKARTA PUSAT,CEMPAKA PUTIH,3420,62,3095,53,210,272,2021-02-04
317506,JAKARTA TIMUR,CAKUNG,8263,200,7276,123,664,864,2021-02-04
317507,JAKARTA TIMUR,DUREN SAWIT,9292,232,7987,179,894,1126,2021-02-04
317103,JAKARTA PUSAT,KEMAYORAN,6677,112,5865,120,580,692,2021-02-04
317305,JAKARTA BARAT,KEBON JERUK,7257,142,6376,125,614,756,2021-02-04
310102,KAB.ADM.KEP.SERIBU,KEP. SERIBU SELATAN,202,0,188,2,12,12,2021-02-04
317102,JAKARTA PUSAT,SAWAH BESAR,2710,30,2412,50,218,248,2021-02-04
317502,JAKARTA TIMUR,PULO GADUNG,6449,117,5653,103,576,693,2021-02-04
317410,JAKARTA SELATAN,PESANGGRAHAN,4849,78,4213,74,484,562,2021-02-04
317201,JAKARTA UTARA,PENJARINGAN,4835,105,4308,68,354,459,2021-02-04
317505,JAKARTA TIMUR,PASAR REBO,4872,111,4249,69,443,554,2021-02-04
317404,JAKARTA SELATAN,PASAR MINGGU,7271,146,6313,117,695,841,2021-02-04
317308,JAKARTA BARAT,KEMBANGAN,6327,151,5479,79,618,769,2021-02-04
317307,JAKARTA BARAT,PALMERAH,5515,118,4854,115,428,546,2021-02-04
317408,JAKARTA SELATAN,PANCORAN,4070,65,3615,60,330,395,2021-02-04
317106,JAKARTA PUSAT,MENTENG,2327,30,2104,41,152,182,2021-02-04
317501,JAKARTA TIMUR,MATRAMAN,4310,57,3804,92,357,414,2021-02-04
317403,JAKARTA SELATAN,MAMPANG PRAPATAN,4180,57,3644,62,417,474,2021-02-04
317508,JAKARTA TIMUR,MAKASAR,5635,185,4981,83,386,571,2021-02-04
317504,JAKARTA TIMUR,KRAMAT JATI,6376,100,5619,122,535,635,2021-02-04
317203,JAKARTA UTARA,KOJA,6173,124,5502,97,450,574,2021-02-04
310101,KAB.ADM.KEP.SERIBU,KEP. SERIBU UTARA,272,2,239,1,30,32,2021-02-04
317205,JAKARTA UTARA,PADEMANGAN,3242,40,2918,59,225,265,2021-02-04
317107,JAKARTA PUSAT,TANAH ABANG,4250,51,3791,75,333,384,2021-02-05
111111,Luar DKI & Proses Update,Luar DKI & Proses Update,143008,137,141294,1273,304,441,2021-02-05
317401,JAKARTA SELATAN,TEBET,5204,76,4612,100,416,492,2021-02-05
317202,JAKARTA UTARA,TANJUNG PRIOK,8745,131,7597,136,881,1012,2021-02-05
317304,JAKARTA BARAT,TAMBORA,3883,64,3457,82,280,344,2021-02-05
317305,JAKARTA BARAT,KEBON JERUK,7420,135,6521,126,638,773,2021-02-05
317402,JAKARTA SELATAN,SETIA BUDI,3745,44,3338,59,304,348,2021-02-05
317206,JAKARTA UTARA,KELAPA GADING,4039,45,3552,60,382,427,2021-02-05
317405,JAKARTA SELATAN,KEBAYORAN LAMA,6301,104,5595,105,497,601,2021-02-05
317407,JAKARTA SELATAN,KEBAYORAN BARU,4145,71,3658,56,360,431,2021-02-05
317306,JAKARTA BARAT,KALI DERES,5236,111,4527,100,498,609,2021-02-05
317108,JAKARTA PUSAT,JOHAR BARU,2975,26,2623,77,249,275,2021-02-05
317503,JAKARTA TIMUR,JATINEGARA,6206,64,5536,93,513,577,2021-02-05
317409,JAKARTA SELATAN,JAGAKARSA,7390,154,6341,99,796,950,2021-02-05
317302,JAKARTA BARAT,GROGOL PETAMBURAN,5528,77,4825,99,527,604,2021-02-05
317101,JAKARTA PUSAT,GAMBIR,2787,44,2491,42,210,254,2021-02-05
317507,JAKARTA TIMUR,DUREN SAWIT,9431,230,8096,179,926,1156,2021-02-05
317509,JAKARTA TIMUR,CIRACAS,5886,93,5195,98,500,593,2021-02-05
317510,JAKARTA TIMUR,CIPAYUNG,6673,91,5799,65,718,809,2021-02-05
317204,JAKARTA UTARA,CILINCING,5715,160,4920,94,541,701,2021-02-05
317406,JAKARTA SELATAN,CILANDAK,5350,147,4534,73,596,743,2021-02-05
317301,JAKARTA BARAT,CENGKARENG,9031,127,8054,183,667,794,2021-02-05
317105,JAKARTA PUSAT,CEMPAKA PUTIH,3476,61,3128,53,234,295,2021-02-05
317506,JAKARTA TIMUR,CAKUNG,8330,193,7337,123,677,870,2021-02-05
317303,JAKARTA BARAT,TAMAN SARI,2714,39,2455,44,176,215,2021-02-05
317308,JAKARTA BARAT,KEMBANGAN,6407,149,5539,80,639,788,2021-02-05
317103,JAKARTA PUSAT,KEMAYORAN,6794,103,5923,121,647,750,2021-02-05
317404,JAKARTA SELATAN,PASAR MINGGU,7453,157,6435,118,743,900,2021-02-05
317502,JAKARTA TIMUR,PULO GADUNG,6521,135,5705,106,575,710,2021-02-05
317410,JAKARTA SELATAN,PESANGGRAHAN,4945,76,4301,76,492,568,2021-02-05
317201,JAKARTA UTARA,PENJARINGAN,4873,100,4349,69,355,455,2021-02-05
317505,JAKARTA TIMUR,PASAR REBO,4966,111,4323,70,462,573,2021-02-05
310102,KAB.ADM.KEP.SERIBU,KEP. SERIBU SELATAN,203,0,190,2,11,11,2021-02-05
317408,JAKARTA SELATAN,PANCORAN,4175,68,3672,60,375,443,2021-02-05
317102,JAKARTA PUSAT,SAWAH BESAR,2749,30,2419,50,250,280,2021-02-05
317307,JAKARTA BARAT,PALMERAH,5586,117,4902,118,449,566,2021-02-05
317106,JAKARTA PUSAT,MENTENG,2354,32,2112,43,167,199,2021-02-05
317501,JAKARTA TIMUR,MATRAMAN,4336,53,3826,93,364,417,2021-02-05
317403,JAKARTA SELATAN,MAMPANG PRAPATAN,4253,59,3748,62,384,443,2021-02-05
317508,JAKARTA TIMUR,MAKASAR,5739,170,5101,83,385,555,2021-02-05
317504,JAKARTA TIMUR,KRAMAT JATI,6455,97,5673,123,562,659,2021-02-05
317203,JAKARTA UTARA,KOJA,6249,127,5530,97,495,622,2021-02-05
310101,KAB.ADM.KEP.SERIBU,KEP. SERIBU UTARA,276,2,248,1,25,27,2021-02-05
317205,JAKARTA UTARA,PADEMANGAN,3283,69,2933,59,222,291,2021-02-05
317104,JAKARTA PUSAT,SENEN,3118,38,2769,59,252,290,2021-02-05
317202,JAKARTA UTARA,TANJUNG PRIOK,8822,132,7776,136,778,910,2021-02-06
317107,JAKARTA PUSAT,TANAH ABANG,4294,56,3863,75,300,356,2021-02-06
111111,Luar DKI & Proses Update,Luar DKI & Proses Update,143008,137,141294,1273,304,441,2021-02-06
317401,JAKARTA SELATAN,TEBET,5295,83,4709,100,403,486,2021-02-06
317304,JAKARTA BARAT,TAMBORA,3900,57,3514,84,245,302,2021-02-06
317303,JAKARTA BARAT,TAMAN SARI,2731,37,2486,44,164,201,2021-02-06
317402,JAKARTA SELATAN,SETIA BUDI,3783,52,3409,61,261,313,2021-02-06
317405,JAKARTA SELATAN,KEBAYORAN LAMA,6383,106,5719,105,453,559,2021-02-06
317407,JAKARTA SELATAN,KEBAYORAN BARU,4228,72,3789,56,311,383,2021-02-06
317306,JAKARTA BARAT,KALI DERES,5273,109,4674,100,390,499,2021-02-06
317108,JAKARTA PUSAT,JOHAR BARU,2998,25,2730,78,165,190,2021-02-06
317503,JAKARTA TIMUR,JATINEGARA,6256,69,5571,94,522,591,2021-02-06
317409,JAKARTA SELATAN,JAGAKARSA,7456,155,6502,102,697,852,2021-02-06
317302,JAKARTA BARAT,GROGOL PETAMBURAN,5559,68,4963,102,426,494,2021-02-06
317305,JAKARTA BARAT,KEBON JERUK,7470,113,6674,127,556,669,2021-02-06
317101,JAKARTA PUSAT,GAMBIR,2815,41,2546,43,185,226,2021-02-06
317509,JAKARTA TIMUR,CIRACAS,5973,92,5300,99,482,574,2021-02-06
317510,JAKARTA TIMUR,CIPAYUNG,6779,105,6021,66,587,692,2021-02-06
317204,JAKARTA UTARA,CILINCING,5753,144,4967,94,548,692,2021-02-06
317406,JAKARTA SELATAN,CILANDAK,5374,154,4615,75,530,684,2021-02-06
317301,JAKARTA BARAT,CENGKARENG,9154,116,8121,183,734,850,2021-02-06
317105,JAKARTA PUSAT,CEMPAKA PUTIH,3513,31,3242,53,187,218,2021-02-06
317506,JAKARTA TIMUR,CAKUNG,8401,208,7461,126,606,814,2021-02-06
317507,JAKARTA TIMUR,DUREN SAWIT,9521,244,8231,182,864,1108,2021-02-06
317103,JAKARTA PUSAT,KEMAYORAN,6881,103,6077,123,578,681,2021-02-06
317206,JAKARTA UTARA,KELAPA GADING,4058,45,3572,61,380,425,2021-02-06
310102,KAB.ADM.KEP.SERIBU,KEP. SERIBU SELATAN,203,0,191,2,10,10,2021-02-06
317104,JAKARTA PUSAT,SENEN,3148,39,2814,61,234,273,2021-02-06
317102,JAKARTA PUSAT,SAWAH BESAR,2791,29,2471,51,240,269,2021-02-06
317502,JAKARTA TIMUR,PULO GADUNG,6599,153,5739,108,599,752,2021-02-06
317410,JAKARTA SELATAN,PESANGGRAHAN,5010,71,4434,76,429,500,2021-02-06
317201,JAKARTA UTARA,PENJARINGAN,4921,106,4398,70,347,453,2021-02-06
317505,JAKARTA TIMUR,PASAR REBO,5029,128,4434,70,397,525,2021-02-06
317404,JAKARTA SELATAN,PASAR MINGGU,7500,163,6573,119,645,808,2021-02-06
317308,JAKARTA BARAT,KEMBANGAN,6473,146,5636,81,610,756,2021-02-06
317307,JAKARTA BARAT,PALMERAH,5631,119,5009,118,385,504,2021-02-06
317408,JAKARTA SELATAN,PANCORAN,4198,65,3734,60,339,404,2021-02-06
317106,JAKARTA PUSAT,MENTENG,2375,29,2152,43,151,180,2021-02-06
317501,JAKARTA TIMUR,MATRAMAN,4369,53,3944,94,278,331,2021-02-06
317403,JAKARTA SELATAN,MAMPANG PRAPATAN,4274,63,3844,62,305,368,2021-02-06
317508,JAKARTA TIMUR,MAKASAR,5803,187,5146,83,387,574,2021-02-06
317504,JAKARTA TIMUR,KRAMAT JATI,6520,103,5824,125,468,571,2021-02-06
317203,JAKARTA UTARA,KOJA,6274,122,5579,98,475,597,2021-02-06
310101,KAB.ADM.KEP.SERIBU,KEP. SERIBU UTARA,278,2,255,1,20,22,2021-02-06
317205,JAKARTA UTARA,PADEMANGAN,3321,60,2983,59,219,279,2021-02-06
317202,JAKARTA UTARA,TANJUNG PRIOK,8953,164,7905,137,747,911,2021-02-07
111111,Luar DKI & Proses Update,Luar DKI & Proses Update,143008,137,141294,1273,304,441,2021-02-07
317401,JAKARTA SELATAN,TEBET,5435,93,4900,104,338,431,2021-02-07
317107,JAKARTA PUSAT,TANAH ABANG,4337,69,3954,76,238,307,2021-02-07
317206,JAKARTA UTARA,KELAPA GADING,4102,69,3603,62,368,437,2021-02-07
317303,JAKARTA BARAT,TAMAN SARI,2752,47,2506,44,155,202,2021-02-07
317305,JAKARTA BARAT,KEBON JERUK,7549,145,6777,128,499,644,2021-02-07
317405,JAKARTA SELATAN,KEBAYORAN LAMA,6497,126,5814,105,452,578,2021-02-07
317407,JAKARTA SELATAN,KEBAYORAN BARU,4299,78,3866,58,297,375,2021-02-07
317306,JAKARTA BARAT,KALI DERES,5324,125,4761,102,336,461,2021-02-07
317108,JAKARTA PUSAT,JOHAR BARU,3066,26,2779,80,181,207,2021-02-07
317503,JAKARTA TIMUR,JATINEGARA,6335,107,5737,95,396,503,2021-02-07
317409,JAKARTA SELATAN,JAGAKARSA,7541,132,6617,103,689,821,2021-02-07
317302,JAKARTA BARAT,GROGOL PETAMBURAN,5650,101,5051,102,396,497,2021-02-07
317101,JAKARTA PUSAT,GAMBIR,2837,50,2585,43,159,209,2021-02-07
317507,JAKARTA TIMUR,DUREN SAWIT,9684,287,8448,184,765,1052,2021-02-07
317509,JAKARTA TIMUR,CIRACAS,6044,113,5395,99,437,550,2021-02-07
317510,JAKARTA TIMUR,CIPAYUNG,6941,132,6259,67,483,615,2021-02-07
317204,JAKARTA UTARA,CILINCING,5843,166,5047,97,533,699,2021-02-07
317406,JAKARTA SELATAN,CILANDAK,5432,163,4741,75,453,616,2021-02-07
317301,JAKARTA BARAT,CENGKARENG,9245,159,8241,184,661,820,2021-02-07
317105,JAKARTA PUSAT,CEMPAKA PUTIH,3556,62,3261,53,180,242,2021-02-07
317506,JAKARTA TIMUR,CAKUNG,8474,229,7587,131,527,756,2021-02-07
317103,JAKARTA PUSAT,KEMAYORAN,7014,151,6228,124,511,662,2021-02-07
317304,JAKARTA BARAT,TAMBORA,3920,80,3545,86,209,289,2021-02-07
317308,JAKARTA BARAT,KEMBANGAN,6520,160,5809,82,469,629,2021-02-07
310101,KAB.ADM.KEP.SERIBU,KEP. SERIBU UTARA,279,2,257,1,19,21,2021-02-07
317402,JAKARTA SELATAN,SETIA BUDI,3820,70,3423,62,265,335,2021-02-07
317104,JAKARTA PUSAT,SENEN,3238,54,2867,64,253,307,2021-02-07
317102,JAKARTA PUSAT,SAWAH BESAR,2864,45,2504,51,264,309,2021-02-07
317502,JAKARTA TIMUR,PULO GADUNG,6689,199,5962,108,420,619,2021-02-07
317410,JAKARTA SELATAN,PESANGGRAHAN,5091,77,4576,77,361,438,2021-02-07
317201,JAKARTA UTARA,PENJARINGAN,5013,148,4478,70,317,465,2021-02-07
317505,JAKARTA TIMUR,PASAR REBO,5347,198,4647,70,432,630,2021-02-07
317404,JAKARTA SELATAN,PASAR MINGGU,7611,174,6677,121,639,813,2021-02-07
310102,KAB.ADM.KEP.SERIBU,KEP. SERIBU SELATAN,203,0,195,2,6,6,2021-02-07
317408,JAKARTA SELATAN,PANCORAN,4249,79,3788,60,322,401,2021-02-07
317205,JAKARTA UTARA,PADEMANGAN,3358,79,3001,59,219,298,2021-02-07
317106,JAKARTA PUSAT,MENTENG,2425,34,2185,44,162,196,2021-02-07
317501,JAKARTA TIMUR,MATRAMAN,4579,79,4029,95,376,455,2021-02-07
317403,JAKARTA SELATAN,MAMPANG PRAPATAN,4301,58,3930,62,251,309,2021-02-07
317508,JAKARTA TIMUR,MAKASAR,5920,227,5249,83,361,588,2021-02-07
317504,JAKARTA TIMUR,KRAMAT JATI,6752,132,5983,127,510,642,2021-02-07
317203,JAKARTA UTARA,KOJA,6361,141,5635,99,486,627,2021-02-07
317307,JAKARTA BARAT,PALMERAH,5693,155,5063,118,357,512,2021-02-07
317401,JAKARTA SELATAN,TEBET,5499,91,4957,104,347,438,2021-02-08
111111,Luar DKI & Proses Update,Luar DKI & Proses Update,143008,137,141294,1273,304,441,2021-02-08
317202,JAKARTA UTARA,TANJUNG PRIOK,9031,166,7987,139,739,905,2021-02-08
317107,JAKARTA PUSAT,TANAH ABANG,4374,55,4013,76,230,285,2021-02-08
317104,JAKARTA PUSAT,SENEN,3262,52,2901,64,245,297,2021-02-08
317308,JAKARTA BARAT,KEMBANGAN,6576,158,5868,84,466,624,2021-02-08
310102,KAB.ADM.KEP.SERIBU,KEP. SERIBU SELATAN,205,0,196,2,7,7,2021-02-08
310101,KAB.ADM.KEP.SERIBU,KEP. SERIBU UTARA,279,2,257,1,19,21,2021-02-08
317203,JAKARTA UTARA,KOJA,6411,150,5666,101,494,644,2021-02-08
317504,JAKARTA TIMUR,KRAMAT JATI,6823,132,6078,128,485,617,2021-02-08
317508,JAKARTA TIMUR,MAKASAR,6054,231,5284,85,454,685,2021-02-08
317403,JAKARTA SELATAN,MAMPANG PRAPATAN,4338,55,3975,63,245,300,2021-02-08
317501,JAKARTA TIMUR,MATRAMAN,4625,87,4122,96,320,407,2021-02-08
317106,JAKARTA PUSAT,MENTENG,2450,32,2200,44,174,206,2021-02-08
317205,JAKARTA UTARA,PADEMANGAN,3382,75,3049,60,198,273,2021-02-08
317307,JAKARTA BARAT,PALMERAH,5751,140,5130,118,363,503,2021-02-08
317408,JAKARTA SELATAN,PANCORAN,4285,81,3812,61,331,412,2021-02-08
317404,JAKARTA SELATAN,PASAR MINGGU,7704,136,6875,122,571,707,2021-02-08
317505,JAKARTA TIMUR,PASAR REBO,5394,186,4737,70,401,587,2021-02-08
317201,JAKARTA UTARA,PENJARINGAN,5129,167,4586,71,305,472,2021-02-08
317103,JAKARTA PUSAT,KEMAYORAN,7116,149,6289,125,553,702,2021-02-08
317206,JAKARTA UTARA,KELAPA GADING,4145,64,3643,63,375,439,2021-02-08
317305,JAKARTA BARAT,KEBON JERUK,7614,131,6849,129,505,636,2021-02-08
317405,JAKARTA SELATAN,KEBAYORAN LAMA,6565,120,5911,108,426,546,2021-02-08
317304,JAKARTA BARAT,TAMBORA,4004,90,3586,87,241,331,2021-02-08
317506,JAKARTA TIMUR,CAKUNG,8584,243,7667,133,541,784,2021-02-08
317105,JAKARTA PUSAT,CEMPAKA PUTIH,3601,70,3281,54,196,266,2021-02-08
317301,JAKARTA BARAT,CENGKARENG,9356,155,8389,186,626,781,2021-02-08
317406,JAKARTA SELATAN,CILANDAK,5491,106,4934,76,375,481,2021-02-08
317204,JAKARTA UTARA,CILINCING,5884,165,5098,97,524,689,2021-02-08
317510,JAKARTA TIMUR,CIPAYUNG,6991,127,6354,69,441,568,2021-02-08
317410,JAKARTA SELATAN,PESANGGRAHAN,5140,64,4664,77,335,399,2021-02-08
317509,JAKARTA TIMUR,CIRACAS,6139,116,5450,99,474,590,2021-02-08
317101,JAKARTA PUSAT,GAMBIR,2865,48,2604,44,169,217,2021-02-08
317302,JAKARTA BARAT,GROGOL PETAMBURAN,5749,105,5154,105,385,490,2021-02-08
317409,JAKARTA SELATAN,JAGAKARSA,7621,95,6841,104,581,676,2021-02-08
317503,JAKARTA TIMUR,JATINEGARA,6413,106,5823,98,386,492,2021-02-08
317108,JAKARTA PUSAT,JOHAR BARU,3109,26,2807,81,195,221,2021-02-08
317306,JAKARTA BARAT,KALI DERES,5390,127,4837,102,324,451,2021-02-08
317407,JAKARTA SELATAN,KEBAYORAN BARU,4345,76,3915,59,295,371,2021-02-08
317507,JAKARTA TIMUR,DUREN SAWIT,9797,277,8584,186,750,1027,2021-02-08
317502,JAKARTA TIMUR,PULO GADUNG,6761,205,6020,109,427,632,2021-02-08
317102,JAKARTA PUSAT,SAWAH BESAR,2915,49,2557,51,258,307,2021-02-08
317303,JAKARTA BARAT,TAMAN SARI,2785,50,2523,45,167,217,2021-02-08
317402,JAKARTA SELATAN,SETIA BUDI,3851,79,3462,62,248,327,2021-02-08
317102,JAKARTA PUSAT,SAWAH BESAR,2973,55,2578,51,289,344,2021-02-09
317305,JAKARTA BARAT,KEBON JERUK,7680,151,6903,131,495,646,2021-02-09
317206,JAKARTA UTARA,KELAPA GADING,4182,63,3744,64,311,374,2021-02-09
317103,JAKARTA PUSAT,KEMAYORAN,7260,160,6342,125,633,793,2021-02-09
317308,JAKARTA BARAT,KEMBANGAN,6657,165,5956,86,450,615,2021-02-09
310102,KAB.ADM.KEP.SERIBU,KEP. SERIBU SELATAN,205,0,196,2,7,7,2021-02-09
310101,KAB.ADM.KEP.SERIBU,KEP. SERIBU UTARA,285,2,257,1,25,27,2021-02-09
317203,JAKARTA UTARA,KOJA,6477,139,5807,102,429,568,2021-02-09
317504,JAKARTA TIMUR,KRAMAT JATI,6891,128,6131,129,503,631,2021-02-09
317508,JAKARTA TIMUR,MAKASAR,6083,144,5437,88,414,558,2021-02-09
317403,JAKARTA SELATAN,MAMPANG PRAPATAN,4383,55,3988,64,276,331,2021-02-09
317501,JAKARTA TIMUR,MATRAMAN,4629,77,4147,96,309,386,2021-02-09
317106,JAKARTA PUSAT,MENTENG,2477,29,2205,45,198,227,2021-02-09
317205,JAKARTA UTARA,PADEMANGAN,3403,69,3063,60,211,280,2021-02-09
317307,JAKARTA BARAT,PALMERAH,5805,149,5177,120,359,508,2021-02-09
317408,JAKARTA SELATAN,PANCORAN,4355,82,3844,62,367,449,2021-02-09
317404,JAKARTA SELATAN,PASAR MINGGU,7804,149,6915,124,616,765,2021-02-09
317505,JAKARTA TIMUR,PASAR REBO,5462,193,4759,74,436,629,2021-02-09
317201,JAKARTA UTARA,PENJARINGAN,5194,183,4617,71,323,506,2021-02-09
317502,JAKARTA TIMUR,PULO GADUNG,6820,200,6116,111,393,593,2021-02-09
317410,JAKARTA SELATAN,PESANGGRAHAN,5227,74,4691,77,385,459,2021-02-09
317405,JAKARTA SELATAN,KEBAYORAN LAMA,6654,127,5962,109,456,583,2021-02-09
317407,JAKARTA SELATAN,KEBAYORAN BARU,4389,80,3927,61,321,401,2021-02-09
317108,JAKARTA PUSAT,JOHAR BARU,3146,26,2818,82,220,246,2021-02-09
317105,JAKARTA PUSAT,CEMPAKA PUTIH,3680,71,3312,56,241,312,2021-02-09
317304,JAKARTA BARAT,TAMBORA,4051,103,3612,88,248,351,2021-02-09
317107,JAKARTA PUSAT,TANAH ABANG,4429,54,4024,79,272,326,2021-02-09
317202,JAKARTA UTARA,TANJUNG PRIOK,9116,169,8076,140,731,900,2021-02-09
317401,JAKARTA SELATAN,TEBET,5582,81,4993,104,404,485,2021-02-09
317104,JAKARTA PUSAT,SENEN,3304,59,2915,65,265,324,2021-02-09
111111,Luar DKI & Proses Update,Luar DKI & Proses Update,143008,137,141294,1273,304,441,2021-02-09
317506,JAKARTA TIMUR,CAKUNG,8698,199,7906,135,458,657,2021-02-09
317306,JAKARTA BARAT,KALI DERES,5435,100,4895,103,337,437,2021-02-09
317303,JAKARTA BARAT,TAMAN SARI,2818,50,2543,45,180,230,2021-02-09
317301,JAKARTA BARAT,CENGKARENG,9441,149,8447,187,658,807,2021-02-09
317204,JAKARTA UTARA,CILINCING,5932,110,5287,97,438,548,2021-02-09
317510,JAKARTA TIMUR,CIPAYUNG,7144,141,6394,69,540,681,2021-02-09
317509,JAKARTA TIMUR,CIRACAS,6248,115,5534,99,500,615,2021-02-09
317507,JAKARTA TIMUR,DUREN SAWIT,9942,232,8793,188,729,961,2021-02-09
317101,JAKARTA PUSAT,GAMBIR,2905,55,2620,44,186,241,2021-02-09
317302,JAKARTA BARAT,GROGOL PETAMBURAN,5822,122,5203,108,389,511,2021-02-09
317409,JAKARTA SELATAN,JAGAKARSA,7743,102,6875,108,658,760,2021-02-09
317503,JAKARTA TIMUR,JATINEGARA,6454,100,5905,99,350,450,2021-02-09
317406,JAKARTA SELATAN,CILANDAK,5577,121,4964,76,416,537,2021-02-09
317402,JAKARTA SELATAN,SETIA BUDI,3890,74,3517,63,236,310,2021-02-09
317401,JAKARTA SELATAN,TEBET,5632,102,5062,105,363,465,2021-02-10
111111,Luar DKI & Proses Update,Luar DKI & Proses Update,143008,137,141294,1273,304,441,2021-02-10
317202,JAKARTA UTARA,TANJUNG PRIOK,9209,220,8217,142,630,850,2021-02-10
317402,JAKARTA SELATAN,SETIA BUDI,3940,91,3569,63,217,308,2021-02-10
317304,JAKARTA BARAT,TAMBORA,4103,140,3645,89,229,369,2021-02-10
317305,JAKARTA BARAT,KEBON JERUK,7844,252,7041,132,419,671,2021-02-10
317405,JAKARTA SELATAN,KEBAYORAN LAMA,6687,146,6043,110,388,534,2021-02-10
317407,JAKARTA SELATAN,KEBAYORAN BARU,4451,92,4006,63,290,382,2021-02-10
317306,JAKARTA BARAT,KALI DERES,5525,135,4973,103,314,449,2021-02-10
317108,JAKARTA PUSAT,JOHAR BARU,3169,41,2849,82,197,238,2021-02-10
317503,JAKARTA TIMUR,JATINEGARA,6504,112,5972,100,320,432,2021-02-10
317409,JAKARTA SELATAN,JAGAKARSA,7842,131,6947,110,654,785,2021-02-10
317302,JAKARTA BARAT,GROGOL PETAMBURAN,5883,169,5262,108,344,513,2021-02-10
317101,JAKARTA PUSAT,GAMBIR,2937,70,2652,44,171,241,2021-02-10
317507,JAKARTA TIMUR,DUREN SAWIT,10047,281,8970,190,606,887,2021-02-10
317509,JAKARTA TIMUR,CIRACAS,6368,173,5593,101,501,674,2021-02-10
317510,JAKARTA TIMUR,CIPAYUNG,7248,174,6502,71,501,675,2021-02-10
317204,JAKARTA UTARA,CILINCING,5991,148,5383,99,361,509,2021-02-10
317406,JAKARTA SELATAN,CILANDAK,5638,143,5019,76,400,543,2021-02-10
317301,JAKARTA BARAT,CENGKARENG,9563,224,8601,190,548,772,2021-02-10
317105,JAKARTA PUSAT,CEMPAKA PUTIH,3707,87,3341,56,223,310,2021-02-10
317506,JAKARTA TIMUR,CAKUNG,8817,237,8029,137,414,651,2021-02-10
317206,JAKARTA UTARA,KELAPA GADING,4222,78,3785,64,295,373,2021-02-10
317107,JAKARTA PUSAT,TANAH ABANG,4442,60,4061,79,242,302,2021-02-10
317103,JAKARTA PUSAT,KEMAYORAN,7311,190,6412,125,584,774,2021-02-10
310102,KAB.ADM.KEP.SERIBU,KEP. SERIBU SELATAN,206,0,196,2,8,8,2021-02-10
317303,JAKARTA BARAT,TAMAN SARI,2866,76,2579,45,166,242,2021-02-10
317104,JAKARTA PUSAT,SENEN,3330,76,2956,66,232,308,2021-02-10
317102,JAKARTA PUSAT,SAWAH BESAR,2994,65,2609,51,269,334,2021-02-10
317502,JAKARTA TIMUR,PULO GADUNG,6894,238,6189,113,354,592,2021-02-10
317410,JAKARTA SELATAN,PESANGGRAHAN,5282,101,4768,78,335,436,2021-02-10
317201,JAKARTA UTARA,PENJARINGAN,5317,238,4659,73,347,585,2021-02-10
317505,JAKARTA TIMUR,PASAR REBO,5511,209,4826,78,398,607,2021-02-10
317404,JAKARTA SELATAN,PASAR MINGGU,7873,182,7001,126,564,746,2021-02-10
317408,JAKARTA SELATAN,PANCORAN,4426,104,3929,62,331,435,2021-02-10
317205,JAKARTA UTARA,PADEMANGAN,3431,83,3097,60,191,274,2021-02-10
317106,JAKARTA PUSAT,MENTENG,2498,42,2222,46,188,230,2021-02-10
317501,JAKARTA TIMUR,MATRAMAN,4674,97,4182,96,299,396,2021-02-10
317403,JAKARTA SELATAN,MAMPANG PRAPATAN,4441,75,4020,65,281,356,2021-02-10
317508,JAKARTA TIMUR,MAKASAR,6163,182,5530,89,362,544,2021-02-10
317504,JAKARTA TIMUR,KRAMAT JATI,6997,170,6202,130,495,665,2021-02-10
317203,JAKARTA UTARA,KOJA,6529,168,5880,102,379,547,2021-02-10
310101,KAB.ADM.KEP.SERIBU,KEP. SERIBU UTARA,285,2,266,1,16,18,2021-02-10
317307,JAKARTA BARAT,PALMERAH,5886,191,5280,120,295,486,2021-02-10
317308,JAKARTA BARAT,KEMBANGAN,6754,213,6040,86,415,628,2021-02-10
317401,JAKARTA SELATAN,TEBET,5676,128,5109,107,332,460,2021-02-11
111111,Luar DKI & Proses Update,Luar DKI & Proses Update,143008,137,141294,1273,304,441,2021-02-11
317107,JAKARTA PUSAT,TANAH ABANG,4514,90,4120,79,225,315,2021-02-11
317304,JAKARTA BARAT,TAMBORA,4175,191,3721,90,173,364,2021-02-11
310101,KAB.ADM.KEP.SERIBU,KEP. SERIBU UTARA,286,2,274,1,9,11,2021-02-11
317203,JAKARTA UTARA,KOJA,6559,184,5927,102,346,530,2021-02-11
317504,JAKARTA TIMUR,KRAMAT JATI,7073,196,6318,130,429,625,2021-02-11
317508,JAKARTA TIMUR,MAKASAR,6243,215,5595,89,344,559,2021-02-11
317403,JAKARTA SELATAN,MAMPANG PRAPATAN,4461,83,4085,66,227,310,2021-02-11
317501,JAKARTA TIMUR,MATRAMAN,4730,124,4267,96,243,367,2021-02-11
317106,JAKARTA PUSAT,MENTENG,2513,52,2251,46,164,216,2021-02-11
317205,JAKARTA UTARA,PADEMANGAN,3474,107,3144,60,163,270,2021-02-11
310102,KAB.ADM.KEP.SERIBU,KEP. SERIBU SELATAN,206,0,201,2,3,3,2021-02-11
317307,JAKARTA BARAT,PALMERAH,5941,213,5335,121,272,485,2021-02-11
317404,JAKARTA SELATAN,PASAR MINGGU,7950,189,7192,126,443,632,2021-02-11
317505,JAKARTA TIMUR,PASAR REBO,5584,216,4917,78,373,589,2021-02-11
317201,JAKARTA UTARA,PENJARINGAN,5418,303,4773,73,269,572,2021-02-11
317410,JAKARTA SELATAN,PESANGGRAHAN,5328,113,4819,78,318,431,2021-02-11
317502,JAKARTA TIMUR,PULO GADUNG,6949,266,6323,114,246,512,2021-02-11
317102,JAKARTA PUSAT,SAWAH BESAR,3026,84,2652,51,239,323,2021-02-11
317104,JAKARTA PUSAT,SENEN,3359,101,2994,66,198,299,2021-02-11
317402,JAKARTA SELATAN,SETIA BUDI,3966,106,3636,63,161,267,2021-02-11
317408,JAKARTA SELATAN,PANCORAN,4460,117,4001,62,280,397,2021-02-11
317202,JAKARTA UTARA,TANJUNG PRIOK,9281,269,8419,143,450,719,2021-02-11
317303,JAKARTA BARAT,TAMAN SARI,2900,104,2614,45,137,241,2021-02-11
317103,JAKARTA PUSAT,KEMAYORAN,7378,218,6560,125,475,693,2021-02-11
317506,JAKARTA TIMUR,CAKUNG,8879,281,8097,139,362,643,2021-02-11
317105,JAKARTA PUSAT,CEMPAKA PUTIH,3732,102,3364,58,208,310,2021-02-11
317301,JAKARTA BARAT,CENGKARENG,9691,267,8715,192,517,784,2021-02-11
317406,JAKARTA SELATAN,CILANDAK,5744,161,5159,76,348,509,2021-02-11
317204,JAKARTA UTARA,CILINCING,6032,168,5455,100,309,477,2021-02-11
317510,JAKARTA TIMUR,CIPAYUNG,7284,186,6602,72,424,610,2021-02-11
317509,JAKARTA TIMUR,CIRACAS,6422,190,5744,102,386,576,2021-02-11
317507,JAKARTA TIMUR,DUREN SAWIT,10118,318,9159,192,449,767,2021-02-11
317308,JAKARTA BARAT,KEMBANGAN,6808,236,6113,87,372,608,2021-02-11
317101,JAKARTA PUSAT,GAMBIR,2956,81,2673,44,158,239,2021-02-11
317409,JAKARTA SELATAN,JAGAKARSA,7931,137,7183,111,500,637,2021-02-11
317503,JAKARTA TIMUR,JATINEGARA,6592,146,6057,100,289,435,2021-02-11
317108,JAKARTA PUSAT,JOHAR BARU,3191,54,2872,82,183,237,2021-02-11
317306,JAKARTA BARAT,KALI DERES,5595,160,5058,103,274,434,2021-02-11
317407,JAKARTA SELATAN,KEBAYORAN BARU,4532,102,4079,63,288,390,2021-02-11
317405,JAKARTA SELATAN,KEBAYORAN LAMA,6768,175,6124,110,359,534,2021-02-11
317305,JAKARTA BARAT,KEBON JERUK,7919,273,7162,134,350,623,2021-02-11
317206,JAKARTA UTARA,KELAPA GADING,4275,107,3866,64,238,345,2021-02-11
317302,JAKARTA BARAT,GROGOL PETAMBURAN,5970,224,5319,108,319,543,2021-02-11
111111,Luar DKI & Proses Update,Luar DKI & Proses Update,143008,137,141294,1273,304,441,2021-02-12
317401,JAKARTA SELATAN,TEBET,5747,137,5230,108,272,409,2021-02-12
310102,KAB.ADM.KEP.SERIBU,KEP. SERIBU SELATAN,208,0,201,2,5,5,2021-02-12
317308,JAKARTA BARAT,KEMBANGAN,6880,218,6333,87,242,460,2021-02-12
317504,JAKARTA TIMUR,KRAMAT JATI,7203,229,6445,131,398,627,2021-02-12
317508,JAKARTA TIMUR,MAKASAR,6331,256,5730,91,254,510,2021-02-12
317403,JAKARTA SELATAN,MAMPANG PRAPATAN,4501,87,4166,66,182,269,2021-02-12
317501,JAKARTA TIMUR,MATRAMAN,4822,161,4324,96,241,402,2021-02-12
317106,JAKARTA PUSAT,MENTENG,2554,70,2304,47,133,203,2021-02-12
317205,JAKARTA UTARA,PADEMANGAN,3506,128,3186,60,132,260,2021-02-12
317307,JAKARTA BARAT,PALMERAH,6002,211,5476,122,193,404,2021-02-12
317408,JAKARTA SELATAN,PANCORAN,4512,149,4100,64,199,348,2021-02-12
317203,JAKARTA UTARA,KOJA,6679,222,6163,102,192,414,2021-02-12
317404,JAKARTA SELATAN,PASAR MINGGU,8094,253,7333,128,380,633,2021-02-12
317201,JAKARTA UTARA,PENJARINGAN,5527,341,4911,73,202,543,2021-02-12
317410,JAKARTA SELATAN,PESANGGRAHAN,5402,138,4931,79,254,392,2021-02-12
317502,JAKARTA TIMUR,PULO GADUNG,7030,265,6466,121,178,443,2021-02-12
317102,JAKARTA PUSAT,SAWAH BESAR,3061,102,2745,52,162,264,2021-02-12
317104,JAKARTA PUSAT,SENEN,3414,127,3081,66,140,267,2021-02-12
317402,JAKARTA SELATAN,SETIA BUDI,4028,137,3711,64,116,253,2021-02-12
317303,JAKARTA BARAT,TAMAN SARI,2934,118,2658,45,113,231,2021-02-12
317304,JAKARTA BARAT,TAMBORA,4247,219,3789,90,149,368,2021-02-12
317505,JAKARTA TIMUR,PASAR REBO,5716,245,5036,82,353,598,2021-02-12
310101,KAB.ADM.KEP.SERIBU,KEP. SERIBU UTARA,289,2,276,1,10,12,2021-02-12
317202,JAKARTA UTARA,TANJUNG PRIOK,9436,331,8578,146,381,712,2021-02-12
317107,JAKARTA PUSAT,TANAH ABANG,4592,119,4218,80,175,294,2021-02-12
317506,JAKARTA TIMUR,CAKUNG,8982,287,8257,142,296,583,2021-02-12
317105,JAKARTA PUSAT,CEMPAKA PUTIH,3745,109,3423,58,155,264,2021-02-12
317301,JAKARTA BARAT,CENGKARENG,9788,311,8928,195,354,665,2021-02-12
317406,JAKARTA SELATAN,CILANDAK,5820,207,5287,76,250,457,2021-02-12
317204,JAKARTA UTARA,CILINCING,6109,194,5627,100,188,382,2021-02-12
317510,JAKARTA TIMUR,CIPAYUNG,7401,245,6753,72,331,576,2021-02-12
317509,JAKARTA TIMUR,CIRACAS,6496,230,5873,102,291,521,2021-02-12
317507,JAKARTA TIMUR,DUREN SAWIT,10284,329,9354,193,408,737,2021-02-12
317101,JAKARTA PUSAT,GAMBIR,2994,102,2752,44,96,198,2021-02-12
317302,JAKARTA BARAT,GROGOL PETAMBURAN,6070,283,5436,109,242,525,2021-02-12
317409,JAKARTA SELATAN,JAGAKARSA,7999,160,7326,112,401,561,2021-02-12
317503,JAKARTA TIMUR,JATINEGARA,6658,171,6198,105,184,355,2021-02-12
317108,JAKARTA PUSAT,JOHAR BARU,3241,74,2923,82,162,236,2021-02-12
317306,JAKARTA BARAT,KALI DERES,5677,182,5185,103,207,389,2021-02-12
317407,JAKARTA SELATAN,KEBAYORAN BARU,4580,117,4180,64,219,336,2021-02-12
317405,JAKARTA SELATAN,KEBAYORAN LAMA,6892,222,6262,113,295,517,2021-02-12
317305,JAKARTA BARAT,KEBON JERUK,7994,307,7316,134,237,544,2021-02-12
317206,JAKARTA UTARA,KELAPA GADING,4331,130,3978,65,158,288,2021-02-12
317103,JAKARTA PUSAT,KEMAYORAN,7498,282,6765,126,325,607,2021-02-12
111111,Luar DKI & Proses Update,Luar DKI & Proses Update,143008,137,141294,1273,304,441,2021-02-13
317506,JAKARTA TIMUR,CAKUNG,9041,261,8378,144,258,519,2021-02-13
317401,JAKARTA SELATAN,TEBET,5785,128,5315,109,233,361,2021-02-13
317107,JAKARTA PUSAT,TANAH ABANG,4641,118,4263,83,177,295,2021-02-13
317206,JAKARTA UTARA,KELAPA GADING,4401,129,4042,66,164,293,2021-02-13
317305,JAKARTA BARAT,KEBON JERUK,8077,324,7409,135,209,533,2021-02-13
317405,JAKARTA SELATAN,KEBAYORAN LAMA,6990,220,6384,113,273,493,2021-02-13
317407,JAKARTA SELATAN,KEBAYORAN BARU,4641,102,4271,65,203,305,2021-02-13
317306,JAKARTA BARAT,KALI DERES,5723,175,5251,103,194,369,2021-02-13
317108,JAKARTA PUSAT,JOHAR BARU,3265,78,3004,82,101,179,2021-02-13
317503,JAKARTA TIMUR,JATINEGARA,6751,158,6288,107,198,356,2021-02-13
317409,JAKARTA SELATAN,JAGAKARSA,8140,157,7451,113,419,576,2021-02-13
317302,JAKARTA BARAT,GROGOL PETAMBURAN,6151,313,5536,111,191,504,2021-02-13
317101,JAKARTA PUSAT,GAMBIR,3024,100,2793,44,87,187,2021-02-13
317507,JAKARTA TIMUR,DUREN SAWIT,10428,281,9582,197,368,649,2021-02-13
317509,JAKARTA TIMUR,CIRACAS,6558,230,5948,104,276,506,2021-02-13
317510,JAKARTA TIMUR,CIPAYUNG,7476,237,6872,72,295,532,2021-02-13
317204,JAKARTA UTARA,CILINCING,6181,189,5715,101,176,365,2021-02-13
317406,JAKARTA SELATAN,CILANDAK,5864,191,5374,76,223,414,2021-02-13
317301,JAKARTA BARAT,CENGKARENG,9914,336,9039,196,343,679,2021-02-13
317105,JAKARTA PUSAT,CEMPAKA PUTIH,3805,102,3489,58,156,258,2021-02-13
317103,JAKARTA PUSAT,KEMAYORAN,7596,255,6912,127,302,557,2021-02-13
317308,JAKARTA BARAT,KEMBANGAN,6996,237,6391,89,279,516,2021-02-13
310101,KAB.ADM.KEP.SERIBU,KEP. SERIBU UTARA,290,2,277,1,10,12,2021-02-13
317203,JAKARTA UTARA,KOJA,6766,208,6254,107,197,405,2021-02-13
317304,JAKARTA BARAT,TAMBORA,4290,232,3834,90,134,366,2021-02-13
317303,JAKARTA BARAT,TAMAN SARI,2962,117,2698,45,102,219,2021-02-13
317402,JAKARTA SELATAN,SETIA BUDI,4057,121,3765,64,107,228,2021-02-13
317104,JAKARTA PUSAT,SENEN,3444,120,3172,67,85,205,2021-02-13
317102,JAKARTA PUSAT,SAWAH BESAR,3090,109,2833,52,96,205,2021-02-13
317502,JAKARTA TIMUR,PULO GADUNG,7109,224,6591,121,173,397,2021-02-13
317410,JAKARTA SELATAN,PESANGGRAHAN,5468,129,5009,80,250,379,2021-02-13
317201,JAKARTA UTARA,PENJARINGAN,5630,330,5029,77,194,524,2021-02-13
317202,JAKARTA UTARA,TANJUNG PRIOK,9598,324,8735,148,391,715,2021-02-13
317505,JAKARTA TIMUR,PASAR REBO,5793,235,5228,83,247,482,2021-02-13
317408,JAKARTA SELATAN,PANCORAN,4557,135,4163,64,195,330,2021-02-13
317307,JAKARTA BARAT,PALMERAH,6091,207,5554,122,208,415,2021-02-13
317205,JAKARTA UTARA,PADEMANGAN,3536,126,3236,61,113,239,2021-02-13
317106,JAKARTA PUSAT,MENTENG,2577,65,2375,47,90,155,2021-02-13
317501,JAKARTA TIMUR,MATRAMAN,4892,154,4469,96,173,327,2021-02-13
317403,JAKARTA SELATAN,MAMPANG PRAPATAN,4536,78,4212,67,179,257,2021-02-13
317508,JAKARTA TIMUR,MAKASAR,6418,244,5851,91,232,476,2021-02-13
317504,JAKARTA TIMUR,KRAMAT JATI,7244,214,6629,132,269,483,2021-02-13
317404,JAKARTA SELATAN,PASAR MINGGU,8170,239,7481,134,316,555,2021-02-13
310102,KAB.ADM.KEP.SERIBU,KEP. SERIBU SELATAN,208,0,203,2,3,3,2021-02-13
111111,Luar DKI & Proses Update,Luar DKI & Proses Update,143008,137,141294,1273,304,441,2021-02-14
317202,JAKARTA UTARA,TANJUNG PRIOK,9685,297,8824,151,413,710,2021-02-14
317103,JAKARTA PUSAT,KEMAYORAN,7648,212,7051,129,256,468,2021-02-14
317206,JAKARTA UTARA,KELAPA GADING,4456,121,4104,66,165,286,2021-02-14
317305,JAKARTA BARAT,KEBON JERUK,8134,293,7519,136,186,479,2021-02-14
317405,JAKARTA SELATAN,KEBAYORAN LAMA,7084,198,6511,115,260,458,2021-02-14
317407,JAKARTA SELATAN,KEBAYORAN BARU,4713,93,4352,67,201,294,2021-02-14
317306,JAKARTA BARAT,KALI DERES,5758,137,5330,103,188,325,2021-02-14
317108,JAKARTA PUSAT,JOHAR BARU,3298,78,3029,83,108,186,2021-02-14
317503,JAKARTA TIMUR,JATINEGARA,6816,135,6382,109,190,325,2021-02-14
317409,JAKARTA SELATAN,JAGAKARSA,8211,152,7588,115,356,508,2021-02-14
317302,JAKARTA BARAT,GROGOL PETAMBURAN,6186,271,5669,112,134,405,2021-02-14
317101,JAKARTA PUSAT,GAMBIR,3040,86,2840,44,70,156,2021-02-14
317507,JAKARTA TIMUR,DUREN SAWIT,10508,269,9772,200,267,536,2021-02-14
317509,JAKARTA TIMUR,CIRACAS,6648,195,6141,105,207,402,2021-02-14
317510,JAKARTA TIMUR,CIPAYUNG,7568,213,7065,74,216,429,2021-02-14
317204,JAKARTA UTARA,CILINCING,6241,161,5792,101,187,348,2021-02-14
317406,JAKARTA SELATAN,CILANDAK,5898,176,5470,78,174,350,2021-02-14
317301,JAKARTA BARAT,CENGKARENG,10016,293,9172,198,353,646,2021-02-14
317105,JAKARTA PUSAT,CEMPAKA PUTIH,3848,92,3559,58,139,231,2021-02-14
317506,JAKARTA TIMUR,CAKUNG,9165,241,8543,146,235,476,2021-02-14
317308,JAKARTA BARAT,KEMBANGAN,7079,208,6491,89,291,499,2021-02-14
317401,JAKARTA SELATAN,TEBET,5834,116,5365,110,243,359,2021-02-14
310102,KAB.ADM.KEP.SERIBU,KEP. SERIBU SELATAN,208,0,203,2,3,3,2021-02-14
317203,JAKARTA UTARA,KOJA,6813,171,6332,109,201,372,2021-02-14
317107,JAKARTA PUSAT,TANAH ABANG,4666,98,4303,83,182,280,2021-02-14
317304,JAKARTA BARAT,TAMBORA,4309,184,3911,91,123,307,2021-02-14
317303,JAKARTA BARAT,TAMAN SARI,2980,102,2741,46,91,193,2021-02-14
317402,JAKARTA SELATAN,SETIA BUDI,4103,102,3811,64,126,228,2021-02-14
317104,JAKARTA PUSAT,SENEN,3468,116,3213,67,72,188,2021-02-14
317102,JAKARTA PUSAT,SAWAH BESAR,3123,89,2900,54,80,169,2021-02-14
317502,JAKARTA TIMUR,PULO GADUNG,7200,224,6679,122,175,399,2021-02-14
317410,JAKARTA SELATAN,PESANGGRAHAN,5555,134,5056,81,284,418,2021-02-14
317201,JAKARTA UTARA,PENJARINGAN,5705,276,5141,78,210,486,2021-02-14
317505,JAKARTA TIMUR,PASAR REBO,5851,179,5338,84,250,429,2021-02-14
317404,JAKARTA SELATAN,PASAR MINGGU,8284,220,7593,134,337,557,2021-02-14
317408,JAKARTA SELATAN,PANCORAN,4620,129,4220,64,207,336,2021-02-14
317307,JAKARTA BARAT,PALMERAH,6138,163,5653,123,199,362,2021-02-14
317205,JAKARTA UTARA,PADEMANGAN,3588,111,3277,61,139,250,2021-02-14
317106,JAKARTA PUSAT,MENTENG,2602,64,2424,48,66,130,2021-02-14
317501,JAKARTA TIMUR,MATRAMAN,4924,131,4522,97,174,305,2021-02-14
317403,JAKARTA SELATAN,MAMPANG PRAPATAN,4556,72,4260,68,156,228,2021-02-14
317508,JAKARTA TIMUR,MAKASAR,6502,225,5999,91,187,412,2021-02-14
317504,JAKARTA TIMUR,KRAMAT JATI,7298,190,6720,134,254,444,2021-02-14
310101,KAB.ADM.KEP.SERIBU,KEP. SERIBU UTARA,291,2,277,1,11,13,2021-02-14
111111,Luar DKI & Proses Update,Luar DKI & Proses Update,143008,137,141294,1273,304,441,2021-02-15
317403,JAKARTA SELATAN,MAMPANG PRAPATAN,4581,65,4308,69,139,204,2021-02-15
317406,JAKARTA SELATAN,CILANDAK,5948,180,5511,79,178,358,2021-02-15
317501,JAKARTA TIMUR,MATRAMAN,4945,133,4547,99,166,299,2021-02-15
317106,JAKARTA PUSAT,MENTENG,2614,68,2440,48,58,126,2021-02-15
317205,JAKARTA UTARA,PADEMANGAN,3621,114,3304,61,142,256,2021-02-15
317307,JAKARTA BARAT,PALMERAH,6160,168,5668,124,200,368,2021-02-15
317408,JAKARTA SELATAN,PANCORAN,4658,124,4283,66,185,309,2021-02-15
317404,JAKARTA SELATAN,PASAR MINGGU,8370,219,7692,136,323,542,2021-02-15
317505,JAKARTA TIMUR,PASAR REBO,5901,199,5398,84,220,419,2021-02-15
317201,JAKARTA UTARA,PENJARINGAN,5743,274,5194,78,197,471,2021-02-15
317508,JAKARTA TIMUR,MAKASAR,6546,235,6034,93,184,419,2021-02-15
317410,JAKARTA SELATAN,PESANGGRAHAN,5624,134,5134,83,273,407,2021-02-15
317102,JAKARTA PUSAT,SAWAH BESAR,3131,88,2926,55,62,150,2021-02-15
317104,JAKARTA PUSAT,SENEN,3485,110,3246,67,62,172,2021-02-15
317402,JAKARTA SELATAN,SETIA BUDI,4129,99,3848,66,116,215,2021-02-15
317303,JAKARTA BARAT,TAMAN SARI,3005,111,2756,46,92,203,2021-02-15
317304,JAKARTA BARAT,TAMBORA,4356,188,3939,91,138,326,2021-02-15
317107,JAKARTA PUSAT,TANAH ABANG,4680,106,4342,85,147,253,2021-02-15
317202,JAKARTA UTARA,TANJUNG PRIOK,9717,296,8906,151,364,660,2021-02-15
317401,JAKARTA SELATAN,TEBET,5886,120,5444,110,212,332,2021-02-15
317502,JAKARTA TIMUR,PULO GADUNG,7280,226,6734,122,198,424,2021-02-15
317504,JAKARTA TIMUR,KRAMAT JATI,7357,181,6782,136,258,439,2021-02-15
317203,JAKARTA UTARA,KOJA,6843,164,6388,112,179,343,2021-02-15
317409,JAKARTA SELATAN,JAGAKARSA,8300,157,7627,119,397,554,2021-02-15
317301,JAKARTA BARAT,CENGKARENG,10091,276,9236,199,380,656,2021-02-15
317204,JAKARTA UTARA,CILINCING,6276,152,5827,102,195,347,2021-02-15
317510,JAKARTA TIMUR,CIPAYUNG,7601,203,7108,75,215,418,2021-02-15
317509,JAKARTA TIMUR,CIRACAS,6748,179,6207,106,256,435,2021-02-15
317507,JAKARTA TIMUR,DUREN SAWIT,10569,294,9803,201,271,565,2021-02-15
317101,JAKARTA PUSAT,GAMBIR,3049,73,2865,46,65,138,2021-02-15
317302,JAKARTA BARAT,GROGOL PETAMBURAN,6232,260,5718,112,142,402,2021-02-15
310101,KAB.ADM.KEP.SERIBU,KEP. SERIBU UTARA,288,1,282,1,4,5,2021-02-15
317105,JAKARTA PUSAT,CEMPAKA PUTIH,3863,91,3604,58,110,201,2021-02-15
317503,JAKARTA TIMUR,JATINEGARA,6863,151,6399,109,204,355,2021-02-15
317306,JAKARTA BARAT,KALI DERES,5805,142,5357,104,202,344,2021-02-15
317407,JAKARTA SELATAN,KEBAYORAN BARU,4753,86,4393,67,207,293,2021-02-15
317405,JAKARTA SELATAN,KEBAYORAN LAMA,7146,204,6548,116,278,482,2021-02-15
317305,JAKARTA BARAT,KEBON JERUK,8198,230,7621,139,208,438,2021-02-15
317206,JAKARTA UTARA,KELAPA GADING,4487,126,4122,67,172,298,2021-02-15
317103,JAKARTA PUSAT,KEMAYORAN,7678,208,7133,130,207,415,2021-02-15
317308,JAKARTA BARAT,KEMBANGAN,7097,190,6536,89,282,472,2021-02-15
310102,KAB.ADM.KEP.SERIBU,KEP. SERIBU SELATAN,208,0,203,2,3,3,2021-02-15
317108,JAKARTA PUSAT,JOHAR BARU,3303,70,3062,84,87,157,2021-02-15
317506,JAKARTA TIMUR,CAKUNG,9211,239,8572,147,253,492,2021-02-15
111111,Luar DKI & Proses Update,Luar DKI & Proses Update,143008,137,141294,1273,304,441,2021-02-16
317506,JAKARTA TIMUR,CAKUNG,9318,243,8654,149,272,515,2021-02-16
317105,JAKARTA PUSAT,CEMPAKA PUTIH,3887,83,3626,58,120,203,2021-02-16
317301,JAKARTA BARAT,CENGKARENG,10137,231,9332,199,375,606,2021-02-16
317501,JAKARTA TIMUR,MATRAMAN,4966,127,4586,101,152,279,2021-02-16
317508,JAKARTA TIMUR,MAKASAR,6593,230,6067,96,200,430,2021-02-16
317504,JAKARTA TIMUR,KRAMAT JATI,7425,184,6845,137,259,443,2021-02-16
317203,JAKARTA UTARA,KOJA,6868,177,6407,112,172,349,2021-02-16
310101,KAB.ADM.KEP.SERIBU,KEP. SERIBU UTARA,289,2,281,2,4,6,2021-02-16
310102,KAB.ADM.KEP.SERIBU,KEP. SERIBU SELATAN,208,0,204,2,2,2,2021-02-16
317308,JAKARTA BARAT,KEMBANGAN,7122,166,6625,89,242,408,2021-02-16
317103,JAKARTA PUSAT,KEMAYORAN,7717,202,7158,132,225,427,2021-02-16
317206,JAKARTA UTARA,KELAPA GADING,4506,110,4164,67,165,275,2021-02-16
317305,JAKARTA BARAT,KEBON JERUK,8275,192,7715,141,227,419,2021-02-16
317403,JAKARTA SELATAN,MAMPANG PRAPATAN,4627,62,4337,70,158,220,2021-02-16
317405,JAKARTA SELATAN,KEBAYORAN LAMA,7184,207,6579,118,280,487,2021-02-16
317306,JAKARTA BARAT,KALI DERES,5843,131,5415,105,192,323,2021-02-16
317108,JAKARTA PUSAT,JOHAR BARU,3354,69,3073,84,128,197,2021-02-16
317503,JAKARTA TIMUR,JATINEGARA,6923,142,6451,110,220,362,2021-02-16
317409,JAKARTA SELATAN,JAGAKARSA,8390,154,7695,120,421,575,2021-02-16
317302,JAKARTA BARAT,GROGOL PETAMBURAN,6265,236,5767,113,149,385,2021-02-16
317101,JAKARTA PUSAT,GAMBIR,3065,67,2880,46,72,139,2021-02-16
317507,JAKARTA TIMUR,DUREN SAWIT,10723,307,9854,205,357,664,2021-02-16
317509,JAKARTA TIMUR,CIRACAS,6789,174,6266,109,240,414,2021-02-16
317510,JAKARTA TIMUR,CIPAYUNG,7651,211,7176,75,189,400,2021-02-16
317407,JAKARTA SELATAN,KEBAYORAN BARU,4777,78,4449,68,182,260,2021-02-16
317204,JAKARTA UTARA,CILINCING,6297,147,5858,105,187,334,2021-02-16
317406,JAKARTA SELATAN,CILANDAK,6005,175,5561,79,190,365,2021-02-16
317205,JAKARTA UTARA,PADEMANGAN,3644,103,3326,61,154,257,2021-02-16
317401,JAKARTA SELATAN,TEBET,5941,124,5481,112,224,348,2021-02-16
317202,JAKARTA UTARA,TANJUNG PRIOK,9738,282,8971,151,334,616,2021-02-16
317107,JAKARTA PUSAT,TANAH ABANG,4711,99,4364,85,163,262,2021-02-16
317304,JAKARTA BARAT,TAMBORA,4367,150,3987,93,137,287,2021-02-16
317303,JAKARTA BARAT,TAMAN SARI,3020,92,2796,46,86,178,2021-02-16
317106,JAKARTA PUSAT,MENTENG,2623,61,2452,49,61,122,2021-02-16
317104,JAKARTA PUSAT,SENEN,3508,102,3264,67,75,177,2021-02-16
317102,JAKARTA PUSAT,SAWAH BESAR,3140,79,2944,56,61,140,2021-02-16
317402,JAKARTA SELATAN,SETIA BUDI,4145,91,3879,67,108,199,2021-02-16
317410,JAKARTA SELATAN,PESANGGRAHAN,5678,135,5165,85,293,428,2021-02-16
317201,JAKARTA UTARA,PENJARINGAN,5777,247,5269,79,182,429,2021-02-16
317505,JAKARTA TIMUR,PASAR REBO,5960,201,5427,85,247,448,2021-02-16
317404,JAKARTA SELATAN,PASAR MINGGU,8477,232,7715,137,393,625,2021-02-16
317408,JAKARTA SELATAN,PANCORAN,4687,125,4332,66,164,289,2021-02-16
317307,JAKARTA BARAT,PALMERAH,6183,150,5727,125,181,331,2021-02-16
317502,JAKARTA TIMUR,PULO GADUNG,7319,223,6770,123,203,426,2021-02-16
317406,JAKARTA SELATAN,CILANDAK,6029,171,5648,79,131,302,2021-02-17
317506,JAKARTA TIMUR,CAKUNG,9376,242,8716,151,267,509,2021-02-17
317105,JAKARTA PUSAT,CEMPAKA PUTIH,3897,83,3639,58,117,200,2021-02-17
317301,JAKARTA BARAT,CENGKARENG,10180,226,9438,202,314,540,2021-02-17
111111,Luar DKI & Proses Update,Luar DKI & Proses Update,143008,137,141294,1273,304,441,2021-02-17
317510,JAKARTA TIMUR,CIPAYUNG,7701,202,7204,75,220,422,2021-02-17
317204,JAKARTA UTARA,CILINCING,6319,150,5900,105,164,314,2021-02-17
317205,JAKARTA UTARA,PADEMANGAN,3729,105,3350,61,213,318,2021-02-17
317408,JAKARTA SELATAN,PANCORAN,4695,121,4353,66,155,276,2021-02-17
317307,JAKARTA BARAT,PALMERAH,6271,156,5770,128,217,373,2021-02-17
317306,JAKARTA BARAT,KALI DERES,5875,127,5479,105,164,291,2021-02-17
317106,JAKARTA PUSAT,MENTENG,2620,55,2458,49,58,113,2021-02-17
317501,JAKARTA TIMUR,MATRAMAN,5007,119,4660,102,126,245,2021-02-17
317403,JAKARTA SELATAN,MAMPANG PRAPATAN,4629,57,4366,72,134,191,2021-02-17
317508,JAKARTA TIMUR,MAKASAR,6670,211,6119,97,243,454,2021-02-17
317504,JAKARTA TIMUR,KRAMAT JATI,7443,175,6957,136,175,350,2021-02-17
317203,JAKARTA UTARA,KOJA,6892,176,6416,114,186,362,2021-02-17
310101,KAB.ADM.KEP.SERIBU,KEP. SERIBU UTARA,289,1,282,2,4,5,2021-02-17
310102,KAB.ADM.KEP.SERIBU,KEP. SERIBU SELATAN,208,0,205,2,1,1,2021-02-17
317308,JAKARTA BARAT,KEMBANGAN,7133,170,6656,89,218,388,2021-02-17
317103,JAKARTA PUSAT,KEMAYORAN,7739,211,7203,132,193,404,2021-02-17
317206,JAKARTA UTARA,KELAPA GADING,4527,109,4196,68,154,263,2021-02-17
317305,JAKARTA BARAT,KEBON JERUK,8339,190,7778,140,231,421,2021-02-17
317404,JAKARTA SELATAN,PASAR MINGGU,8516,247,7801,138,330,577,2021-02-17
317505,JAKARTA TIMUR,PASAR REBO,6012,210,5528,84,190,400,2021-02-17
317108,JAKARTA PUSAT,JOHAR BARU,3358,67,3088,84,119,186,2021-02-17
317201,JAKARTA UTARA,PENJARINGAN,5806,244,5328,79,155,399,2021-02-17
317509,JAKARTA TIMUR,CIRACAS,6851,169,6320,111,251,420,2021-02-17
317507,JAKARTA TIMUR,DUREN SAWIT,10783,300,9909,208,366,666,2021-02-17
317101,JAKARTA PUSAT,GAMBIR,3074,66,2892,47,69,135,2021-02-17
317302,JAKARTA BARAT,GROGOL PETAMBURAN,6281,225,5811,116,129,354,2021-02-17
317409,JAKARTA SELATAN,JAGAKARSA,8429,157,7788,121,363,520,2021-02-17
317503,JAKARTA TIMUR,JATINEGARA,6951,139,6494,111,207,346,2021-02-17
317401,JAKARTA SELATAN,TEBET,5952,117,5511,112,212,329,2021-02-17
317405,JAKARTA SELATAN,KEBAYORAN LAMA,7250,199,6619,120,312,511,2021-02-17
317202,JAKARTA UTARA,TANJUNG PRIOK,9766,287,9038,151,290,577,2021-02-17
317304,JAKARTA BARAT,TAMBORA,4417,161,4040,93,123,284,2021-02-17
317303,JAKARTA BARAT,TAMAN SARI,3040,87,2813,47,93,180,2021-02-17
317402,JAKARTA SELATAN,SETIA BUDI,4156,93,3893,69,101,194,2021-02-17
317104,JAKARTA PUSAT,SENEN,3506,90,3277,67,72,162,2021-02-17
317102,JAKARTA PUSAT,SAWAH BESAR,3147,75,2959,58,55,130,2021-02-17
317502,JAKARTA TIMUR,PULO GADUNG,7383,221,6812,126,224,445,2021-02-17
317410,JAKARTA SELATAN,PESANGGRAHAN,5707,130,5203,85,289,419,2021-02-17
317107,JAKARTA PUSAT,TANAH ABANG,4733,98,4413,88,134,232,2021-02-17
317407,JAKARTA SELATAN,KEBAYORAN BARU,4852,81,4484,69,218,299,2021-02-17
317302,JAKARTA BARAT,GROGOL PETAMBURAN,6302,196,5863,117,126,322,2021-02-18
317101,JAKARTA PUSAT,GAMBIR,3086,56,2932,47,51,107,2021-02-18
317506,JAKARTA TIMUR,CAKUNG,9380,208,8794,152,226,434,2021-02-18
317105,JAKARTA PUSAT,CEMPAKA PUTIH,3904,77,3684,58,85,162,2021-02-18
317301,JAKARTA BARAT,CENGKARENG,10188,205,9487,202,294,499,2021-02-18
317406,JAKARTA SELATAN,CILANDAK,6034,161,5679,79,115,276,2021-02-18
317204,JAKARTA UTARA,CILINCING,6320,131,5944,106,139,270,2021-02-18
317510,JAKARTA TIMUR,CIPAYUNG,7708,188,7276,75,169,357,2021-02-18
111111,Luar DKI & Proses Update,Luar DKI & Proses Update,143008,137,141294,1273,304,441,2021-02-18
317509,JAKARTA TIMUR,CIRACAS,6858,151,6358,112,237,388,2021-02-18
317507,JAKARTA TIMUR,DUREN SAWIT,10788,269,10081,208,230,499,2021-02-18
317205,JAKARTA UTARA,PADEMANGAN,3733,78,3382,61,212,290,2021-02-18
317107,JAKARTA PUSAT,TANAH ABANG,4741,86,4473,89,93,179,2021-02-18
317304,JAKARTA BARAT,TAMBORA,4426,120,4114,93,99,219,2021-02-18
317303,JAKARTA BARAT,TAMAN SARI,3040,55,2849,47,89,144,2021-02-18
317402,JAKARTA SELATAN,SETIA BUDI,4168,83,3929,69,87,170,2021-02-18
317104,JAKARTA PUSAT,SENEN,3532,73,3313,67,79,152,2021-02-18
317102,JAKARTA PUSAT,SAWAH BESAR,3162,55,2989,59,59,114,2021-02-18
317502,JAKARTA TIMUR,PULO GADUNG,7399,203,6880,127,189,392,2021-02-18
317410,JAKARTA SELATAN,PESANGGRAHAN,5710,120,5268,85,237,357,2021-02-18
317201,JAKARTA UTARA,PENJARINGAN,5821,192,5409,79,141,333,2021-02-18
317505,JAKARTA TIMUR,PASAR REBO,6018,207,5569,84,158,365,2021-02-18
317404,JAKARTA SELATAN,PASAR MINGGU,8535,243,7886,140,266,509,2021-02-18
317408,JAKARTA SELATAN,PANCORAN,4700,100,4398,67,135,235,2021-02-18
317307,JAKARTA BARAT,PALMERAH,6280,143,5832,128,177,320,2021-02-18
317106,JAKARTA PUSAT,MENTENG,2628,48,2485,49,46,94,2021-02-18
317202,JAKARTA UTARA,TANJUNG PRIOK,9775,236,9122,151,266,502,2021-02-18
317501,JAKARTA TIMUR,MATRAMAN,5006,109,4712,103,82,191,2021-02-18
317508,JAKARTA TIMUR,MAKASAR,6682,176,6189,97,220,396,2021-02-18
317409,JAKARTA SELATAN,JAGAKARSA,8433,142,7909,121,261,403,2021-02-18
317503,JAKARTA TIMUR,JATINEGARA,6960,124,6568,111,157,281,2021-02-18
317108,JAKARTA PUSAT,JOHAR BARU,3376,59,3123,84,110,169,2021-02-18
317306,JAKARTA BARAT,KALI DERES,5887,117,5507,105,158,275,2021-02-18
317407,JAKARTA SELATAN,KEBAYORAN BARU,4855,68,4523,69,195,263,2021-02-18
317405,JAKARTA SELATAN,KEBAYORAN LAMA,7251,180,6715,120,236,416,2021-02-18
317305,JAKARTA BARAT,KEBON JERUK,8349,171,7828,142,208,379,2021-02-18
317206,JAKARTA UTARA,KELAPA GADING,4532,93,4252,68,119,212,2021-02-18
317103,JAKARTA PUSAT,KEMAYORAN,7759,188,7283,133,155,343,2021-02-18
317308,JAKARTA BARAT,KEMBANGAN,7142,163,6733,89,157,320,2021-02-18
310102,KAB.ADM.KEP.SERIBU,KEP. SERIBU SELATAN,208,0,206,2,0,0,2021-02-18
310101,KAB.ADM.KEP.SERIBU,KEP. SERIBU UTARA,289,1,283,2,3,4,2021-02-18
317203,JAKARTA UTARA,KOJA,6895,156,6506,115,118,274,2021-02-18
317504,JAKARTA TIMUR,KRAMAT JATI,7461,160,7013,136,152,312,2021-02-18
317403,JAKARTA SELATAN,MAMPANG PRAPATAN,4632,53,4396,72,111,164,2021-02-18
317401,JAKARTA SELATAN,TEBET,5958,104,5553,114,187,291,2021-02-18
317105,JAKARTA PUSAT,CEMPAKA PUTIH,3919,64,3733,58,64,128,2021-02-19
317407,JAKARTA SELATAN,KEBAYORAN BARU,4893,56,4567,69,201,257,2021-02-19
317301,JAKARTA BARAT,CENGKARENG,10214,188,9602,202,222,410,2021-02-19
317506,JAKARTA TIMUR,CAKUNG,9400,155,8862,153,230,385,2021-02-19
317406,JAKARTA SELATAN,CILANDAK,6088,140,5733,79,136,276,2021-02-19
317204,JAKARTA UTARA,CILINCING,6350,115,6010,106,119,234,2021-02-19
317510,JAKARTA TIMUR,CIPAYUNG,7753,149,7351,77,176,325,2021-02-19
317408,JAKARTA SELATAN,PANCORAN,4713,83,4446,67,117,200,2021-02-19
317108,JAKARTA PUSAT,JOHAR BARU,3376,35,3148,84,109,144,2021-02-19
317205,JAKARTA UTARA,PADEMANGAN,3754,78,3395,61,220,298,2021-02-19
317106,JAKARTA PUSAT,MENTENG,2638,38,2508,50,42,80,2021-02-19
317501,JAKARTA TIMUR,MATRAMAN,5017,82,4738,104,93,175,2021-02-19
317403,JAKARTA SELATAN,MAMPANG PRAPATAN,4721,47,4407,74,193,240,2021-02-19
317508,JAKARTA TIMUR,MAKASAR,6732,175,6292,101,164,339,2021-02-19
317404,JAKARTA SELATAN,PASAR MINGGU,8630,215,7968,141,306,521,2021-02-19
317504,JAKARTA TIMUR,KRAMAT JATI,7509,144,7055,137,173,317,2021-02-19
310101,KAB.ADM.KEP.SERIBU,KEP. SERIBU UTARA,289,0,284,2,3,3,2021-02-19
310102,KAB.ADM.KEP.SERIBU,KEP. SERIBU SELATAN,208,0,206,2,0,0,2021-02-19
317308,JAKARTA BARAT,KEMBANGAN,7214,149,6782,90,193,342,2021-02-19
317103,JAKARTA PUSAT,KEMAYORAN,7815,129,7403,135,148,277,2021-02-19
317206,JAKARTA UTARA,KELAPA GADING,4544,77,4290,68,109,186,2021-02-19
317305,JAKARTA BARAT,KEBON JERUK,8381,154,7853,142,232,386,2021-02-19
317405,JAKARTA SELATAN,KEBAYORAN LAMA,7318,149,6801,120,248,397,2021-02-19
317203,JAKARTA UTARA,KOJA,6940,119,6582,117,122,241,2021-02-19
317505,JAKARTA TIMUR,PASAR REBO,6054,148,5646,86,174,322,2021-02-19
317201,JAKARTA UTARA,PENJARINGAN,5839,185,5491,80,83,268,2021-02-19
317410,JAKARTA SELATAN,PESANGGRAHAN,5730,107,5322,86,215,322,2021-02-19
317509,JAKARTA TIMUR,CIRACAS,6945,130,6431,112,272,402,2021-02-19
317507,JAKARTA TIMUR,DUREN SAWIT,10841,241,10141,208,251,492,2021-02-19
317101,JAKARTA PUSAT,GAMBIR,3096,53,2944,47,52,105,2021-02-19
317302,JAKARTA BARAT,GROGOL PETAMBURAN,6333,161,5934,117,121,282,2021-02-19
317409,JAKARTA SELATAN,JAGAKARSA,8510,148,7972,122,268,416,2021-02-19
317503,JAKARTA TIMUR,JATINEGARA,6988,112,6595,113,168,280,2021-02-19
111111,Luar DKI & Proses Update,Luar DKI & Proses Update,143008,137,141294,1273,304,441,2021-02-19
317306,JAKARTA BARAT,KALI DERES,5904,102,5558,105,139,241,2021-02-19
317401,JAKARTA SELATAN,TEBET,5990,88,5594,115,193,281,2021-02-19
317107,JAKARTA PUSAT,TANAH ABANG,4771,65,4517,89,100,165,2021-02-19
317304,JAKARTA BARAT,TAMBORA,4426,107,4135,93,91,198,2021-02-19
317303,JAKARTA BARAT,TAMAN SARI,3048,52,2864,47,85,137,2021-02-19
317402,JAKARTA SELATAN,SETIA BUDI,4185,62,3980,69,74,136,2021-02-19
317104,JAKARTA PUSAT,SENEN,3541,56,3348,69,68,124,2021-02-19
317102,JAKARTA PUSAT,SAWAH BESAR,3178,56,3004,59,59,115,2021-02-19
317502,JAKARTA TIMUR,PULO GADUNG,7446,174,6939,129,204,378,2021-02-19
317202,JAKARTA UTARA,TANJUNG PRIOK,9861,213,9271,152,225,438,2021-02-19
317307,JAKARTA BARAT,PALMERAH,6297,112,5895,132,158,270,2021-02-19
111111,Luar DKI & Proses Update,Luar DKI & Proses Update,143008,137,141294,1273,304,441,2021-02-20
317408,JAKARTA SELATAN,PANCORAN,4823,106,4515,67,135,241,2021-02-20
317202,JAKARTA UTARA,TANJUNG PRIOK,9931,223,9360,154,194,417,2021-02-20
317504,JAKARTA TIMUR,KRAMAT JATI,7599,164,7126,138,171,335,2021-02-20
317508,JAKARTA TIMUR,MAKASAR,6815,178,6344,104,189,367,2021-02-20
317403,JAKARTA SELATAN,MAMPANG PRAPATAN,4787,47,4436,76,228,275,2021-02-20
317501,JAKARTA TIMUR,MATRAMAN,5058,87,4771,104,96,183,2021-02-20
317106,JAKARTA PUSAT,MENTENG,2658,33,2527,50,48,81,2021-02-20
317205,JAKARTA UTARA,PADEMANGAN,3781,66,3465,61,189,255,2021-02-20
317307,JAKARTA BARAT,PALMERAH,6343,108,5933,133,169,277,2021-02-20
317404,JAKARTA SELATAN,PASAR MINGGU,8688,211,8108,142,227,438,2021-02-20
317505,JAKARTA TIMUR,PASAR REBO,6143,140,5709,89,205,345,2021-02-20
317201,JAKARTA UTARA,PENJARINGAN,5888,189,5561,81,57,246,2021-02-20
317410,JAKARTA SELATAN,PESANGGRAHAN,5823,116,5427,86,194,310,2021-02-20
317502,JAKARTA TIMUR,PULO GADUNG,7519,200,7023,129,167,367,2021-02-20
317102,JAKARTA PUSAT,SAWAH BESAR,3209,57,3035,60,57,114,2021-02-20
317104,JAKARTA PUSAT,SENEN,3569,60,3372,69,68,128,2021-02-20
317402,JAKARTA SELATAN,SETIA BUDI,4206,70,4012,69,55,125,2021-02-20
317303,JAKARTA BARAT,TAMAN SARI,3060,51,2891,47,71,122,2021-02-20
317304,JAKARTA BARAT,TAMBORA,4517,124,4191,95,107,231,2021-02-20
317203,JAKARTA UTARA,KOJA,7006,123,6633,118,132,255,2021-02-20
310101,KAB.ADM.KEP.SERIBU,KEP. SERIBU UTARA,293,1,283,2,7,8,2021-02-20
310102,KAB.ADM.KEP.SERIBU,KEP. SERIBU SELATAN,210,0,206,2,2,2,2021-02-20
317308,JAKARTA BARAT,KEMBANGAN,7282,135,6866,91,190,325,2021-02-20
317506,JAKARTA TIMUR,CAKUNG,9529,188,8979,157,205,393,2021-02-20
317105,JAKARTA PUSAT,CEMPAKA PUTIH,3945,64,3771,58,52,116,2021-02-20
317301,JAKARTA BARAT,CENGKARENG,10324,175,9716,204,229,404,2021-02-20
317406,JAKARTA SELATAN,CILANDAK,6150,135,5784,79,152,287,2021-02-20
317204,JAKARTA UTARA,CILINCING,6451,128,6070,109,144,272,2021-02-20
317510,JAKARTA TIMUR,CIPAYUNG,7861,140,7432,78,211,351,2021-02-20
317507,JAKARTA TIMUR,DUREN SAWIT,10993,282,10195,209,307,589,2021-02-20
317101,JAKARTA PUSAT,GAMBIR,3111,48,2965,47,51,99,2021-02-20
317107,JAKARTA PUSAT,TANAH ABANG,4807,67,4555,90,95,162,2021-02-20
317302,JAKARTA BARAT,GROGOL PETAMBURAN,6384,148,5988,117,131,279,2021-02-20
317503,JAKARTA TIMUR,JATINEGARA,7026,112,6666,113,135,247,2021-02-20
317108,JAKARTA PUSAT,JOHAR BARU,3406,42,3181,86,97,139,2021-02-20
317306,JAKARTA BARAT,KALI DERES,5964,107,5611,105,141,248,2021-02-20
317407,JAKARTA SELATAN,KEBAYORAN BARU,4925,58,4613,70,184,242,2021-02-20
317405,JAKARTA SELATAN,KEBAYORAN LAMA,7399,153,6874,122,250,403,2021-02-20
317305,JAKARTA BARAT,KEBON JERUK,8418,155,7895,142,226,381,2021-02-20
317206,JAKARTA UTARA,KELAPA GADING,4606,82,4355,69,100,182,2021-02-20
317103,JAKARTA PUSAT,KEMAYORAN,7883,133,7453,136,161,294,2021-02-20
317409,JAKARTA SELATAN,JAGAKARSA,8624,152,8078,124,270,422,2021-02-20
317401,JAKARTA SELATAN,TEBET,6062,83,5673,115,191,274,2021-02-20
317509,JAKARTA TIMUR,CIRACAS,7059,131,6554,113,261,392,2021-02-20
317105,JAKARTA PUSAT,CEMPAKA PUTIH,3983,56,3808,58,61,117,2021-02-21
317403,JAKARTA SELATAN,MAMPANG PRAPATAN,4815,42,4500,76,197,239,2021-02-21
317508,JAKARTA TIMUR,MAKASAR,6898,170,6408,105,215,385,2021-02-21
317504,JAKARTA TIMUR,KRAMAT JATI,7673,163,7206,141,163,326,2021-02-21
317203,JAKARTA UTARA,KOJA,7048,127,6673,119,129,256,2021-02-21
310101,KAB.ADM.KEP.SERIBU,KEP. SERIBU UTARA,290,0,284,2,4,4,2021-02-21
310102,KAB.ADM.KEP.SERIBU,KEP. SERIBU SELATAN,210,0,206,2,2,2,2021-02-21
317308,JAKARTA BARAT,KEMBANGAN,7362,143,6895,94,230,373,2021-02-21
317103,JAKARTA PUSAT,KEMAYORAN,7931,148,7501,137,145,293,2021-02-21
317206,JAKARTA UTARA,KELAPA GADING,4645,91,4390,69,95,186,2021-02-21
317305,JAKARTA BARAT,KEBON JERUK,8510,158,8016,143,193,351,2021-02-21
317405,JAKARTA SELATAN,KEBAYORAN LAMA,7452,154,6918,122,258,412,2021-02-21
317407,JAKARTA SELATAN,KEBAYORAN BARU,5006,62,4660,70,214,276,2021-02-21
317306,JAKARTA BARAT,KALI DERES,6029,120,5655,106,148,268,2021-02-21
317108,JAKARTA PUSAT,JOHAR BARU,3432,46,3234,87,65,111,2021-02-21
317503,JAKARTA TIMUR,JATINEGARA,7115,105,6749,115,146,251,2021-02-21
317409,JAKARTA SELATAN,JAGAKARSA,8715,156,8186,124,249,405,2021-02-21
317302,JAKARTA BARAT,GROGOL PETAMBURAN,6467,166,6030,119,152,318,2021-02-21
317101,JAKARTA PUSAT,GAMBIR,3139,53,2988,47,51,104,2021-02-21
111111,Luar DKI & Proses Update,Luar DKI & Proses Update,143008,137,141294,1273,304,441,2021-02-21
317501,JAKARTA TIMUR,MATRAMAN,5119,86,4799,106,128,214,2021-02-21
317506,JAKARTA TIMUR,CAKUNG,9629,169,9101,159,200,369,2021-02-21
317106,JAKARTA PUSAT,MENTENG,2668,28,2549,50,41,69,2021-02-21
317307,JAKARTA BARAT,PALMERAH,6371,117,5953,134,167,284,2021-02-21
317509,JAKARTA TIMUR,CIRACAS,7166,140,6614,114,298,438,2021-02-21
317301,JAKARTA BARAT,CENGKARENG,10395,194,9777,205,219,413,2021-02-21
317406,JAKARTA SELATAN,CILANDAK,6225,133,5864,81,147,280,2021-02-21
317204,JAKARTA UTARA,CILINCING,6511,154,6112,110,135,289,2021-02-21
317510,JAKARTA TIMUR,CIPAYUNG,7937,137,7502,79,219,356,2021-02-21
317401,JAKARTA SELATAN,TEBET,6114,88,5725,114,187,275,2021-02-21
317202,JAKARTA UTARA,TANJUNG PRIOK,10011,214,9415,156,226,440,2021-02-21
317107,JAKARTA PUSAT,TANAH ABANG,4837,75,4583,91,88,163,2021-02-21
317205,JAKARTA UTARA,PADEMANGAN,3810,57,3509,63,181,238,2021-02-21
317304,JAKARTA BARAT,TAMBORA,4595,138,4220,97,140,278,2021-02-21
317402,JAKARTA SELATAN,SETIA BUDI,4253,70,4049,70,64,134,2021-02-21
317104,JAKARTA PUSAT,SENEN,3607,65,3406,70,66,131,2021-02-21
317102,JAKARTA PUSAT,SAWAH BESAR,3231,53,3059,61,58,111,2021-02-21
317502,JAKARTA TIMUR,PULO GADUNG,7614,175,7119,129,191,366,2021-02-21
317410,JAKARTA SELATAN,PESANGGRAHAN,5849,104,5494,86,165,269,2021-02-21
317201,JAKARTA UTARA,PENJARINGAN,5936,186,5617,83,50,236,2021-02-21
317505,JAKARTA TIMUR,PASAR REBO,6189,150,5783,91,165,315,2021-02-21
317404,JAKARTA SELATAN,PASAR MINGGU,8775,200,8235,146,194,394,2021-02-21
317408,JAKARTA SELATAN,PANCORAN,4869,104,4564,67,134,238,2021-02-21
317303,JAKARTA BARAT,TAMAN SARI,3076,49,2916,48,63,112,2021-02-21
317507,JAKARTA TIMUR,DUREN SAWIT,11092,272,10371,212,237,509,2021-02-21
111111,Luar DKI & Proses Update,Luar DKI & Proses Update,143008,137,141294,1273,304,441,2021-02-22
317307,JAKARTA BARAT,PALMERAH,6452,114,6051,135,152,266,2021-02-22
317403,JAKARTA SELATAN,MAMPANG PRAPATAN,4855,44,4504,77,230,274,2021-02-22
317508,JAKARTA TIMUR,MAKASAR,6951,151,6528,106,166,317,2021-02-22
317501,JAKARTA TIMUR,MATRAMAN,5197,82,4840,106,169,251,2021-02-22
317106,JAKARTA PUSAT,MENTENG,2686,23,2567,50,46,69,2021-02-22
317205,JAKARTA UTARA,PADEMANGAN,3826,49,3601,64,112,161,2021-02-22
317408,JAKARTA SELATAN,PANCORAN,4925,104,4588,67,166,270,2021-02-22
317404,JAKARTA SELATAN,PASAR MINGGU,8857,193,8284,146,234,427,2021-02-22
317505,JAKARTA TIMUR,PASAR REBO,6209,125,5865,92,127,252,2021-02-22
317201,JAKARTA UTARA,PENJARINGAN,5992,177,5671,84,60,237,2021-02-22
317504,JAKARTA TIMUR,KRAMAT JATI,7699,154,7248,143,154,308,2021-02-22
317410,JAKARTA SELATAN,PESANGGRAHAN,5942,93,5537,88,224,317,2021-02-22
317102,JAKARTA PUSAT,SAWAH BESAR,3251,51,3072,61,67,118,2021-02-22
317104,JAKARTA PUSAT,SENEN,3651,70,3432,70,79,149,2021-02-22
317402,JAKARTA SELATAN,SETIA BUDI,4289,75,4069,71,74,149,2021-02-22
317303,JAKARTA BARAT,TAMAN SARI,3096,42,2947,49,58,100,2021-02-22
317304,JAKARTA BARAT,TAMBORA,4656,137,4247,97,175,312,2021-02-22
317107,JAKARTA PUSAT,TANAH ABANG,4893,73,4613,91,116,189,2021-02-22
317202,JAKARTA UTARA,TANJUNG PRIOK,10056,205,9449,157,245,450,2021-02-22
317401,JAKARTA SELATAN,TEBET,6166,86,5754,114,212,298,2021-02-22
317502,JAKARTA TIMUR,PULO GADUNG,7660,147,7211,129,173,320,2021-02-22
310101,KAB.ADM.KEP.SERIBU,KEP. SERIBU UTARA,290,0,284,2,4,4,2021-02-22
317203,JAKARTA UTARA,KOJA,7086,123,6722,119,122,245,2021-02-22
317308,JAKARTA BARAT,KEMBANGAN,7407,144,6914,94,255,399,2021-02-22
317506,JAKARTA TIMUR,CAKUNG,9713,163,9144,161,245,408,2021-02-22
317105,JAKARTA PUSAT,CEMPAKA PUTIH,4018,54,3822,58,84,138,2021-02-22
317301,JAKARTA BARAT,CENGKARENG,10535,193,9850,206,286,479,2021-02-22
317406,JAKARTA SELATAN,CILANDAK,6256,116,5904,83,153,269,2021-02-22
317204,JAKARTA UTARA,CILINCING,6548,148,6131,111,158,306,2021-02-22
317510,JAKARTA TIMUR,CIPAYUNG,8046,129,7578,80,259,388,2021-02-22
317509,JAKARTA TIMUR,CIRACAS,7229,138,6691,114,286,424,2021-02-22
317507,JAKARTA TIMUR,DUREN SAWIT,11212,229,10487,215,281,510,2021-02-22
317101,JAKARTA PUSAT,GAMBIR,3162,61,3005,47,49,110,2021-02-22
310102,KAB.ADM.KEP.SERIBU,KEP. SERIBU SELATAN,210,0,206,2,2,2,2021-02-22
317302,JAKARTA BARAT,GROGOL PETAMBURAN,6525,154,6079,120,172,326,2021-02-22
317503,JAKARTA TIMUR,JATINEGARA,7197,92,6808,115,182,274,2021-02-22
317108,JAKARTA PUSAT,JOHAR BARU,3453,46,3255,87,65,111,2021-02-22
317306,JAKARTA BARAT,KALI DERES,6087,117,5707,107,156,273,2021-02-22
317407,JAKARTA SELATAN,KEBAYORAN BARU,5036,63,4754,71,148,211,2021-02-22
317405,JAKARTA SELATAN,KEBAYORAN LAMA,7539,135,7029,122,253,388,2021-02-22
317305,JAKARTA BARAT,KEBON JERUK,8571,155,8117,144,155,310,2021-02-22
317206,JAKARTA UTARA,KELAPA GADING,4669,86,4422,69,92,178,2021-02-22
317103,JAKARTA PUSAT,KEMAYORAN,8012,152,7529,137,194,346,2021-02-22
317409,JAKARTA SELATAN,JAGAKARSA,8809,154,8247,125,283,437,2021-02-22
317509,JAKARTA TIMUR,CIRACAS,7292,119,6771,115,287,406,2021-02-23
317204,JAKARTA UTARA,CILINCING,6571,133,6168,112,158,291,2021-02-23
317510,JAKARTA TIMUR,CIPAYUNG,8098,113,7626,81,278,391,2021-02-23
317406,JAKARTA SELATAN,CILANDAK,6256,96,5938,85,137,233,2021-02-23
317507,JAKARTA TIMUR,DUREN SAWIT,11255,209,10547,215,284,493,2021-02-23
317105,JAKARTA PUSAT,CEMPAKA PUTIH,4025,44,3840,58,83,127,2021-02-23
317506,JAKARTA TIMUR,CAKUNG,9741,137,9194,165,245,382,2021-02-23
111111,Luar DKI & Proses Update,Luar DKI & Proses Update,143008,137,141294,1273,304,441,2021-02-23
317301,JAKARTA BARAT,CENGKARENG,10550,168,9881,209,292,460,2021-02-23
317101,JAKARTA PUSAT,GAMBIR,3166,50,3018,47,51,101,2021-02-23
317302,JAKARTA BARAT,GROGOL PETAMBURAN,6526,142,6106,122,156,298,2021-02-23
317308,JAKARTA BARAT,KEMBANGAN,7422,115,6992,94,221,336,2021-02-23
317408,JAKARTA SELATAN,PANCORAN,4968,95,4601,67,205,300,2021-02-23
317404,JAKARTA SELATAN,PASAR MINGGU,8886,160,8383,148,195,355,2021-02-23
317505,JAKARTA TIMUR,PASAR REBO,6231,104,5915,93,119,223,2021-02-23
317201,JAKARTA UTARA,PENJARINGAN,6003,157,5696,83,67,224,2021-02-23
317410,JAKARTA SELATAN,PESANGGRAHAN,5938,73,5562,88,215,288,2021-02-23
317502,JAKARTA TIMUR,PULO GADUNG,7695,131,7262,130,172,303,2021-02-23
317205,JAKARTA UTARA,PADEMANGAN,3829,36,3625,64,104,140,2021-02-23
317102,JAKARTA PUSAT,SAWAH BESAR,3251,47,3092,61,51,98,2021-02-23
317402,JAKARTA SELATAN,SETIA BUDI,4312,71,4081,72,88,159,2021-02-23
317303,JAKARTA BARAT,TAMAN SARI,3095,35,2954,49,57,92,2021-02-23
317304,JAKARTA BARAT,TAMBORA,4668,119,4280,97,172,291,2021-02-23
317107,JAKARTA PUSAT,TANAH ABANG,4903,67,4661,91,84,151,2021-02-23
317202,JAKARTA UTARA,TANJUNG PRIOK,10088,209,9516,161,202,411,2021-02-23
317401,JAKARTA SELATAN,TEBET,6167,69,5785,116,197,266,2021-02-23
317104,JAKARTA PUSAT,SENEN,3655,58,3452,70,75,133,2021-02-23
317106,JAKARTA PUSAT,MENTENG,2700,21,2575,50,54,75,2021-02-23
317307,JAKARTA BARAT,PALMERAH,6452,92,6074,135,151,243,2021-02-23
317403,JAKARTA SELATAN,MAMPANG PRAPATAN,4886,39,4595,77,175,214,2021-02-23
317206,JAKARTA UTARA,KELAPA GADING,4679,82,4431,70,96,178,2021-02-23
317305,JAKARTA BARAT,KEBON JERUK,8598,145,8143,146,164,309,2021-02-23
317405,JAKARTA SELATAN,KEBAYORAN LAMA,7558,108,7100,124,226,334,2021-02-23
317407,JAKARTA SELATAN,KEBAYORAN BARU,5043,59,4762,72,150,209,2021-02-23
317306,JAKARTA BARAT,KALI DERES,6103,100,5737,108,158,258,2021-02-23
317501,JAKARTA TIMUR,MATRAMAN,5215,82,4872,106,155,237,2021-02-23
317503,JAKARTA TIMUR,JATINEGARA,7209,83,6840,117,169,252,2021-02-23
317108,JAKARTA PUSAT,JOHAR BARU,3458,40,3266,87,65,105,2021-02-23
310102,KAB.ADM.KEP.SERIBU,KEP. SERIBU SELATAN,211,0,207,2,2,2,2021-02-23
310101,KAB.ADM.KEP.SERIBU,KEP. SERIBU UTARA,290,0,283,3,4,4,2021-02-23
317203,JAKARTA UTARA,KOJA,7093,106,6773,121,93,199,2021-02-23
317504,JAKARTA TIMUR,KRAMAT JATI,7758,126,7300,145,187,313,2021-02-23
317508,JAKARTA TIMUR,MAKASAR,6947,130,6553,106,158,288,2021-02-23
317409,JAKARTA SELATAN,JAGAKARSA,8862,137,8307,126,292,429,2021-02-23
317103,JAKARTA PUSAT,KEMAYORAN,8030,133,7606,137,154,287,2021-02-23
317206,JAKARTA UTARA,KELAPA GADING,4685,80,4461,70,74,154,2021-02-24
317103,JAKARTA PUSAT,KEMAYORAN,8038,126,7648,139,125,251,2021-02-24
317506,JAKARTA TIMUR,CAKUNG,9801,117,9231,165,288,405,2021-02-24
317105,JAKARTA PUSAT,CEMPAKA PUTIH,4034,42,3857,60,75,117,2021-02-24
317301,JAKARTA BARAT,CENGKARENG,10604,157,10057,210,180,337,2021-02-24
317308,JAKARTA BARAT,KEMBANGAN,7439,97,7092,94,156,253,2021-02-24
317510,JAKARTA TIMUR,CIPAYUNG,8121,108,7647,84,282,390,2021-02-24
317502,JAKARTA TIMUR,PULO GADUNG,7722,108,7308,132,174,282,2021-02-24
317410,JAKARTA SELATAN,PESANGGRAHAN,5944,60,5633,89,162,222,2021-02-24
317201,JAKARTA UTARA,PENJARINGAN,6021,134,5727,83,77,211,2021-02-24
317505,JAKARTA TIMUR,PASAR REBO,6278,87,5952,94,145,232,2021-02-24
317404,JAKARTA SELATAN,PASAR MINGGU,8906,113,8476,150,167,280,2021-02-24
317408,JAKARTA SELATAN,PANCORAN,4976,77,4665,68,166,243,2021-02-24
317307,JAKARTA BARAT,PALMERAH,6452,84,6124,137,107,191,2021-02-24
317102,JAKARTA PUSAT,SAWAH BESAR,3259,48,3106,61,44,92,2021-02-24
317205,JAKARTA UTARA,PADEMANGAN,3838,36,3700,65,37,73,2021-02-24
317501,JAKARTA TIMUR,MATRAMAN,5223,75,4890,108,150,225,2021-02-24
317403,JAKARTA SELATAN,MAMPANG PRAPATAN,4890,34,4652,78,126,160,2021-02-24
317508,JAKARTA TIMUR,MAKASAR,6970,79,6615,106,170,249,2021-02-24
317504,JAKARTA TIMUR,KRAMAT JATI,7800,104,7341,146,209,313,2021-02-24
317203,JAKARTA UTARA,KOJA,7100,97,6787,124,92,189,2021-02-24
310101,KAB.ADM.KEP.SERIBU,KEP. SERIBU UTARA,291,1,287,3,0,1,2021-02-24
310102,KAB.ADM.KEP.SERIBU,KEP. SERIBU SELATAN,211,0,208,2,1,1,2021-02-24
317106,JAKARTA PUSAT,MENTENG,2704,18,2582,52,52,70,2021-02-24
317204,JAKARTA UTARA,CILINCING,6575,116,6221,112,126,242,2021-02-24
317104,JAKARTA PUSAT,SENEN,3655,45,3468,71,71,116,2021-02-24
317303,JAKARTA BARAT,TAMAN SARI,3094,31,2985,49,29,60,2021-02-24
317509,JAKARTA TIMUR,CIRACAS,7314,111,6809,116,278,389,2021-02-24
317507,JAKARTA TIMUR,DUREN SAWIT,11261,183,10602,216,260,443,2021-02-24
317101,JAKARTA PUSAT,GAMBIR,3165,40,3042,47,36,76,2021-02-24
317302,JAKARTA BARAT,GROGOL PETAMBURAN,6541,125,6190,123,103,228,2021-02-24
317409,JAKARTA SELATAN,JAGAKARSA,8910,100,8386,132,292,392,2021-02-24
317503,JAKARTA TIMUR,JATINEGARA,7238,76,6877,119,166,242,2021-02-24
317108,JAKARTA PUSAT,JOHAR BARU,3462,34,3288,89,51,85,2021-02-24
317402,JAKARTA SELATAN,SETIA BUDI,4328,65,4109,72,82,147,2021-02-24
317306,JAKARTA BARAT,KALI DERES,6118,91,5788,109,130,221,2021-02-24
317405,JAKARTA SELATAN,KEBAYORAN LAMA,7586,91,7182,127,186,277,2021-02-24
317305,JAKARTA BARAT,KEBON JERUK,8615,144,8192,147,132,276,2021-02-24
111111,Luar DKI & Proses Update,Luar DKI & Proses Update,143008,137,141294,1273,304,441,2021-02-24
317401,JAKARTA SELATAN,TEBET,6189,66,5861,118,144,210,2021-02-24
317202,JAKARTA UTARA,TANJUNG PRIOK,10098,174,9656,162,106,280,2021-02-24
317107,JAKARTA PUSAT,TANAH ABANG,4913,71,4676,91,75,146,2021-02-24
317304,JAKARTA BARAT,TAMBORA,4691,121,4318,97,155,276,2021-02-24
317407,JAKARTA SELATAN,KEBAYORAN BARU,5065,53,4815,74,123,176,2021-02-24
317406,JAKARTA SELATAN,CILANDAK,6272,78,5984,85,125,203,2021-02-24
317104,JAKARTA PUSAT,SENEN,3679,41,3490,72,76,117,2021-02-25
317202,JAKARTA UTARA,TANJUNG PRIOK,10192,166,9724,162,140,306,2021-02-25
317103,JAKARTA PUSAT,KEMAYORAN,8092,120,7697,140,135,255,2021-02-25
317206,JAKARTA UTARA,KELAPA GADING,4699,60,4515,71,53,113,2021-02-25
317305,JAKARTA BARAT,KEBON JERUK,8645,141,8267,148,89,230,2021-02-25
317405,JAKARTA SELATAN,KEBAYORAN LAMA,7592,82,7232,128,150,232,2021-02-25
317407,JAKARTA SELATAN,KEBAYORAN BARU,5071,54,4827,75,115,169,2021-02-25
317306,JAKARTA BARAT,KALI DERES,6164,82,5875,111,96,178,2021-02-25
317108,JAKARTA PUSAT,JOHAR BARU,3479,25,3305,90,59,84,2021-02-25
317503,JAKARTA TIMUR,JATINEGARA,7303,81,6896,120,206,287,2021-02-25
317409,JAKARTA SELATAN,JAGAKARSA,8977,99,8473,132,273,372,2021-02-25
317302,JAKARTA BARAT,GROGOL PETAMBURAN,6584,117,6269,123,75,192,2021-02-25
317101,JAKARTA PUSAT,GAMBIR,3191,32,3046,48,65,97,2021-02-25
317507,JAKARTA TIMUR,DUREN SAWIT,11356,169,10725,218,244,413,2021-02-25
317509,JAKARTA TIMUR,CIRACAS,7313,98,6898,118,199,297,2021-02-25
317510,JAKARTA TIMUR,CIPAYUNG,8140,108,7728,86,218,326,2021-02-25
317204,JAKARTA UTARA,CILINCING,6576,88,6306,112,70,158,2021-02-25
317406,JAKARTA SELATAN,CILANDAK,6332,84,6021,85,142,226,2021-02-25
317301,JAKARTA BARAT,CENGKARENG,10649,151,10093,212,193,344,2021-02-25
317105,JAKARTA PUSAT,CEMPAKA PUTIH,4037,42,3845,60,90,132,2021-02-25
317506,JAKARTA TIMUR,CAKUNG,9862,104,9326,168,264,368,2021-02-25
317308,JAKARTA BARAT,KEMBANGAN,7456,78,7195,94,89,167,2021-02-25
317401,JAKARTA SELATAN,TEBET,6198,67,5909,120,102,169,2021-02-25
310102,KAB.ADM.KEP.SERIBU,KEP. SERIBU SELATAN,211,0,208,2,1,1,2021-02-25
317203,JAKARTA UTARA,KOJA,7120,92,6842,125,61,153,2021-02-25
317107,JAKARTA PUSAT,TANAH ABANG,4933,54,4700,91,88,142,2021-02-25
317304,JAKARTA BARAT,TAMBORA,4719,103,4420,97,99,202,2021-02-25
317303,JAKARTA BARAT,TAMAN SARI,3114,35,2996,49,34,69,2021-02-25
317402,JAKARTA SELATAN,SETIA BUDI,4345,64,4126,72,83,147,2021-02-25
111111,Luar DKI & Proses Update,Luar DKI & Proses Update,143008,137,141294,1273,304,441,2021-02-25
317102,JAKARTA PUSAT,SAWAH BESAR,3271,39,3135,61,36,75,2021-02-25
317502,JAKARTA TIMUR,PULO GADUNG,7762,97,7355,133,177,274,2021-02-25
317410,JAKARTA SELATAN,PESANGGRAHAN,6004,60,5703,91,150,210,2021-02-25
317201,JAKARTA UTARA,PENJARINGAN,6060,134,5772,83,71,205,2021-02-25
317505,JAKARTA TIMUR,PASAR REBO,6337,86,6006,97,148,234,2021-02-25
317404,JAKARTA SELATAN,PASAR MINGGU,9020,118,8508,152,242,360,2021-02-25
317408,JAKARTA SELATAN,PANCORAN,4990,71,4732,70,117,188,2021-02-25
317307,JAKARTA BARAT,PALMERAH,6488,73,6176,138,101,174,2021-02-25
317205,JAKARTA UTARA,PADEMANGAN,3869,40,3706,65,58,98,2021-02-25
317106,JAKARTA PUSAT,MENTENG,2693,19,2597,52,25,44,2021-02-25
317501,JAKARTA TIMUR,MATRAMAN,5231,73,4914,108,136,209,2021-02-25
317403,JAKARTA SELATAN,MAMPANG PRAPATAN,4921,41,4704,81,95,136,2021-02-25
317508,JAKARTA TIMUR,MAKASAR,6971,73,6662,108,128,201,2021-02-25
317504,JAKARTA TIMUR,KRAMAT JATI,7847,90,7405,147,205,295,2021-02-25
310101,KAB.ADM.KEP.SERIBU,KEP. SERIBU UTARA,293,1,288,3,1,2,2021-02-25
111111,Luar DKI & Proses Update,Luar DKI & Proses Update,143008,137,141294,1273,304,441,2021-02-26
317402,JAKARTA SELATAN,SETIA BUDI,4362,64,4163,72,63,127,2021-02-26
317503,JAKARTA TIMUR,JATINEGARA,7352,90,6969,122,171,261,2021-02-26
317508,JAKARTA TIMUR,MAKASAR,7018,82,6735,109,92,174,2021-02-26
317403,JAKARTA SELATAN,MAMPANG PRAPATAN,4921,38,4720,81,82,120,2021-02-26
317501,JAKARTA TIMUR,MATRAMAN,5272,68,4965,110,129,197,2021-02-26
317106,JAKARTA PUSAT,MENTENG,2705,19,2603,53,30,49,2021-02-26
317205,JAKARTA UTARA,PADEMANGAN,3886,34,3728,65,59,93,2021-02-26
317307,JAKARTA BARAT,PALMERAH,6518,69,6177,141,131,200,2021-02-26
317408,JAKARTA SELATAN,PANCORAN,5020,59,4762,71,128,187,2021-02-26
317404,JAKARTA SELATAN,PASAR MINGGU,9091,118,8575,156,242,360,2021-02-26
317504,JAKARTA TIMUR,KRAMAT JATI,7902,95,7454,147,206,301,2021-02-26
317505,JAKARTA TIMUR,PASAR REBO,6357,64,6034,97,162,226,2021-02-26
317410,JAKARTA SELATAN,PESANGGRAHAN,6042,66,5708,91,177,243,2021-02-26
317502,JAKARTA TIMUR,PULO GADUNG,7813,93,7433,133,154,247,2021-02-26
317102,JAKARTA PUSAT,SAWAH BESAR,3313,40,3155,61,57,97,2021-02-26
317104,JAKARTA PUSAT,SENEN,3700,46,3517,72,65,111,2021-02-26
317303,JAKARTA BARAT,TAMAN SARI,3141,38,3001,49,53,91,2021-02-26
317304,JAKARTA BARAT,TAMBORA,4763,112,4469,97,85,197,2021-02-26
317107,JAKARTA PUSAT,TANAH ABANG,4961,57,4724,92,88,145,2021-02-26
317202,JAKARTA UTARA,TANJUNG PRIOK,10235,147,9762,162,164,311,2021-02-26
317201,JAKARTA UTARA,PENJARINGAN,6125,153,5796,83,93,246,2021-02-26
317203,JAKARTA UTARA,KOJA,7192,95,6861,127,109,204,2021-02-26
310101,KAB.ADM.KEP.SERIBU,KEP. SERIBU UTARA,292,0,287,4,1,1,2021-02-26
310102,KAB.ADM.KEP.SERIBU,KEP. SERIBU SELATAN,212,1,208,2,1,2,2021-02-26
317506,JAKARTA TIMUR,CAKUNG,9917,115,9406,169,227,342,2021-02-26
317105,JAKARTA PUSAT,CEMPAKA PUTIH,4042,38,3871,60,73,111,2021-02-26
317301,JAKARTA BARAT,CENGKARENG,10669,147,10148,213,161,308,2021-02-26
317406,JAKARTA SELATAN,CILANDAK,6358,68,6078,86,126,194,2021-02-26
317204,JAKARTA UTARA,CILINCING,6606,66,6350,113,77,143,2021-02-26
317510,JAKARTA TIMUR,CIPAYUNG,8219,114,7795,87,223,337,2021-02-26
317509,JAKARTA TIMUR,CIRACAS,7385,100,6984,118,183,283,2021-02-26
317507,JAKARTA TIMUR,DUREN SAWIT,11449,163,10796,221,269,432,2021-02-26
317101,JAKARTA PUSAT,GAMBIR,3205,28,3068,48,61,89,2021-02-26
317302,JAKARTA BARAT,GROGOL PETAMBURAN,6615,111,6297,125,82,193,2021-02-26
317409,JAKARTA SELATAN,JAGAKARSA,9084,95,8540,134,315,410,2021-02-26
317108,JAKARTA PUSAT,JOHAR BARU,3488,25,3319,90,54,79,2021-02-26
317306,JAKARTA BARAT,KALI DERES,6193,76,5885,111,121,197,2021-02-26
317407,JAKARTA SELATAN,KEBAYORAN BARU,5078,44,4900,75,59,103,2021-02-26
317405,JAKARTA SELATAN,KEBAYORAN LAMA,7641,87,7265,130,159,246,2021-02-26
317305,JAKARTA BARAT,KEBON JERUK,8676,128,8267,150,131,259,2021-02-26
317206,JAKARTA UTARA,KELAPA GADING,4720,58,4534,72,56,114,2021-02-26
317103,JAKARTA PUSAT,KEMAYORAN,8128,99,7763,142,124,223,2021-02-26
317308,JAKARTA BARAT,KEMBANGAN,7451,64,7198,94,95,159,2021-02-26
317401,JAKARTA SELATAN,TEBET,6243,63,5952,120,108,171,2021-02-26
317108,JAKARTA PUSAT,JOHAR BARU,3517,37,3333,91,56,93,2021-02-27
317306,JAKARTA BARAT,KALI DERES,6238,83,5933,114,108,191,2021-02-27
317301,JAKARTA BARAT,CENGKARENG,10750,149,10222,219,160,309,2021-02-27
317404,JAKARTA SELATAN,PASAR MINGGU,9157,107,8634,156,260,367,2021-02-27
317408,JAKARTA SELATAN,PANCORAN,5032,59,4808,73,92,151,2021-02-27
317307,JAKARTA BARAT,PALMERAH,6541,68,6242,141,90,158,2021-02-27
317205,JAKARTA UTARA,PADEMANGAN,3902,35,3727,66,74,109,2021-02-27
317106,JAKARTA PUSAT,MENTENG,2717,20,2613,53,31,51,2021-02-27
317501,JAKARTA TIMUR,MATRAMAN,5317,70,4991,111,145,215,2021-02-27
317403,JAKARTA SELATAN,MAMPANG PRAPATAN,4943,40,4752,81,70,110,2021-02-27
317508,JAKARTA TIMUR,MAKASAR,7074,72,6744,112,146,218,2021-02-27
317505,JAKARTA TIMUR,PASAR REBO,6472,72,6037,99,264,336,2021-02-27
317504,JAKARTA TIMUR,KRAMAT JATI,8004,99,7462,148,295,394,2021-02-27
310101,KAB.ADM.KEP.SERIBU,KEP. SERIBU UTARA,292,0,287,4,1,1,2021-02-27
310102,KAB.ADM.KEP.SERIBU,KEP. SERIBU SELATAN,212,1,208,2,1,2,2021-02-27
317308,JAKARTA BARAT,KEMBANGAN,7496,68,7228,94,106,174,2021-02-27
317103,JAKARTA PUSAT,KEMAYORAN,8156,90,7798,143,125,215,2021-02-27
317206,JAKARTA UTARA,KELAPA GADING,4728,54,4539,72,63,117,2021-02-27
317305,JAKARTA BARAT,KEBON JERUK,8703,118,8307,154,124,242,2021-02-27
317405,JAKARTA SELATAN,KEBAYORAN LAMA,7662,85,7332,131,114,199,2021-02-27
317407,JAKARTA SELATAN,KEBAYORAN BARU,5112,44,4909,75,84,128,2021-02-27
317203,JAKARTA UTARA,KOJA,7219,94,6874,128,123,217,2021-02-27
317201,JAKARTA UTARA,PENJARINGAN,6160,160,5818,83,99,259,2021-02-27
317410,JAKARTA SELATAN,PESANGGRAHAN,6071,64,5788,91,128,192,2021-02-27
317502,JAKARTA TIMUR,PULO GADUNG,7857,108,7447,135,167,275,2021-02-27
317406,JAKARTA SELATAN,CILANDAK,6396,77,6083,88,148,225,2021-02-27
317204,JAKARTA UTARA,CILINCING,6628,72,6360,114,82,154,2021-02-27
317510,JAKARTA TIMUR,CIPAYUNG,8280,109,7806,88,277,386,2021-02-27
317509,JAKARTA TIMUR,CIRACAS,7447,96,6994,120,237,333,2021-02-27
317507,JAKARTA TIMUR,DUREN SAWIT,11532,172,10861,224,275,447,2021-02-27
317101,JAKARTA PUSAT,GAMBIR,3217,26,3079,48,64,90,2021-02-27
317302,JAKARTA BARAT,GROGOL PETAMBURAN,6649,117,6331,126,75,192,2021-02-27
317409,JAKARTA SELATAN,JAGAKARSA,9135,97,8619,136,283,380,2021-02-27
317503,JAKARTA TIMUR,JATINEGARA,7384,86,6999,125,174,260,2021-02-27
111111,Luar DKI & Proses Update,Luar DKI & Proses Update,143008,137,141294,1273,304,441,2021-02-27
317401,JAKARTA SELATAN,TEBET,6275,65,5994,119,97,162,2021-02-27
317202,JAKARTA UTARA,TANJUNG PRIOK,10294,159,9777,166,192,351,2021-02-27
317107,JAKARTA PUSAT,TANAH ABANG,4993,63,4760,93,77,140,2021-02-27
317304,JAKARTA BARAT,TAMBORA,4791,114,4505,97,75,189,2021-02-27
317303,JAKARTA BARAT,TAMAN SARI,3151,40,3012,49,50,90,2021-02-27
317402,JAKARTA SELATAN,SETIA BUDI,4374,61,4189,74,50,111,2021-02-27
317104,JAKARTA PUSAT,SENEN,3723,46,3549,73,55,101,2021-02-27
317102,JAKARTA PUSAT,SAWAH BESAR,3328,40,3163,61,64,104,2021-02-27
317105,JAKARTA PUSAT,CEMPAKA PUTIH,4072,45,3900,61,66,111,2021-02-27
317506,JAKARTA TIMUR,CAKUNG,9972,131,9431,169,241,372,2021-02-27
111111,Luar DKI & Proses Update,Luar DKI & Proses Update,143008,137,141294,1273,304,441,2021-02-28
317504,JAKARTA TIMUR,KRAMAT JATI,8044,112,7485,149,298,410,2021-02-28
317106,JAKARTA PUSAT,MENTENG,2739,25,2618,54,42,67,2021-02-28
317505,JAKARTA TIMUR,PASAR REBO,6503,87,6048,101,267,354,2021-02-28
317404,JAKARTA SELATAN,PASAR MINGGU,9245,96,8688,157,304,400,2021-02-28
317408,JAKARTA SELATAN,PANCORAN,5052,59,4858,75,60,119,2021-02-28
317307,JAKARTA BARAT,PALMERAH,6566,67,6263,141,95,162,2021-02-28
317205,JAKARTA UTARA,PADEMANGAN,3925,44,3733,67,81,125,2021-02-28
317503,JAKARTA TIMUR,JATINEGARA,7422,90,7052,127,153,243,2021-02-28
317501,JAKARTA TIMUR,MATRAMAN,5332,64,5054,112,102,166,2021-02-28
317403,JAKARTA SELATAN,MAMPANG PRAPATAN,4964,43,4786,82,53,96,2021-02-28
317201,JAKARTA UTARA,PENJARINGAN,6219,190,5837,83,109,299,2021-02-28
317508,JAKARTA TIMUR,MAKASAR,7110,80,6790,112,128,208,2021-02-28
310101,KAB.ADM.KEP.SERIBU,KEP. SERIBU UTARA,295,0,288,4,3,3,2021-02-28
310102,KAB.ADM.KEP.SERIBU,KEP. SERIBU SELATAN,231,1,226,2,2,3,2021-02-28
317308,JAKARTA BARAT,KEMBANGAN,7563,85,7271,95,112,197,2021-02-28
317103,JAKARTA PUSAT,KEMAYORAN,8205,92,7825,144,144,236,2021-02-28
317206,JAKARTA UTARA,KELAPA GADING,4758,75,4555,73,55,130,2021-02-28
317305,JAKARTA BARAT,KEBON JERUK,8785,136,8358,154,137,273,2021-02-28
317405,JAKARTA SELATAN,KEBAYORAN LAMA,7715,94,7361,132,128,222,2021-02-28
317407,JAKARTA SELATAN,KEBAYORAN BARU,5131,53,4927,76,75,128,2021-02-28
317203,JAKARTA UTARA,KOJA,7268,105,6902,128,133,238,2021-02-28
317410,JAKARTA SELATAN,PESANGGRAHAN,6133,69,5800,91,173,242,2021-02-28
317502,JAKARTA TIMUR,PULO GADUNG,7915,123,7493,137,162,285,2021-02-28
317102,JAKARTA PUSAT,SAWAH BESAR,3355,49,3171,61,74,123,2021-02-28
317506,JAKARTA TIMUR,CAKUNG,10037,134,9518,170,215,349,2021-02-28
317105,JAKARTA PUSAT,CEMPAKA PUTIH,4106,49,3914,61,82,131,2021-02-28
317301,JAKARTA BARAT,CENGKARENG,10839,172,10256,220,191,363,2021-02-28
317406,JAKARTA SELATAN,CILANDAK,6458,74,6104,89,191,265,2021-02-28
317204,JAKARTA UTARA,CILINCING,6664,74,6398,115,77,151,2021-02-28
317510,JAKARTA TIMUR,CIPAYUNG,8310,114,7964,90,142,256,2021-02-28
317509,JAKARTA TIMUR,CIRACAS,7472,96,7077,121,178,274,2021-02-28
317507,JAKARTA TIMUR,DUREN SAWIT,11613,170,10935,225,283,453,2021-02-28
317306,JAKARTA BARAT,KALI DERES,6291,93,5962,116,120,213,2021-02-28
317101,JAKARTA PUSAT,GAMBIR,3241,33,3087,48,73,106,2021-02-28
317409,JAKARTA SELATAN,JAGAKARSA,9248,106,8688,139,315,421,2021-02-28
317401,JAKARTA SELATAN,TEBET,6317,83,6012,120,102,185,2021-02-28
317202,JAKARTA UTARA,TANJUNG PRIOK,10370,174,9809,167,220,394,2021-02-28
317107,JAKARTA PUSAT,TANAH ABANG,5024,65,4773,94,92,157,2021-02-28
317304,JAKARTA BARAT,TAMBORA,4839,124,4535,97,83,207,2021-02-28
317303,JAKARTA BARAT,TAMAN SARI,3173,49,3017,50,57,106,2021-02-28
317402,JAKARTA SELATAN,SETIA BUDI,4409,58,4221,74,56,114,2021-02-28
317104,JAKARTA PUSAT,SENEN,3741,54,3555,73,59,113,2021-02-28
317302,JAKARTA BARAT,GROGOL PETAMBURAN,6702,135,6352,126,89,224,2021-02-28
317108,JAKARTA PUSAT,JOHAR BARU,3536,42,3342,92,60,102,2021-02-28
111111,Luar DKI & Proses Update,Luar DKI & Proses Update,143008,137,141294,1273,304,441,2021-03-01
317405,JAKARTA SELATAN,KEBAYORAN LAMA,7762,60,7440,136,126,186,2021-03-01
317506,JAKARTA TIMUR,CAKUNG,10075,91,9715,174,95,186,2021-03-01
317105,JAKARTA PUSAT,CEMPAKA PUTIH,4155,34,3974,62,85,119,2021-03-01
317301,JAKARTA BARAT,CENGKARENG,10897,107,10427,222,141,248,2021-03-01
317406,JAKARTA SELATAN,CILANDAK,6510,37,6230,95,148,185,2021-03-01
317204,JAKARTA UTARA,CILINCING,6699,73,6445,118,63,136,2021-03-01
317510,JAKARTA TIMUR,CIPAYUNG,8394,68,8054,91,181,249,2021-03-01
317509,JAKARTA TIMUR,CIRACAS,7541,45,7198,123,175,220,2021-03-01
317507,JAKARTA TIMUR,DUREN SAWIT,11685,102,11170,229,184,286,2021-03-01
317101,JAKARTA PUSAT,GAMBIR,3254,28,3134,48,44,72,2021-03-01
317302,JAKARTA BARAT,GROGOL PETAMBURAN,6750,92,6470,128,60,152,2021-03-01
317409,JAKARTA SELATAN,JAGAKARSA,9379,69,8855,143,312,381,2021-03-01
317503,JAKARTA TIMUR,JATINEGARA,7482,58,7179,131,114,172,2021-03-01
317407,JAKARTA SELATAN,KEBAYORAN BARU,5194,49,4976,78,91,140,2021-03-01
317108,JAKARTA PUSAT,JOHAR BARU,3581,35,3392,92,62,97,2021-03-01
317306,JAKARTA BARAT,KALI DERES,6336,69,6067,117,83,152,2021-03-01
317305,JAKARTA BARAT,KEBON JERUK,8873,101,8473,157,142,243,2021-03-01
317401,JAKARTA SELATAN,TEBET,6411,54,6073,122,162,216,2021-03-01
317202,JAKARTA UTARA,TANJUNG PRIOK,10439,122,9998,172,147,269,2021-03-01
317107,JAKARTA PUSAT,TANAH ABANG,5050,50,4833,95,72,122,2021-03-01
317304,JAKARTA BARAT,TAMBORA,4890,73,4649,97,71,144,2021-03-01
317303,JAKARTA BARAT,TAMAN SARI,3210,34,3072,51,53,87,2021-03-01
317402,JAKARTA SELATAN,SETIA BUDI,4462,32,4264,75,91,123,2021-03-01
317104,JAKARTA PUSAT,SENEN,3764,38,3610,75,41,79,2021-03-01
317102,JAKARTA PUSAT,SAWAH BESAR,3393,37,3231,61,64,101,2021-03-01
317502,JAKARTA TIMUR,PULO GADUNG,7973,98,7615,140,120,218,2021-03-01
317410,JAKARTA SELATAN,PESANGGRAHAN,6201,41,5927,92,141,182,2021-03-01
317201,JAKARTA UTARA,PENJARINGAN,6279,144,5971,84,80,224,2021-03-01
317505,JAKARTA TIMUR,PASAR REBO,6557,69,6206,110,172,241,2021-03-01
317404,JAKARTA SELATAN,PASAR MINGGU,9339,67,8892,160,220,287,2021-03-01
317206,JAKARTA UTARA,KELAPA GADING,4786,58,4622,74,32,90,2021-03-01
317307,JAKARTA BARAT,PALMERAH,6619,43,6324,143,109,152,2021-03-01
317408,JAKARTA SELATAN,PANCORAN,5133,49,4896,77,111,160,2021-03-01
317103,JAKARTA PUSAT,KEMAYORAN,8260,74,7950,144,92,166,2021-03-01
317308,JAKARTA BARAT,KEMBANGAN,7650,82,7333,95,140,222,2021-03-01
310102,KAB.ADM.KEP.SERIBU,KEP. SERIBU SELATAN,230,0,225,2,3,3,2021-03-01
317203,JAKARTA UTARA,KOJA,7306,74,6971,130,131,205,2021-03-01
310101,KAB.ADM.KEP.SERIBU,KEP. SERIBU UTARA,295,1,289,4,1,2,2021-03-01
317508,JAKARTA TIMUR,MAKASAR,7164,70,6854,112,128,198,2021-03-01
317403,JAKARTA SELATAN,MAMPANG PRAPATAN,4995,29,4828,84,54,83,2021-03-01
317501,JAKARTA TIMUR,MATRAMAN,5384,41,5138,115,90,131,2021-03-01
317106,JAKARTA PUSAT,MENTENG,2748,21,2639,55,33,54,2021-03-01
317205,JAKARTA UTARA,PADEMANGAN,3973,39,3800,68,66,105,2021-03-01
317504,JAKARTA TIMUR,KRAMAT JATI,8120,92,7673,151,204,296,2021-03-01
317305,JAKARTA BARAT,KEBON JERUK,8926,119,8553,159,95,214,2021-03-02
310102,KAB.ADM.KEP.SERIBU,KEP. SERIBU SELATAN,230,0,225,2,3,3,2021-03-02
317206,JAKARTA UTARA,KELAPA GADING,4803,52,4652,75,24,76,2021-03-02
317103,JAKARTA PUSAT,KEMAYORAN,8272,75,7989,145,63,138,2021-03-02
317308,JAKARTA BARAT,KEMBANGAN,7681,96,7392,96,97,193,2021-03-02
310101,KAB.ADM.KEP.SERIBU,KEP. SERIBU UTARA,296,1,289,4,2,3,2021-03-02
317106,JAKARTA PUSAT,MENTENG,2754,25,2651,55,23,48,2021-03-02
317504,JAKARTA TIMUR,KRAMAT JATI,8164,85,7820,152,107,192,2021-03-02
317508,JAKARTA TIMUR,MAKASAR,7196,69,6949,113,65,134,2021-03-02
317403,JAKARTA SELATAN,MAMPANG PRAPATAN,5010,29,4849,86,46,75,2021-03-02
317501,JAKARTA TIMUR,MATRAMAN,5395,38,5186,115,56,94,2021-03-02
317405,JAKARTA SELATAN,KEBAYORAN LAMA,7817,73,7491,138,115,188,2021-03-02
111111,Luar DKI & Proses Update,Luar DKI & Proses Update,143008,137,141294,1273,304,441,2021-03-02
317203,JAKARTA UTARA,KOJA,7351,72,7066,131,82,154,2021-03-02
317407,JAKARTA SELATAN,KEBAYORAN BARU,5212,53,5017,78,64,117,2021-03-02
317101,JAKARTA PUSAT,GAMBIR,3264,29,3155,49,31,60,2021-03-02
317108,JAKARTA PUSAT,JOHAR BARU,3595,35,3421,93,46,81,2021-03-02
317503,JAKARTA TIMUR,JATINEGARA,7507,54,7241,134,78,132,2021-03-02
317409,JAKARTA SELATAN,JAGAKARSA,9415,70,8989,144,212,282,2021-03-02
317302,JAKARTA BARAT,GROGOL PETAMBURAN,6789,95,6510,130,54,149,2021-03-02
317507,JAKARTA TIMUR,DUREN SAWIT,11734,119,11258,232,125,244,2021-03-02
317408,JAKARTA SELATAN,PANCORAN,5164,53,4933,77,101,154,2021-03-02
317509,JAKARTA TIMUR,CIRACAS,7578,67,7306,124,81,148,2021-03-02
317510,JAKARTA TIMUR,CIPAYUNG,8446,75,8158,91,122,197,2021-03-02
317204,JAKARTA UTARA,CILINCING,6743,77,6496,119,51,128,2021-03-02
317406,JAKARTA SELATAN,CILANDAK,6531,33,6256,100,142,175,2021-03-02
317301,JAKARTA BARAT,CENGKARENG,10947,119,10517,222,89,208,2021-03-02
317205,JAKARTA UTARA,PADEMANGAN,3991,43,3821,68,59,102,2021-03-02
317506,JAKARTA TIMUR,CAKUNG,10105,86,9770,175,74,160,2021-03-02
317307,JAKARTA BARAT,PALMERAH,6646,52,6384,144,66,118,2021-03-02
317306,JAKARTA BARAT,KALI DERES,6387,96,6105,117,69,165,2021-03-02
317105,JAKARTA PUSAT,CEMPAKA PUTIH,4176,39,4004,62,71,110,2021-03-02
317404,JAKARTA SELATAN,PASAR MINGGU,9381,81,8929,160,211,292,2021-03-02
317505,JAKARTA TIMUR,PASAR REBO,6586,74,6327,113,72,146,2021-03-02
317401,JAKARTA SELATAN,TEBET,6431,58,6136,122,115,173,2021-03-02
317202,JAKARTA UTARA,TANJUNG PRIOK,10483,114,10072,174,123,237,2021-03-02
317107,JAKARTA PUSAT,TANAH ABANG,5065,53,4880,95,37,90,2021-03-02
317304,JAKARTA BARAT,TAMBORA,4932,88,4685,97,62,150,2021-03-02
317303,JAKARTA BARAT,TAMAN SARI,3222,40,3092,51,39,79,2021-03-02
317201,JAKARTA UTARA,PENJARINGAN,6327,126,6053,86,62,188,2021-03-02
317104,JAKARTA PUSAT,SENEN,3769,34,3635,76,24,58,2021-03-02
317102,JAKARTA PUSAT,SAWAH BESAR,3403,42,3256,62,43,85,2021-03-02
317502,JAKARTA TIMUR,PULO GADUNG,8022,95,7692,140,95,190,2021-03-02
317410,JAKARTA SELATAN,PESANGGRAHAN,6214,46,5938,92,138,184,2021-03-02
317402,JAKARTA SELATAN,SETIA BUDI,4495,39,4287,77,92,131,2021-03-02
317305,JAKARTA BARAT,KEBON JERUK,8978,122,8627,161,68,190,2021-03-03
317405,JAKARTA SELATAN,KEBAYORAN LAMA,7864,77,7515,141,131,208,2021-03-03
317407,JAKARTA SELATAN,KEBAYORAN BARU,5226,53,5026,78,69,122,2021-03-03
317306,JAKARTA BARAT,KALI DERES,6430,71,6184,117,58,129,2021-03-03
317108,JAKARTA PUSAT,JOHAR BARU,3607,25,3436,93,53,78,2021-03-03
317503,JAKARTA TIMUR,JATINEGARA,7546,59,7256,134,97,156,2021-03-03
317409,JAKARTA SELATAN,JAGAKARSA,9483,78,9015,147,243,321,2021-03-03
317302,JAKARTA BARAT,GROGOL PETAMBURAN,6847,97,6556,130,64,161,2021-03-03
317507,JAKARTA TIMUR,DUREN SAWIT,11829,120,11295,233,181,301,2021-03-03
317509,JAKARTA TIMUR,CIRACAS,7627,72,7327,125,103,175,2021-03-03
317510,JAKARTA TIMUR,CIPAYUNG,8511,82,8177,93,159,241,2021-03-03
317204,JAKARTA UTARA,CILINCING,6765,78,6512,120,55,133,2021-03-03
317206,JAKARTA UTARA,KELAPA GADING,4827,45,4676,75,31,76,2021-03-03
317301,JAKARTA BARAT,CENGKARENG,11009,114,10613,223,59,173,2021-03-03
317105,JAKARTA PUSAT,CEMPAKA PUTIH,4191,39,4028,62,62,101,2021-03-03
317506,JAKARTA TIMUR,CAKUNG,10148,71,9807,176,94,165,2021-03-03
317101,JAKARTA PUSAT,GAMBIR,3278,24,3170,49,35,59,2021-03-03
317406,JAKARTA SELATAN,CILANDAK,6575,38,6332,100,105,143,2021-03-03
317103,JAKARTA PUSAT,KEMAYORAN,8323,72,8016,145,90,162,2021-03-03
310102,KAB.ADM.KEP.SERIBU,KEP. SERIBU SELATAN,230,0,227,2,1,1,2021-03-03
111111,Luar DKI & Proses Update,Luar DKI & Proses Update,143008,137,141294,1273,304,441,2021-03-03
317401,JAKARTA SELATAN,TEBET,6456,54,6156,124,122,176,2021-03-03
317202,JAKARTA UTARA,TANJUNG PRIOK,10555,111,10167,175,102,213,2021-03-03
317107,JAKARTA PUSAT,TANAH ABANG,5098,53,4891,96,58,111,2021-03-03
317304,JAKARTA BARAT,TAMBORA,4980,105,4729,99,47,152,2021-03-03
317303,JAKARTA BARAT,TAMAN SARI,3254,48,3116,51,39,87,2021-03-03
317402,JAKARTA SELATAN,SETIA BUDI,4509,35,4303,77,94,129,2021-03-03
317104,JAKARTA PUSAT,SENEN,3797,33,3645,77,42,75,2021-03-03
317102,JAKARTA PUSAT,SAWAH BESAR,3419,40,3275,63,41,81,2021-03-03
317502,JAKARTA TIMUR,PULO GADUNG,8093,101,7729,141,122,223,2021-03-03
317308,JAKARTA BARAT,KEMBANGAN,7735,93,7448,97,97,190,2021-03-03
317201,JAKARTA UTARA,PENJARINGAN,6385,152,6097,89,47,199,2021-03-03
317410,JAKARTA SELATAN,PESANGGRAHAN,6273,49,6010,93,121,170,2021-03-03
317404,JAKARTA SELATAN,PASAR MINGGU,9448,91,9050,162,145,236,2021-03-03
310101,KAB.ADM.KEP.SERIBU,KEP. SERIBU UTARA,297,1,290,4,2,3,2021-03-03
317203,JAKARTA UTARA,KOJA,7381,68,7095,131,87,155,2021-03-03
317505,JAKARTA TIMUR,PASAR REBO,6641,87,6348,114,92,179,2021-03-03
317508,JAKARTA TIMUR,MAKASAR,7280,80,6966,115,119,199,2021-03-03
317403,JAKARTA SELATAN,MAMPANG PRAPATAN,5017,28,4863,87,39,67,2021-03-03
317504,JAKARTA TIMUR,KRAMAT JATI,8212,85,7856,153,118,203,2021-03-03
317106,JAKARTA PUSAT,MENTENG,2770,26,2664,56,24,50,2021-03-03
317205,JAKARTA UTARA,PADEMANGAN,4031,39,3848,69,75,114,2021-03-03
317307,JAKARTA BARAT,PALMERAH,6690,67,6408,144,71,138,2021-03-03
317408,JAKARTA SELATAN,PANCORAN,5203,54,4949,78,122,176,2021-03-03
317501,JAKARTA TIMUR,MATRAMAN,5450,35,5204,115,96,131,2021-03-03
317406,JAKARTA SELATAN,CILANDAK,6618,42,6358,100,118,160,2021-03-04
317301,JAKARTA BARAT,CENGKARENG,11060,109,10661,224,66,175,2021-03-04
317506,JAKARTA TIMUR,CAKUNG,10191,64,9858,179,90,154,2021-03-04
111111,Luar DKI & Proses Update,Luar DKI & Proses Update,143008,137,141294,1273,304,441,2021-03-04
317204,JAKARTA UTARA,CILINCING,6807,62,6538,122,85,147,2021-03-04
317105,JAKARTA PUSAT,CEMPAKA PUTIH,4227,43,4072,65,47,90,2021-03-04
317508,JAKARTA TIMUR,MAKASAR,7299,73,6988,115,123,196,2021-03-04
317407,JAKARTA SELATAN,KEBAYORAN BARU,5234,38,5038,78,80,118,2021-03-04
317405,JAKARTA SELATAN,KEBAYORAN LAMA,7871,67,7543,143,118,185,2021-03-04
317305,JAKARTA BARAT,KEBON JERUK,9016,103,8683,161,69,172,2021-03-04
317206,JAKARTA UTARA,KELAPA GADING,4842,46,4681,75,40,86,2021-03-04
317103,JAKARTA PUSAT,KEMAYORAN,8343,56,8076,145,66,122,2021-03-04
317308,JAKARTA BARAT,KEMBANGAN,7755,93,7489,99,74,167,2021-03-04
310102,KAB.ADM.KEP.SERIBU,KEP. SERIBU SELATAN,230,0,227,3,0,0,2021-03-04
310101,KAB.ADM.KEP.SERIBU,KEP. SERIBU UTARA,297,1,290,4,2,3,2021-03-04
317203,JAKARTA UTARA,KOJA,7409,53,7130,131,95,148,2021-03-04
317504,JAKARTA TIMUR,KRAMAT JATI,8259,72,7879,154,154,226,2021-03-04
317202,JAKARTA UTARA,TANJUNG PRIOK,10560,82,10204,175,99,181,2021-03-04
317403,JAKARTA SELATAN,MAMPANG PRAPATAN,5018,21,4872,87,38,59,2021-03-04
317306,JAKARTA BARAT,KALI DERES,6482,86,6218,118,60,146,2021-03-04
317501,JAKARTA TIMUR,MATRAMAN,5459,31,5218,115,95,126,2021-03-04
317205,JAKARTA UTARA,PADEMANGAN,4029,37,3851,71,70,107,2021-03-04
317307,JAKARTA BARAT,PALMERAH,6692,62,6429,144,57,119,2021-03-04
317408,JAKARTA SELATAN,PANCORAN,5202,39,4968,79,116,155,2021-03-04
317404,JAKARTA SELATAN,PASAR MINGGU,9519,72,9085,164,198,270,2021-03-04
317505,JAKARTA TIMUR,PASAR REBO,6690,81,6373,117,119,200,2021-03-04
317201,JAKARTA UTARA,PENJARINGAN,6413,143,6131,89,50,193,2021-03-04
317410,JAKARTA SELATAN,PESANGGRAHAN,6324,39,6033,94,158,197,2021-03-04
317502,JAKARTA TIMUR,PULO GADUNG,8115,88,7762,141,124,212,2021-03-04
317102,JAKARTA PUSAT,SAWAH BESAR,3432,43,3303,65,21,64,2021-03-04
317104,JAKARTA PUSAT,SENEN,3810,29,3658,77,46,75,2021-03-04
317402,JAKARTA SELATAN,SETIA BUDI,4538,30,4332,77,99,129,2021-03-04
317303,JAKARTA BARAT,TAMAN SARI,3270,54,3128,51,37,91,2021-03-04
317106,JAKARTA PUSAT,MENTENG,2780,21,2675,56,28,49,2021-03-04
317108,JAKARTA PUSAT,JOHAR BARU,3621,23,3449,93,56,79,2021-03-04
317503,JAKARTA TIMUR,JATINEGARA,7572,45,7292,134,101,146,2021-03-04
317409,JAKARTA SELATAN,JAGAKARSA,9523,65,9179,149,130,195,2021-03-04
317304,JAKARTA BARAT,TAMBORA,5002,99,4745,102,56,155,2021-03-04
317401,JAKARTA SELATAN,TEBET,6475,39,6182,125,129,168,2021-03-04
317510,JAKARTA TIMUR,CIPAYUNG,8524,77,8193,94,160,237,2021-03-04
317107,JAKARTA PUSAT,TANAH ABANG,5118,59,4905,96,58,117,2021-03-04
317507,JAKARTA TIMUR,DUREN SAWIT,11867,103,11358,236,170,273,2021-03-04
317101,JAKARTA PUSAT,GAMBIR,3283,23,3187,49,24,47,2021-03-04
317302,JAKARTA BARAT,GROGOL PETAMBURAN,6869,76,6574,132,87,163,2021-03-04
317509,JAKARTA TIMUR,CIRACAS,7653,70,7342,127,114,184,2021-03-04
317204,JAKARTA UTARA,CILINCING,6829,58,6564,124,83,141,2021-03-05
317510,JAKARTA TIMUR,CIPAYUNG,8606,79,8252,95,180,259,2021-03-05
317509,JAKARTA TIMUR,CIRACAS,7697,71,7401,130,95,166,2021-03-05
317507,JAKARTA TIMUR,DUREN SAWIT,11948,105,11424,239,180,285,2021-03-05
317101,JAKARTA PUSAT,GAMBIR,3295,21,3193,49,32,53,2021-03-05
317302,JAKARTA BARAT,GROGOL PETAMBURAN,6906,81,6586,136,103,184,2021-03-05
317409,JAKARTA SELATAN,JAGAKARSA,9586,83,9182,152,169,252,2021-03-05
317503,JAKARTA TIMUR,JATINEGARA,7599,36,7340,134,89,125,2021-03-05
317108,JAKARTA PUSAT,JOHAR BARU,3634,15,3459,93,67,82,2021-03-05
317407,JAKARTA SELATAN,KEBAYORAN BARU,5248,30,5071,80,67,97,2021-03-05
317405,JAKARTA SELATAN,KEBAYORAN LAMA,7915,59,7582,145,129,188,2021-03-05
317305,JAKARTA BARAT,KEBON JERUK,9049,83,8708,162,96,179,2021-03-05
317103,JAKARTA PUSAT,KEMAYORAN,8380,63,8094,145,78,141,2021-03-05
317308,JAKARTA BARAT,KEMBANGAN,7769,72,7510,101,86,158,2021-03-05
310102,KAB.ADM.KEP.SERIBU,KEP. SERIBU SELATAN,230,0,227,3,0,0,2021-03-05
310101,KAB.ADM.KEP.SERIBU,KEP. SERIBU UTARA,300,4,290,4,2,6,2021-03-05
317203,JAKARTA UTARA,KOJA,7431,57,7168,131,75,132,2021-03-05
317105,JAKARTA PUSAT,CEMPAKA PUTIH,4243,44,4079,65,55,99,2021-03-05
317506,JAKARTA TIMUR,CAKUNG,10239,62,9879,180,118,180,2021-03-05
317306,JAKARTA BARAT,KALI DERES,6512,76,6241,120,75,151,2021-03-05
317206,JAKARTA UTARA,KELAPA GADING,4856,46,4688,75,47,93,2021-03-05
317504,JAKARTA TIMUR,KRAMAT JATI,8306,69,7951,155,131,200,2021-03-05
111111,Luar DKI & Proses Update,Luar DKI & Proses Update,143008,137,141294,1273,304,441,2021-03-05
317508,JAKARTA TIMUR,MAKASAR,7322,58,7031,116,117,175,2021-03-05
317403,JAKARTA SELATAN,MAMPANG PRAPATAN,5062,23,4890,87,62,85,2021-03-05
317501,JAKARTA TIMUR,MATRAMAN,5487,30,5260,116,81,111,2021-03-05
317106,JAKARTA PUSAT,MENTENG,2790,19,2680,57,34,53,2021-03-05
317205,JAKARTA UTARA,PADEMANGAN,4058,29,3884,71,74,103,2021-03-05
317307,JAKARTA BARAT,PALMERAH,6732,63,6441,144,84,147,2021-03-05
317408,JAKARTA SELATAN,PANCORAN,5233,39,5017,80,97,136,2021-03-05
317404,JAKARTA SELATAN,PASAR MINGGU,9549,79,9138,165,167,246,2021-03-05
317505,JAKARTA TIMUR,PASAR REBO,6741,91,6431,118,101,192,2021-03-05
317201,JAKARTA UTARA,PENJARINGAN,6468,130,6174,89,75,205,2021-03-05
317410,JAKARTA SELATAN,PESANGGRAHAN,6357,42,6073,95,147,189,2021-03-05
317502,JAKARTA TIMUR,PULO GADUNG,8179,96,7800,143,140,236,2021-03-05
317102,JAKARTA PUSAT,SAWAH BESAR,3455,32,3323,65,35,67,2021-03-05
317104,JAKARTA PUSAT,SENEN,3824,34,3662,77,51,85,2021-03-05
317402,JAKARTA SELATAN,SETIA BUDI,4565,40,4355,78,92,132,2021-03-05
317303,JAKARTA BARAT,TAMAN SARI,3292,49,3148,51,44,93,2021-03-05
317304,JAKARTA BARAT,TAMBORA,5042,99,4772,103,68,167,2021-03-05
317107,JAKARTA PUSAT,TANAH ABANG,5131,46,4922,97,66,112,2021-03-05
317202,JAKARTA UTARA,TANJUNG PRIOK,10674,85,10216,178,195,280,2021-03-05
317401,JAKARTA SELATAN,TEBET,6500,42,6272,125,61,103,2021-03-05
317406,JAKARTA SELATAN,CILANDAK,6644,45,6400,102,97,142,2021-03-05
317301,JAKARTA BARAT,CENGKARENG,11123,103,10689,225,106,209,2021-03-05
111111,Luar DKI & Proses Update,Luar DKI & Proses Update,143008,137,141294,1273,304,441,2021-03-06
317401,JAKARTA SELATAN,TEBET,6572,47,6289,125,111,158,2021-03-06
317107,JAKARTA PUSAT,TANAH ABANG,5164,53,4939,99,73,126,2021-03-06
317103,JAKARTA PUSAT,KEMAYORAN,8420,70,8110,145,95,165,2021-03-06
317206,JAKARTA UTARA,KELAPA GADING,4879,50,4705,77,47,97,2021-03-06
317305,JAKARTA BARAT,KEBON JERUK,9077,69,8753,162,93,162,2021-03-06
317405,JAKARTA SELATAN,KEBAYORAN LAMA,7959,63,7643,148,105,168,2021-03-06
317407,JAKARTA SELATAN,KEBAYORAN BARU,5275,33,5112,80,50,83,2021-03-06
317306,JAKARTA BARAT,KALI DERES,6550,74,6283,120,73,147,2021-03-06
317503,JAKARTA TIMUR,JATINEGARA,7657,41,7367,135,114,155,2021-03-06
317409,JAKARTA SELATAN,JAGAKARSA,9641,74,9271,153,143,217,2021-03-06
317308,JAKARTA BARAT,KEMBANGAN,7802,66,7552,102,82,148,2021-03-06
317302,JAKARTA BARAT,GROGOL PETAMBURAN,6939,69,6629,139,102,171,2021-03-06
317507,JAKARTA TIMUR,DUREN SAWIT,12028,110,11465,241,212,322,2021-03-06
317509,JAKARTA TIMUR,CIRACAS,7765,73,7432,130,130,203,2021-03-06
317510,JAKARTA TIMUR,CIPAYUNG,8682,76,8351,95,160,236,2021-03-06
317204,JAKARTA UTARA,CILINCING,6847,46,6603,128,70,116,2021-03-06
317406,JAKARTA SELATAN,CILANDAK,6721,50,6435,103,133,183,2021-03-06
317301,JAKARTA BARAT,CENGKARENG,11177,96,10726,225,130,226,2021-03-06
317105,JAKARTA PUSAT,CEMPAKA PUTIH,4265,39,4112,65,49,88,2021-03-06
317506,JAKARTA TIMUR,CAKUNG,10290,86,9913,180,111,197,2021-03-06
317101,JAKARTA PUSAT,GAMBIR,3303,21,3207,49,26,47,2021-03-06
317202,JAKARTA UTARA,TANJUNG PRIOK,10740,84,10282,179,195,279,2021-03-06
310102,KAB.ADM.KEP.SERIBU,KEP. SERIBU SELATAN,230,0,227,3,0,0,2021-03-06
317203,JAKARTA UTARA,KOJA,7447,50,7202,133,62,112,2021-03-06
317304,JAKARTA BARAT,TAMBORA,5068,87,4817,103,61,148,2021-03-06
317303,JAKARTA BARAT,TAMAN SARI,3310,56,3172,51,31,87,2021-03-06
317402,JAKARTA SELATAN,SETIA BUDI,4585,46,4408,78,53,99,2021-03-06
317104,JAKARTA PUSAT,SENEN,3854,39,3682,77,56,95,2021-03-06
317102,JAKARTA PUSAT,SAWAH BESAR,3463,37,3329,65,32,69,2021-03-06
317502,JAKARTA TIMUR,PULO GADUNG,8229,80,7874,143,132,212,2021-03-06
317410,JAKARTA SELATAN,PESANGGRAHAN,6406,46,6107,96,157,203,2021-03-06
317201,JAKARTA UTARA,PENJARINGAN,6497,121,6224,90,62,183,2021-03-06
317505,JAKARTA TIMUR,PASAR REBO,6769,91,6461,119,98,189,2021-03-06
317404,JAKARTA SELATAN,PASAR MINGGU,9645,83,9192,169,201,284,2021-03-06
317408,JAKARTA SELATAN,PANCORAN,5242,34,5068,80,60,94,2021-03-06
317307,JAKARTA BARAT,PALMERAH,6758,63,6475,148,72,135,2021-03-06
317205,JAKARTA UTARA,PADEMANGAN,4078,29,3913,71,65,94,2021-03-06
317106,JAKARTA PUSAT,MENTENG,2799,16,2692,57,34,50,2021-03-06
317501,JAKARTA TIMUR,MATRAMAN,5503,32,5264,119,88,120,2021-03-06
317403,JAKARTA SELATAN,MAMPANG PRAPATAN,5081,27,4912,88,54,81,2021-03-06
317508,JAKARTA TIMUR,MAKASAR,7383,70,7074,116,123,193,2021-03-06
317504,JAKARTA TIMUR,KRAMAT JATI,8350,70,7993,158,129,199,2021-03-06
310101,KAB.ADM.KEP.SERIBU,KEP. SERIBU UTARA,300,4,291,4,1,5,2021-03-06
317108,JAKARTA PUSAT,JOHAR BARU,3638,13,3497,93,35,48,2021-03-06
111111,Luar DKI & Proses Update,Luar DKI & Proses Update,143008,137,141294,1273,304,441,2021-03-07
317502,JAKARTA TIMUR,PULO GADUNG,8272,74,7923,145,130,204,2021-03-07
317510,JAKARTA TIMUR,CIPAYUNG,8735,60,8413,95,167,227,2021-03-07
317508,JAKARTA TIMUR,MAKASAR,7403,73,7088,116,126,199,2021-03-07
317403,JAKARTA SELATAN,MAMPANG PRAPATAN,5093,26,4921,89,57,83,2021-03-07
317501,JAKARTA TIMUR,MATRAMAN,5544,33,5317,119,75,108,2021-03-07
317106,JAKARTA PUSAT,MENTENG,2805,14,2705,58,28,42,2021-03-07
317205,JAKARTA UTARA,PADEMANGAN,4098,29,3915,72,82,111,2021-03-07
317307,JAKARTA BARAT,PALMERAH,6809,56,6518,149,86,142,2021-03-07
317408,JAKARTA SELATAN,PANCORAN,5332,33,5104,83,112,145,2021-03-07
317404,JAKARTA SELATAN,PASAR MINGGU,9723,71,9262,172,218,289,2021-03-07
317504,JAKARTA TIMUR,KRAMAT JATI,8413,67,8010,158,178,245,2021-03-07
317201,JAKARTA UTARA,PENJARINGAN,6545,128,6245,91,81,209,2021-03-07
317102,JAKARTA PUSAT,SAWAH BESAR,3488,40,3349,65,34,74,2021-03-07
317104,JAKARTA PUSAT,SENEN,3880,40,3708,79,53,93,2021-03-07
317402,JAKARTA SELATAN,SETIA BUDI,4620,55,4421,78,66,121,2021-03-07
317303,JAKARTA BARAT,TAMAN SARI,3338,47,3201,51,39,86,2021-03-07
317304,JAKARTA BARAT,TAMBORA,5099,85,4848,103,63,148,2021-03-07
317107,JAKARTA PUSAT,TANAH ABANG,5184,45,4979,101,59,104,2021-03-07
317202,JAKARTA UTARA,TANJUNG PRIOK,10784,80,10297,179,228,308,2021-03-07
317401,JAKARTA SELATAN,TEBET,6617,47,6314,125,131,178,2021-03-07
317410,JAKARTA SELATAN,PESANGGRAHAN,6451,38,6167,96,150,188,2021-03-07
317203,JAKARTA UTARA,KOJA,7478,53,7213,134,78,131,2021-03-07
317505,JAKARTA TIMUR,PASAR REBO,6831,97,6468,122,144,241,2021-03-07
310102,KAB.ADM.KEP.SERIBU,KEP. SERIBU SELATAN,232,0,227,3,2,2,2021-03-07
310101,KAB.ADM.KEP.SERIBU,KEP. SERIBU UTARA,300,4,292,4,0,4,2021-03-07
317506,JAKARTA TIMUR,CAKUNG,10319,84,9956,182,97,181,2021-03-07
317105,JAKARTA PUSAT,CEMPAKA PUTIH,4291,40,4125,65,61,101,2021-03-07
317301,JAKARTA BARAT,CENGKARENG,11225,82,10777,226,140,222,2021-03-07
317406,JAKARTA SELATAN,CILANDAK,6767,49,6476,103,139,188,2021-03-07
317204,JAKARTA UTARA,CILINCING,6872,51,6604,131,86,137,2021-03-07
317507,JAKARTA TIMUR,DUREN SAWIT,12116,119,11570,243,184,303,2021-03-07
317101,JAKARTA PUSAT,GAMBIR,3327,23,3220,53,31,54,2021-03-07
317302,JAKARTA BARAT,GROGOL PETAMBURAN,6984,68,6687,142,87,155,2021-03-07
317409,JAKARTA SELATAN,JAGAKARSA,9672,70,9342,154,106,176,2021-03-07
317509,JAKARTA TIMUR,CIRACAS,7825,67,7484,130,144,211,2021-03-07
317503,JAKARTA TIMUR,JATINEGARA,7694,48,7388,139,119,167,2021-03-07
317103,JAKARTA PUSAT,KEMAYORAN,8440,70,8154,147,69,139,2021-03-07
317206,JAKARTA UTARA,KELAPA GADING,4915,57,4718,77,63,120,2021-03-07
317305,JAKARTA BARAT,KEBON JERUK,9145,64,8802,163,116,180,2021-03-07
317405,JAKARTA SELATAN,KEBAYORAN LAMA,8032,68,7691,148,125,193,2021-03-07
317308,JAKARTA BARAT,KEMBANGAN,7868,61,7610,103,94,155,2021-03-07
317306,JAKARTA BARAT,KALI DERES,6576,71,6314,121,70,141,2021-03-07
317108,JAKARTA PUSAT,JOHAR BARU,3655,15,3508,93,39,54,2021-03-07
317407,JAKARTA SELATAN,KEBAYORAN BARU,5293,34,5132,81,46,80,2021-03-07
317503,JAKARTA TIMUR,JATINEGARA,7720,41,7426,143,110,151,2021-03-08
317308,JAKARTA BARAT,KEMBANGAN,7882,55,7636,105,86,141,2021-03-08
317103,JAKARTA PUSAT,KEMAYORAN,8472,70,8185,148,69,139,2021-03-08
317206,JAKARTA UTARA,KELAPA GADING,4931,45,4754,77,55,100,2021-03-08
317305,JAKARTA BARAT,KEBON JERUK,9160,67,8834,163,96,163,2021-03-08
317405,JAKARTA SELATAN,KEBAYORAN LAMA,8051,70,7712,149,120,190,2021-03-08
317407,JAKARTA SELATAN,KEBAYORAN BARU,5312,34,5151,82,45,79,2021-03-08
317306,JAKARTA BARAT,KALI DERES,6596,64,6351,122,59,123,2021-03-08
317108,JAKARTA PUSAT,JOHAR BARU,3657,15,3524,93,25,40,2021-03-08
317409,JAKARTA SELATAN,JAGAKARSA,9719,67,9373,157,122,189,2021-03-08
317506,JAKARTA TIMUR,CAKUNG,10333,89,9989,183,72,161,2021-03-08
317101,JAKARTA PUSAT,GAMBIR,3334,23,3226,54,31,54,2021-03-08
317507,JAKARTA TIMUR,DUREN SAWIT,12138,120,11617,245,156,276,2021-03-08
317509,JAKARTA TIMUR,CIRACAS,7866,66,7518,130,152,218,2021-03-08
317510,JAKARTA TIMUR,CIPAYUNG,8755,62,8432,96,165,227,2021-03-08
317204,JAKARTA UTARA,CILINCING,6886,34,6678,132,42,76,2021-03-08
317406,JAKARTA SELATAN,CILANDAK,6788,50,6506,104,128,178,2021-03-08
317301,JAKARTA BARAT,CENGKARENG,11244,82,10820,226,116,198,2021-03-08
317105,JAKARTA PUSAT,CEMPAKA PUTIH,4311,26,4162,66,57,83,2021-03-08
111111,Luar DKI & Proses Update,Luar DKI & Proses Update,143008,137,141294,1273,304,441,2021-03-08
317302,JAKARTA BARAT,GROGOL PETAMBURAN,7010,76,6713,143,78,154,2021-03-08
310101,KAB.ADM.KEP.SERIBU,KEP. SERIBU UTARA,296,0,292,4,0,0,2021-03-08
317203,JAKARTA UTARA,KOJA,7481,43,7268,134,36,79,2021-03-08
310102,KAB.ADM.KEP.SERIBU,KEP. SERIBU SELATAN,232,0,227,3,2,2,2021-03-08
317401,JAKARTA SELATAN,TEBET,6624,40,6340,125,119,159,2021-03-08
317202,JAKARTA UTARA,TANJUNG PRIOK,10810,78,10369,180,183,261,2021-03-08
317107,JAKARTA PUSAT,TANAH ABANG,5194,41,5005,104,44,85,2021-03-08
317304,JAKARTA BARAT,TAMBORA,5105,73,4875,105,52,125,2021-03-08
317303,JAKARTA BARAT,TAMAN SARI,3346,42,3216,51,37,79,2021-03-08
317104,JAKARTA PUSAT,SENEN,3890,41,3726,79,44,85,2021-03-08
317102,JAKARTA PUSAT,SAWAH BESAR,3496,38,3362,66,30,68,2021-03-08
317502,JAKARTA TIMUR,PULO GADUNG,8301,62,7973,148,118,180,2021-03-08
317410,JAKARTA SELATAN,PESANGGRAHAN,6464,38,6222,98,106,144,2021-03-08
317201,JAKARTA UTARA,PENJARINGAN,6573,104,6303,91,75,179,2021-03-08
317402,JAKARTA SELATAN,SETIA BUDI,4632,59,4456,78,39,98,2021-03-08
317404,JAKARTA SELATAN,PASAR MINGGU,9742,72,9291,175,204,276,2021-03-08
317408,JAKARTA SELATAN,PANCORAN,5343,38,5107,83,115,153,2021-03-08
317307,JAKARTA BARAT,PALMERAH,6814,52,6526,150,86,138,2021-03-08
317205,JAKARTA UTARA,PADEMANGAN,4100,22,3955,72,51,73,2021-03-08
317106,JAKARTA PUSAT,MENTENG,2814,15,2720,58,21,36,2021-03-08
317501,JAKARTA TIMUR,MATRAMAN,5552,32,5328,119,73,105,2021-03-08
317403,JAKARTA SELATAN,MAMPANG PRAPATAN,5106,27,4923,91,65,92,2021-03-08
317508,JAKARTA TIMUR,MAKASAR,7413,67,7169,117,60,127,2021-03-08
317504,JAKARTA TIMUR,KRAMAT JATI,8444,68,8086,160,130,198,2021-03-08
317505,JAKARTA TIMUR,PASAR REBO,6909,80,6558,123,148,228,2021-03-08
317101,JAKARTA PUSAT,GAMBIR,3334,22,3234,54,24,46,2021-03-09
317507,JAKARTA TIMUR,DUREN SAWIT,12184,137,11638,248,161,298,2021-03-09
317509,JAKARTA TIMUR,CIRACAS,7880,70,7516,133,161,231,2021-03-09
317510,JAKARTA TIMUR,CIPAYUNG,8778,63,8439,98,178,241,2021-03-09
317506,JAKARTA TIMUR,CAKUNG,10371,111,10001,183,76,187,2021-03-09
317406,JAKARTA SELATAN,CILANDAK,6816,54,6534,107,121,175,2021-03-09
317301,JAKARTA BARAT,CENGKARENG,11275,92,10874,226,83,175,2021-03-09
317105,JAKARTA PUSAT,CEMPAKA PUTIH,4316,29,4173,66,48,77,2021-03-09
317302,JAKARTA BARAT,GROGOL PETAMBURAN,7027,85,6742,144,56,141,2021-03-09
317204,JAKARTA UTARA,CILINCING,6923,59,6681,134,49,108,2021-03-09
317409,JAKARTA SELATAN,JAGAKARSA,9766,81,9376,159,150,231,2021-03-09
317202,JAKARTA UTARA,TANJUNG PRIOK,10825,88,10464,181,92,180,2021-03-09
317108,JAKARTA PUSAT,JOHAR BARU,3658,13,3536,93,16,29,2021-03-09
111111,Luar DKI & Proses Update,Luar DKI & Proses Update,143008,137,141294,1273,304,441,2021-03-09
317107,JAKARTA PUSAT,TANAH ABANG,5197,45,5010,104,38,83,2021-03-09
317304,JAKARTA BARAT,TAMBORA,5120,80,4897,105,38,118,2021-03-09
317303,JAKARTA BARAT,TAMAN SARI,3352,45,3220,52,35,80,2021-03-09
317402,JAKARTA SELATAN,SETIA BUDI,4638,55,4466,78,39,94,2021-03-09
317104,JAKARTA PUSAT,SENEN,3897,46,3730,79,42,88,2021-03-09
317102,JAKARTA PUSAT,SAWAH BESAR,3495,37,3373,66,19,56,2021-03-09
317502,JAKARTA TIMUR,PULO GADUNG,8333,76,7984,149,124,200,2021-03-09
317410,JAKARTA SELATAN,PESANGGRAHAN,6483,50,6241,100,92,142,2021-03-09
317201,JAKARTA UTARA,PENJARINGAN,6594,97,6350,92,55,152,2021-03-09
317505,JAKARTA TIMUR,PASAR REBO,6928,88,6564,123,153,241,2021-03-09
317404,JAKARTA SELATAN,PASAR MINGGU,9767,81,9348,175,163,244,2021-03-09
317408,JAKARTA SELATAN,PANCORAN,5371,40,5109,84,138,178,2021-03-09
317307,JAKARTA BARAT,PALMERAH,6823,62,6551,150,60,122,2021-03-09
317401,JAKARTA SELATAN,TEBET,6642,56,6353,125,108,164,2021-03-09
317205,JAKARTA UTARA,PADEMANGAN,4102,23,3970,73,36,59,2021-03-09
317501,JAKARTA TIMUR,MATRAMAN,5563,39,5335,119,70,109,2021-03-09
317306,JAKARTA BARAT,KALI DERES,6620,65,6385,125,45,110,2021-03-09
317407,JAKARTA SELATAN,KEBAYORAN BARU,5337,40,5160,82,55,95,2021-03-09
317405,JAKARTA SELATAN,KEBAYORAN LAMA,8083,84,7729,149,121,205,2021-03-09
317305,JAKARTA BARAT,KEBON JERUK,9191,86,8871,164,70,156,2021-03-09
317206,JAKARTA UTARA,KELAPA GADING,4961,57,4762,78,64,121,2021-03-09
317106,JAKARTA PUSAT,MENTENG,2819,18,2727,59,15,33,2021-03-09
317103,JAKARTA PUSAT,KEMAYORAN,8487,74,8202,148,63,137,2021-03-09
310102,KAB.ADM.KEP.SERIBU,KEP. SERIBU SELATAN,233,0,227,3,3,3,2021-03-09
310101,KAB.ADM.KEP.SERIBU,KEP. SERIBU UTARA,296,0,292,4,0,0,2021-03-09
317203,JAKARTA UTARA,KOJA,7516,50,7272,135,59,109,2021-03-09
317504,JAKARTA TIMUR,KRAMAT JATI,8475,74,8103,161,137,211,2021-03-09
317508,JAKARTA TIMUR,MAKASAR,7488,77,7173,120,118,195,2021-03-09
317403,JAKARTA SELATAN,MAMPANG PRAPATAN,5138,28,4929,91,90,118,2021-03-09
317308,JAKARTA BARAT,KEMBANGAN,7896,65,7651,107,73,138,2021-03-09
317503,JAKARTA TIMUR,JATINEGARA,7733,49,7431,145,108,157,2021-03-09
111111,Luar DKI & Proses Update,Luar DKI & Proses Update,143008,137,141294,1273,304,441,2021-03-10
317101,JAKARTA PUSAT,GAMBIR,3347,23,3234,54,36,59,2021-03-10
317505,JAKARTA TIMUR,PASAR REBO,6959,105,6595,124,135,240,2021-03-10
317401,JAKARTA SELATAN,TEBET,6690,61,6360,126,143,204,2021-03-10
317202,JAKARTA UTARA,TANJUNG PRIOK,10916,101,10478,182,155,256,2021-03-10
317107,JAKARTA PUSAT,TANAH ABANG,5223,42,5015,106,60,102,2021-03-10
317304,JAKARTA BARAT,TAMBORA,5148,78,4912,105,53,131,2021-03-10
317303,JAKARTA BARAT,TAMAN SARI,3372,41,3229,52,50,91,2021-03-10
317402,JAKARTA SELATAN,SETIA BUDI,4654,67,4476,78,33,100,2021-03-10
317104,JAKARTA PUSAT,SENEN,3920,41,3737,79,63,104,2021-03-10
317102,JAKARTA PUSAT,SAWAH BESAR,3528,41,3382,66,39,80,2021-03-10
317203,JAKARTA UTARA,KOJA,7558,61,7282,135,80,141,2021-03-10
317502,JAKARTA TIMUR,PULO GADUNG,8381,83,8027,149,122,205,2021-03-10
317201,JAKARTA UTARA,PENJARINGAN,6624,108,6357,92,67,175,2021-03-10
317504,JAKARTA TIMUR,KRAMAT JATI,8492,80,8131,162,119,199,2021-03-10
317404,JAKARTA SELATAN,PASAR MINGGU,9822,89,9354,176,203,292,2021-03-10
317408,JAKARTA SELATAN,PANCORAN,5392,38,5140,84,130,168,2021-03-10
317307,JAKARTA BARAT,PALMERAH,6863,60,6564,152,87,147,2021-03-10
317205,JAKARTA UTARA,PADEMANGAN,4125,27,3979,73,46,73,2021-03-10
317106,JAKARTA PUSAT,MENTENG,2829,16,2731,59,23,39,2021-03-10
317501,JAKARTA TIMUR,MATRAMAN,5638,48,5370,119,101,149,2021-03-10
317410,JAKARTA SELATAN,PESANGGRAHAN,6518,47,6252,100,119,166,2021-03-10
317403,JAKARTA SELATAN,MAMPANG PRAPATAN,5168,32,4969,91,76,108,2021-03-10
310101,KAB.ADM.KEP.SERIBU,KEP. SERIBU UTARA,296,0,292,4,0,0,2021-03-10
317308,JAKARTA BARAT,KEMBANGAN,7946,82,7656,107,101,183,2021-03-10
317506,JAKARTA TIMUR,CAKUNG,10414,120,10036,183,75,195,2021-03-10
317105,JAKARTA PUSAT,CEMPAKA PUTIH,4335,38,4175,66,56,94,2021-03-10
317301,JAKARTA BARAT,CENGKARENG,11299,89,10910,227,73,162,2021-03-10
317406,JAKARTA SELATAN,CILANDAK,6863,51,6555,107,150,201,2021-03-10
317204,JAKARTA UTARA,CILINCING,6953,81,6689,134,49,130,2021-03-10
317510,JAKARTA TIMUR,CIPAYUNG,8828,73,8501,99,155,228,2021-03-10
317509,JAKARTA TIMUR,CIRACAS,7892,74,7546,133,139,213,2021-03-10
317507,JAKARTA TIMUR,DUREN SAWIT,12270,154,11691,249,176,330,2021-03-10
310102,KAB.ADM.KEP.SERIBU,KEP. SERIBU SELATAN,233,0,227,3,3,3,2021-03-10
317302,JAKARTA BARAT,GROGOL PETAMBURAN,7066,90,6774,144,58,148,2021-03-10
317503,JAKARTA TIMUR,JATINEGARA,7784,62,7448,146,128,190,2021-03-10
317108,JAKARTA PUSAT,JOHAR BARU,3679,14,3538,93,34,48,2021-03-10
317306,JAKARTA BARAT,KALI DERES,6649,68,6397,126,58,126,2021-03-10
317407,JAKARTA SELATAN,KEBAYORAN BARU,5365,42,5173,82,68,110,2021-03-10
317405,JAKARTA SELATAN,KEBAYORAN LAMA,8105,82,7768,149,106,188,2021-03-10
317305,JAKARTA BARAT,KEBON JERUK,9212,96,8872,164,80,176,2021-03-10
317206,JAKARTA UTARA,KELAPA GADING,4980,61,4769,79,71,132,2021-03-10
317103,JAKARTA PUSAT,KEMAYORAN,8584,89,8223,149,123,212,2021-03-10
317409,JAKARTA SELATAN,JAGAKARSA,9864,77,9437,162,188,265,2021-03-10
317508,JAKARTA TIMUR,MAKASAR,7540,93,7185,120,142,235,2021-03-10
317403,JAKARTA SELATAN,MAMPANG PRAPATAN,5198,41,4982,91,84,125,2021-03-11
111111,Luar DKI & Proses Update,Luar DKI & Proses Update,143008,137,141294,1273,304,441,2021-03-11
310101,KAB.ADM.KEP.SERIBU,KEP. SERIBU UTARA,296,0,292,4,0,0,2021-03-11
310102,KAB.ADM.KEP.SERIBU,KEP. SERIBU SELATAN,233,0,227,3,3,3,2021-03-11
317308,JAKARTA BARAT,KEMBANGAN,8027,94,7688,107,138,232,2021-03-11
317103,JAKARTA PUSAT,KEMAYORAN,8637,102,8255,150,130,232,2021-03-11
317206,JAKARTA UTARA,KELAPA GADING,5017,71,4773,80,93,164,2021-03-11
317305,JAKARTA BARAT,KEBON JERUK,9297,108,8907,164,118,226,2021-03-11
317405,JAKARTA SELATAN,KEBAYORAN LAMA,8160,90,7800,151,119,209,2021-03-11
317407,JAKARTA SELATAN,KEBAYORAN BARU,5397,48,5185,82,82,130,2021-03-11
317306,JAKARTA BARAT,KALI DERES,6670,65,6412,129,64,129,2021-03-11
317108,JAKARTA PUSAT,JOHAR BARU,3709,30,3543,94,42,72,2021-03-11
317508,JAKARTA TIMUR,MAKASAR,7567,106,7192,120,149,255,2021-03-11
317503,JAKARTA TIMUR,JATINEGARA,7827,74,7483,147,123,197,2021-03-11
317302,JAKARTA BARAT,GROGOL PETAMBURAN,7119,116,6779,144,80,196,2021-03-11
317101,JAKARTA PUSAT,GAMBIR,3358,27,3239,54,38,65,2021-03-11
317507,JAKARTA TIMUR,DUREN SAWIT,12346,166,11756,250,174,340,2021-03-11
317509,JAKARTA TIMUR,CIRACAS,7993,95,7601,135,162,257,2021-03-11
317510,JAKARTA TIMUR,CIPAYUNG,8907,80,8557,99,171,251,2021-03-11
317204,JAKARTA UTARA,CILINCING,6990,86,6699,134,71,157,2021-03-11
317406,JAKARTA SELATAN,CILANDAK,6891,51,6614,107,119,170,2021-03-11
317301,JAKARTA BARAT,CENGKARENG,11356,96,10925,229,106,202,2021-03-11
317105,JAKARTA PUSAT,CEMPAKA PUTIH,4370,47,4191,66,66,113,2021-03-11
317506,JAKARTA TIMUR,CAKUNG,10472,129,10072,183,88,217,2021-03-11
317409,JAKARTA SELATAN,JAGAKARSA,9908,87,9471,164,186,273,2021-03-11
317203,JAKARTA UTARA,KOJA,7597,77,7293,135,92,169,2021-03-11
317504,JAKARTA TIMUR,KRAMAT JATI,8608,95,8167,163,183,278,2021-03-11
317402,JAKARTA SELATAN,SETIA BUDI,4675,75,4487,78,35,110,2021-03-11
317401,JAKARTA SELATAN,TEBET,6734,60,6430,127,117,177,2021-03-11
317202,JAKARTA UTARA,TANJUNG PRIOK,10991,119,10493,182,197,316,2021-03-11
317107,JAKARTA PUSAT,TANAH ABANG,5238,48,5040,106,44,92,2021-03-11
317304,JAKARTA BARAT,TAMBORA,5180,97,4925,106,52,149,2021-03-11
317303,JAKARTA BARAT,TAMAN SARI,3390,42,3240,52,56,98,2021-03-11
317104,JAKARTA PUSAT,SENEN,3939,44,3756,80,59,103,2021-03-11
317102,JAKARTA PUSAT,SAWAH BESAR,3537,45,3385,66,41,86,2021-03-11
317410,JAKARTA SELATAN,PESANGGRAHAN,6562,48,6299,100,115,163,2021-03-11
317502,JAKARTA TIMUR,PULO GADUNG,8425,87,8045,151,142,229,2021-03-11
317505,JAKARTA TIMUR,PASAR REBO,6981,106,6603,125,147,253,2021-03-11
317404,JAKARTA SELATAN,PASAR MINGGU,9874,83,9452,176,163,246,2021-03-11
317408,JAKARTA SELATAN,PANCORAN,5419,47,5145,84,143,190,2021-03-11
317307,JAKARTA BARAT,PALMERAH,6899,64,6591,152,92,156,2021-03-11
317205,JAKARTA UTARA,PADEMANGAN,4142,26,3983,74,59,85,2021-03-11
317106,JAKARTA PUSAT,MENTENG,2838,20,2739,59,20,40,2021-03-11
317501,JAKARTA TIMUR,MATRAMAN,5638,53,5359,119,107,160,2021-03-11
317201,JAKARTA UTARA,PENJARINGAN,6659,117,6370,94,78,195,2021-03-11
317202,JAKARTA UTARA,TANJUNG PRIOK,11000,100,10594,182,124,224,2021-03-12
317304,JAKARTA BARAT,TAMBORA,5193,86,4954,106,47,133,2021-03-12
317107,JAKARTA PUSAT,TANAH ABANG,5243,40,5060,106,37,77,2021-03-12
317401,JAKARTA SELATAN,TEBET,6748,60,6445,127,116,176,2021-03-12
317410,JAKARTA SELATAN,PESANGGRAHAN,6593,45,6346,101,101,146,2021-03-12
317504,JAKARTA TIMUR,KRAMAT JATI,8618,81,8193,163,181,262,2021-03-12
317203,JAKARTA UTARA,KOJA,7599,66,7315,135,83,149,2021-03-12
317303,JAKARTA BARAT,TAMAN SARI,3408,37,3271,52,48,85,2021-03-12
317508,JAKARTA TIMUR,MAKASAR,7589,91,7250,121,127,218,2021-03-12
317402,JAKARTA SELATAN,SETIA BUDI,4699,60,4511,78,50,110,2021-03-12
317205,JAKARTA UTARA,PADEMANGAN,4147,20,4020,74,33,53,2021-03-12
317102,JAKARTA PUSAT,SAWAH BESAR,3561,37,3408,66,50,87,2021-03-12
317502,JAKARTA TIMUR,PULO GADUNG,8456,81,8110,151,114,195,2021-03-12
317403,JAKARTA SELATAN,MAMPANG PRAPATAN,5213,35,5004,91,83,118,2021-03-12
317201,JAKARTA UTARA,PENJARINGAN,6671,88,6433,96,54,142,2021-03-12
317505,JAKARTA TIMUR,PASAR REBO,7029,98,6633,125,173,271,2021-03-12
317404,JAKARTA SELATAN,PASAR MINGGU,9922,80,9526,176,140,220,2021-03-12
317408,JAKARTA SELATAN,PANCORAN,5466,47,5217,86,116,163,2021-03-12
317307,JAKARTA BARAT,PALMERAH,6913,59,6642,153,59,118,2021-03-12
310101,KAB.ADM.KEP.SERIBU,KEP. SERIBU UTARA,296,0,292,4,0,0,2021-03-12
317104,JAKARTA PUSAT,SENEN,3948,40,3780,80,48,88,2021-03-12
310102,KAB.ADM.KEP.SERIBU,KEP. SERIBU SELATAN,238,0,229,3,6,6,2021-03-12
317108,JAKARTA PUSAT,JOHAR BARU,3736,36,3556,95,49,85,2021-03-12
317308,JAKARTA BARAT,KEMBANGAN,8040,96,7741,107,96,192,2021-03-12
317506,JAKARTA TIMUR,CAKUNG,10503,101,10115,183,104,205,2021-03-12
317105,JAKARTA PUSAT,CEMPAKA PUTIH,4386,44,4219,66,57,101,2021-03-12
317301,JAKARTA BARAT,CENGKARENG,11385,84,10985,229,87,171,2021-03-12
317406,JAKARTA SELATAN,CILANDAK,6935,47,6662,107,119,166,2021-03-12
317204,JAKARTA UTARA,CILINCING,6994,78,6714,136,66,144,2021-03-12
317510,JAKARTA TIMUR,CIPAYUNG,8927,84,8569,100,174,258,2021-03-12
317509,JAKARTA TIMUR,CIRACAS,8020,87,7626,135,172,259,2021-03-12
317507,JAKARTA TIMUR,DUREN SAWIT,12394,140,11831,251,172,312,2021-03-12
317101,JAKARTA PUSAT,GAMBIR,3369,26,3259,55,29,55,2021-03-12
317302,JAKARTA BARAT,GROGOL PETAMBURAN,7151,112,6811,144,84,196,2021-03-12
317409,JAKARTA SELATAN,JAGAKARSA,9948,93,9487,166,202,295,2021-03-12
317503,JAKARTA TIMUR,JATINEGARA,7861,63,7537,148,113,176,2021-03-12
317106,JAKARTA PUSAT,MENTENG,2841,21,2745,59,16,37,2021-03-12
317306,JAKARTA BARAT,KALI DERES,6685,55,6443,129,58,113,2021-03-12
317407,JAKARTA SELATAN,KEBAYORAN BARU,5402,43,5199,82,78,121,2021-03-12
317405,JAKARTA SELATAN,KEBAYORAN LAMA,8179,78,7873,152,76,154,2021-03-12
317305,JAKARTA BARAT,KEBON JERUK,9314,110,8963,165,76,186,2021-03-12
317206,JAKARTA UTARA,KELAPA GADING,5020,54,4806,80,80,134,2021-03-12
317103,JAKARTA PUSAT,KEMAYORAN,8670,102,8273,153,142,244,2021-03-12
111111,Luar DKI & Proses Update,Luar DKI & Proses Update,143008,137,141294,1273,304,441,2021-03-12
317501,JAKARTA TIMUR,MATRAMAN,5670,46,5404,119,101,147,2021-03-12
317507,JAKARTA TIMUR,DUREN SAWIT,12424,124,11891,254,155,279,2021-03-13
317506,JAKARTA TIMUR,CAKUNG,10531,107,10142,185,97,204,2021-03-13
317510,JAKARTA TIMUR,CIPAYUNG,8983,83,8651,101,148,231,2021-03-13
317403,JAKARTA SELATAN,MAMPANG PRAPATAN,5220,35,5042,92,51,86,2021-03-13
317508,JAKARTA TIMUR,MAKASAR,7629,96,7337,121,75,171,2021-03-13
317504,JAKARTA TIMUR,KRAMAT JATI,8646,83,8279,163,121,204,2021-03-13
317203,JAKARTA UTARA,KOJA,7616,63,7368,138,47,110,2021-03-13
310101,KAB.ADM.KEP.SERIBU,KEP. SERIBU UTARA,296,0,292,4,0,0,2021-03-13
310102,KAB.ADM.KEP.SERIBU,KEP. SERIBU SELATAN,238,0,230,3,5,5,2021-03-13
317308,JAKARTA BARAT,KEMBANGAN,8057,87,7775,107,88,175,2021-03-13
317103,JAKARTA PUSAT,KEMAYORAN,8695,98,8316,153,128,226,2021-03-13
317206,JAKARTA UTARA,KELAPA GADING,5049,58,4865,81,45,103,2021-03-13
317305,JAKARTA BARAT,KEBON JERUK,9334,99,8995,166,74,173,2021-03-13
317405,JAKARTA SELATAN,KEBAYORAN LAMA,8213,69,7913,153,78,147,2021-03-13
317407,JAKARTA SELATAN,KEBAYORAN BARU,5421,40,5246,84,51,91,2021-03-13
317306,JAKARTA BARAT,KALI DERES,6721,65,6476,129,51,116,2021-03-13
317108,JAKARTA PUSAT,JOHAR BARU,3744,37,3565,95,47,84,2021-03-13
317503,JAKARTA TIMUR,JATINEGARA,7874,61,7575,148,90,151,2021-03-13
317409,JAKARTA SELATAN,JAGAKARSA,10009,76,9582,167,184,260,2021-03-13
317302,JAKARTA BARAT,GROGOL PETAMBURAN,7176,107,6857,147,65,172,2021-03-13
317101,JAKARTA PUSAT,GAMBIR,3377,24,3271,56,26,50,2021-03-13
317106,JAKARTA PUSAT,MENTENG,2849,20,2754,60,15,35,2021-03-13
317509,JAKARTA TIMUR,CIRACAS,8041,89,7715,137,100,189,2021-03-13
317205,JAKARTA UTARA,PADEMANGAN,4164,26,4026,74,38,64,2021-03-13
317408,JAKARTA SELATAN,PANCORAN,5503,47,5277,87,92,139,2021-03-13
317105,JAKARTA PUSAT,CEMPAKA PUTIH,4400,44,4245,66,45,89,2021-03-13
317301,JAKARTA BARAT,CENGKARENG,11412,78,11038,229,67,145,2021-03-13
317406,JAKARTA SELATAN,CILANDAK,6950,40,6705,107,98,138,2021-03-13
317204,JAKARTA UTARA,CILINCING,7020,79,6761,136,44,123,2021-03-13
111111,Luar DKI & Proses Update,Luar DKI & Proses Update,143008,137,141294,1273,304,441,2021-03-13
317401,JAKARTA SELATAN,TEBET,6788,62,6490,129,107,169,2021-03-13
317202,JAKARTA UTARA,TANJUNG PRIOK,11081,122,10628,183,148,270,2021-03-13
317107,JAKARTA PUSAT,TANAH ABANG,5249,32,5077,106,34,66,2021-03-13
317307,JAKARTA BARAT,PALMERAH,6926,66,6654,153,53,119,2021-03-13
317304,JAKARTA BARAT,TAMBORA,5204,78,4981,108,37,115,2021-03-13
317402,JAKARTA SELATAN,SETIA BUDI,4722,62,4545,78,37,99,2021-03-13
317104,JAKARTA PUSAT,SENEN,3962,32,3799,80,51,83,2021-03-13
317102,JAKARTA PUSAT,SAWAH BESAR,3568,31,3424,66,47,78,2021-03-13
317502,JAKARTA TIMUR,PULO GADUNG,8484,75,8166,152,91,166,2021-03-13
317410,JAKARTA SELATAN,PESANGGRAHAN,6603,43,6366,102,92,135,2021-03-13
317201,JAKARTA UTARA,PENJARINGAN,6730,92,6501,96,41,133,2021-03-13
317505,JAKARTA TIMUR,PASAR REBO,7066,93,6759,126,88,181,2021-03-13
317404,JAKARTA SELATAN,PASAR MINGGU,9942,68,9564,178,132,200,2021-03-13
317303,JAKARTA BARAT,TAMAN SARI,3417,36,3292,52,37,73,2021-03-13
317501,JAKARTA TIMUR,MATRAMAN,5672,41,5415,119,97,138,2021-03-13
111111,Luar DKI & Proses Update,Luar DKI & Proses Update,143008,137,141294,1273,304,441,2021-03-14
317106,JAKARTA PUSAT,MENTENG,2862,18,2769,60,15,33,2021-03-14
317202,JAKARTA UTARA,TANJUNG PRIOK,11137,107,10658,183,189,296,2021-03-14
317203,JAKARTA UTARA,KOJA,7623,54,7407,138,24,78,2021-03-14
317504,JAKARTA TIMUR,KRAMAT JATI,8683,67,8316,165,135,202,2021-03-14
317508,JAKARTA TIMUR,MAKASAR,7656,84,7393,121,58,142,2021-03-14
317403,JAKARTA SELATAN,MAMPANG PRAPATAN,5249,37,5068,92,52,89,2021-03-14
317501,JAKARTA TIMUR,MATRAMAN,5718,36,5483,120,79,115,2021-03-14
317205,JAKARTA UTARA,PADEMANGAN,4194,28,4032,74,60,88,2021-03-14
317307,JAKARTA BARAT,PALMERAH,6969,61,6692,153,63,124,2021-03-14
317408,JAKARTA SELATAN,PANCORAN,5519,55,5292,88,84,139,2021-03-14
310101,KAB.ADM.KEP.SERIBU,KEP. SERIBU UTARA,296,0,292,4,0,0,2021-03-14
317404,JAKARTA SELATAN,PASAR MINGGU,10014,66,9632,178,138,204,2021-03-14
317201,JAKARTA UTARA,PENJARINGAN,6756,79,6534,96,47,126,2021-03-14
317410,JAKARTA SELATAN,PESANGGRAHAN,6645,38,6411,102,94,132,2021-03-14
317502,JAKARTA TIMUR,PULO GADUNG,8525,73,8215,153,84,157,2021-03-14
317102,JAKARTA PUSAT,SAWAH BESAR,3589,36,3446,66,41,77,2021-03-14
317104,JAKARTA PUSAT,SENEN,3984,28,3830,80,46,74,2021-03-14
317402,JAKARTA SELATAN,SETIA BUDI,4733,55,4561,78,39,94,2021-03-14
317303,JAKARTA BARAT,TAMAN SARI,3435,39,3312,52,32,71,2021-03-14
317304,JAKARTA BARAT,TAMBORA,5233,77,5010,108,38,115,2021-03-14
317505,JAKARTA TIMUR,PASAR REBO,7105,83,6807,126,89,172,2021-03-14
310102,KAB.ADM.KEP.SERIBU,KEP. SERIBU SELATAN,238,0,230,3,5,5,2021-03-14
317308,JAKARTA BARAT,KEMBANGAN,8112,87,7814,107,104,191,2021-03-14
317103,JAKARTA PUSAT,KEMAYORAN,8748,103,8386,154,105,208,2021-03-14
317506,JAKARTA TIMUR,CAKUNG,10585,79,10213,185,108,187,2021-03-14
317105,JAKARTA PUSAT,CEMPAKA PUTIH,4430,47,4260,66,57,104,2021-03-14
317301,JAKARTA BARAT,CENGKARENG,11468,82,11063,231,92,174,2021-03-14
317406,JAKARTA SELATAN,CILANDAK,6984,40,6751,107,86,126,2021-03-14
317204,JAKARTA UTARA,CILINCING,7033,57,6801,136,39,96,2021-03-14
317510,JAKARTA TIMUR,CIPAYUNG,9006,72,8709,101,124,196,2021-03-14
317509,JAKARTA TIMUR,CIRACAS,8076,84,7743,137,112,196,2021-03-14
317507,JAKARTA TIMUR,DUREN SAWIT,12495,98,11981,254,162,260,2021-03-14
317101,JAKARTA PUSAT,GAMBIR,3390,30,3282,56,22,52,2021-03-14
317302,JAKARTA BARAT,GROGOL PETAMBURAN,7212,110,6890,149,63,173,2021-03-14
317409,JAKARTA SELATAN,JAGAKARSA,10120,68,9681,167,204,272,2021-03-14
317503,JAKARTA TIMUR,JATINEGARA,7912,54,7623,149,86,140,2021-03-14
317108,JAKARTA PUSAT,JOHAR BARU,3762,44,3585,95,38,82,2021-03-14
317306,JAKARTA BARAT,KALI DERES,6758,61,6510,129,58,119,2021-03-14
317407,JAKARTA SELATAN,KEBAYORAN BARU,5453,36,5284,84,49,85,2021-03-14
317405,JAKARTA SELATAN,KEBAYORAN LAMA,8241,61,7938,153,89,150,2021-03-14
317305,JAKARTA BARAT,KEBON JERUK,9394,92,9031,166,105,197,2021-03-14
317206,JAKARTA UTARA,KELAPA GADING,5053,41,4891,81,40,81,2021-03-14
317107,JAKARTA PUSAT,TANAH ABANG,5269,34,5112,106,17,51,2021-03-14
317401,JAKARTA SELATAN,TEBET,6823,47,6550,129,97,144,2021-03-14
111111,Luar DKI & Proses Update,Luar DKI & Proses Update,143008,137,141294,1273,304,441,2021-03-15
317307,JAKARTA BARAT,PALMERAH,6977,54,6727,154,42,96,2021-03-15
317506,JAKARTA TIMUR,CAKUNG,10598,67,10260,188,83,150,2021-03-15
317508,JAKARTA TIMUR,MAKASAR,7676,77,7420,122,57,134,2021-03-15
317403,JAKARTA SELATAN,MAMPANG PRAPATAN,5256,30,5097,92,37,67,2021-03-15
317501,JAKARTA TIMUR,MATRAMAN,5722,30,5501,120,71,101,2021-03-15
317106,JAKARTA PUSAT,MENTENG,2864,18,2773,60,13,31,2021-03-15
317401,JAKARTA SELATAN,TEBET,6840,46,6598,129,67,113,2021-03-15
317202,JAKARTA UTARA,TANJUNG PRIOK,11145,95,10770,184,96,191,2021-03-15
317107,JAKARTA PUSAT,TANAH ABANG,5276,34,5120,106,16,50,2021-03-15
317304,JAKARTA BARAT,TAMBORA,5234,66,5033,108,27,93,2021-03-15
317504,JAKARTA TIMUR,KRAMAT JATI,8734,61,8343,165,165,226,2021-03-15
317303,JAKARTA BARAT,TAMAN SARI,3443,37,3328,52,26,63,2021-03-15
317104,JAKARTA PUSAT,SENEN,3988,25,3849,81,33,58,2021-03-15
317102,JAKARTA PUSAT,SAWAH BESAR,3593,27,3460,67,39,66,2021-03-15
317502,JAKARTA TIMUR,PULO GADUNG,8551,66,8233,153,99,165,2021-03-15
317410,JAKARTA SELATAN,PESANGGRAHAN,6656,41,6452,102,61,102,2021-03-15
317201,JAKARTA UTARA,PENJARINGAN,6773,71,6558,96,48,119,2021-03-15
317505,JAKARTA TIMUR,PASAR REBO,7128,69,6827,127,105,174,2021-03-15
317404,JAKARTA SELATAN,PASAR MINGGU,10029,59,9679,178,113,172,2021-03-15
317408,JAKARTA SELATAN,PANCORAN,5556,52,5318,88,98,150,2021-03-15
317402,JAKARTA SELATAN,SETIA BUDI,4741,43,4584,78,36,79,2021-03-15
317203,JAKARTA UTARA,KOJA,7644,54,7431,138,21,75,2021-03-15
310101,KAB.ADM.KEP.SERIBU,KEP. SERIBU UTARA,297,1,292,4,0,1,2021-03-15
310102,KAB.ADM.KEP.SERIBU,KEP. SERIBU SELATAN,238,0,230,3,5,5,2021-03-15
317105,JAKARTA PUSAT,CEMPAKA PUTIH,4452,39,4289,66,58,97,2021-03-15
317301,JAKARTA BARAT,CENGKARENG,11484,83,11105,233,63,146,2021-03-15
317406,JAKARTA SELATAN,CILANDAK,7005,43,6779,107,76,119,2021-03-15
317204,JAKARTA UTARA,CILINCING,7056,47,6825,136,48,95,2021-03-15
317510,JAKARTA TIMUR,CIPAYUNG,9067,69,8782,102,114,183,2021-03-15
317509,JAKARTA TIMUR,CIRACAS,8163,104,7810,138,111,215,2021-03-15
317507,JAKARTA TIMUR,DUREN SAWIT,12519,84,12023,259,153,237,2021-03-15
317101,JAKARTA PUSAT,GAMBIR,3404,27,3297,56,24,51,2021-03-15
317302,JAKARTA BARAT,GROGOL PETAMBURAN,7227,96,6936,149,46,142,2021-03-15
317409,JAKARTA SELATAN,JAGAKARSA,10157,65,9729,168,195,260,2021-03-15
317503,JAKARTA TIMUR,JATINEGARA,7939,51,7644,150,94,145,2021-03-15
317108,JAKARTA PUSAT,JOHAR BARU,3771,41,3600,96,34,75,2021-03-15
317306,JAKARTA BARAT,KALI DERES,6770,58,6540,130,42,100,2021-03-15
317407,JAKARTA SELATAN,KEBAYORAN BARU,5484,31,5319,84,50,81,2021-03-15
317405,JAKARTA SELATAN,KEBAYORAN LAMA,8268,65,7990,153,60,125,2021-03-15
317305,JAKARTA BARAT,KEBON JERUK,9401,81,9102,166,52,133,2021-03-15
317206,JAKARTA UTARA,KELAPA GADING,5072,41,4908,81,42,83,2021-03-15
317103,JAKARTA PUSAT,KEMAYORAN,8762,72,8454,156,80,152,2021-03-15
317308,JAKARTA BARAT,KEMBANGAN,8121,73,7889,107,52,125,2021-03-15
317205,JAKARTA UTARA,PADEMANGAN,4198,18,4062,74,44,62,2021-03-15
111111,Luar DKI & Proses Update,Luar DKI & Proses Update,143008,137,141294,1273,304,441,2021-03-16
317102,JAKARTA PUSAT,SAWAH BESAR,3602,31,3466,67,38,69,2021-03-16
317509,JAKARTA TIMUR,CIRACAS,8319,131,7830,139,219,350,2021-03-16
317508,JAKARTA TIMUR,MAKASAR,7696,79,7435,122,60,139,2021-03-16
317403,JAKARTA SELATAN,MAMPANG PRAPATAN,5264,29,5103,93,39,68,2021-03-16
317501,JAKARTA TIMUR,MATRAMAN,5737,32,5511,120,74,106,2021-03-16
317106,JAKARTA PUSAT,MENTENG,2872,16,2778,60,18,34,2021-03-16
317205,JAKARTA UTARA,PADEMANGAN,4245,28,4104,74,39,67,2021-03-16
317307,JAKARTA BARAT,PALMERAH,6992,52,6745,154,41,93,2021-03-16
317408,JAKARTA SELATAN,PANCORAN,5564,52,5331,88,93,145,2021-03-16
317404,JAKARTA SELATAN,PASAR MINGGU,10057,70,9722,178,87,157,2021-03-16
317504,JAKARTA TIMUR,KRAMAT JATI,8770,68,8439,165,98,166,2021-03-16
317505,JAKARTA TIMUR,PASAR REBO,7161,87,6847,127,100,187,2021-03-16
317410,JAKARTA SELATAN,PESANGGRAHAN,6674,47,6481,103,43,90,2021-03-16
317502,JAKARTA TIMUR,PULO GADUNG,8584,76,8272,154,82,158,2021-03-16
317104,JAKARTA PUSAT,SENEN,4007,38,3851,81,37,75,2021-03-16
317303,JAKARTA BARAT,TAMAN SARI,3457,46,3344,52,15,61,2021-03-16
317304,JAKARTA BARAT,TAMBORA,5251,72,5044,108,27,99,2021-03-16
317107,JAKARTA PUSAT,TANAH ABANG,5287,36,5126,106,19,55,2021-03-16
317202,JAKARTA UTARA,TANJUNG PRIOK,11218,100,10835,186,97,197,2021-03-16
317401,JAKARTA SELATAN,TEBET,6863,54,6607,129,73,127,2021-03-16
317201,JAKARTA UTARA,PENJARINGAN,6812,79,6586,97,50,129,2021-03-16
317203,JAKARTA UTARA,KOJA,7687,53,7461,138,35,88,2021-03-16
317402,JAKARTA SELATAN,SETIA BUDI,4752,45,4591,79,37,82,2021-03-16
310102,KAB.ADM.KEP.SERIBU,KEP. SERIBU SELATAN,238,0,235,3,0,0,2021-03-16
310101,KAB.ADM.KEP.SERIBU,KEP. SERIBU UTARA,299,1,293,4,1,2,2021-03-16
317506,JAKARTA TIMUR,CAKUNG,10629,77,10276,188,88,165,2021-03-16
317105,JAKARTA PUSAT,CEMPAKA PUTIH,4470,40,4302,66,62,102,2021-03-16
317301,JAKARTA BARAT,CENGKARENG,11525,94,11144,233,54,148,2021-03-16
317204,JAKARTA UTARA,CILINCING,7071,51,6854,137,29,80,2021-03-16
317510,JAKARTA TIMUR,CIPAYUNG,9098,75,8796,103,124,199,2021-03-16
317507,JAKARTA TIMUR,DUREN SAWIT,12544,93,12066,259,126,219,2021-03-16
317101,JAKARTA PUSAT,GAMBIR,3414,31,3298,56,29,60,2021-03-16
317302,JAKARTA BARAT,GROGOL PETAMBURAN,7260,106,6981,149,24,130,2021-03-16
317406,JAKARTA SELATAN,CILANDAK,7034,51,6821,107,55,106,2021-03-16
317503,JAKARTA TIMUR,JATINEGARA,7949,44,7680,150,75,119,2021-03-16
317108,JAKARTA PUSAT,JOHAR BARU,3784,48,3607,96,33,81,2021-03-16
317306,JAKARTA BARAT,KALI DERES,6784,66,6556,130,32,98,2021-03-16
317407,JAKARTA SELATAN,KEBAYORAN BARU,5500,30,5328,86,56,86,2021-03-16
317405,JAKARTA SELATAN,KEBAYORAN LAMA,8297,72,8003,154,68,140,2021-03-16
317305,JAKARTA BARAT,KEBON JERUK,9452,95,9137,167,53,148,2021-03-16
317206,JAKARTA UTARA,KELAPA GADING,5099,49,4930,82,38,87,2021-03-16
317103,JAKARTA PUSAT,KEMAYORAN,8803,98,8463,156,86,184,2021-03-16
317409,JAKARTA SELATAN,JAGAKARSA,10195,80,9749,168,198,278,2021-03-16
317308,JAKARTA BARAT,KEMBANGAN,8140,75,7908,107,50,125,2021-03-16
317206,JAKARTA UTARA,KELAPA GADING,5132,49,4944,82,57,106,2021-03-17
317103,JAKARTA PUSAT,KEMAYORAN,8844,88,8523,158,75,163,2021-03-17
317308,JAKARTA BARAT,KEMBANGAN,8180,83,7923,108,66,149,2021-03-17
310102,KAB.ADM.KEP.SERIBU,KEP. SERIBU SELATAN,238,0,235,3,0,0,2021-03-17
310101,KAB.ADM.KEP.SERIBU,KEP. SERIBU UTARA,299,1,293,4,1,2,2021-03-17
317203,JAKARTA UTARA,KOJA,7725,51,7485,138,51,102,2021-03-17
317501,JAKARTA TIMUR,MATRAMAN,5783,34,5550,121,78,112,2021-03-17
317508,JAKARTA TIMUR,MAKASAR,7727,78,7465,123,61,139,2021-03-17
317403,JAKARTA SELATAN,MAMPANG PRAPATAN,5275,24,5121,93,37,61,2021-03-17
317106,JAKARTA PUSAT,MENTENG,2888,23,2785,61,19,42,2021-03-17
317205,JAKARTA UTARA,PADEMANGAN,4299,42,4107,74,76,118,2021-03-17
317305,JAKARTA BARAT,KEBON JERUK,9484,97,9152,168,67,164,2021-03-17
317307,JAKARTA BARAT,PALMERAH,7033,69,6751,154,59,128,2021-03-17
317504,JAKARTA TIMUR,KRAMAT JATI,8821,74,8463,165,119,193,2021-03-17
317405,JAKARTA SELATAN,KEBAYORAN LAMA,8324,77,8044,155,48,125,2021-03-17
317510,JAKARTA TIMUR,CIPAYUNG,9148,68,8819,103,158,226,2021-03-17
317306,JAKARTA BARAT,KALI DERES,6807,75,6561,130,41,116,2021-03-17
317108,JAKARTA PUSAT,JOHAR BARU,3825,41,3640,96,48,89,2021-03-17
317503,JAKARTA TIMUR,JATINEGARA,7996,50,7712,151,83,133,2021-03-17
317409,JAKARTA SELATAN,JAGAKARSA,10233,89,9818,168,158,247,2021-03-17
317302,JAKARTA BARAT,GROGOL PETAMBURAN,7316,109,7001,149,57,166,2021-03-17
317101,JAKARTA PUSAT,GAMBIR,3434,32,3309,56,37,69,2021-03-17
317507,JAKARTA TIMUR,DUREN SAWIT,12637,92,12121,262,162,254,2021-03-17
317509,JAKARTA TIMUR,CIRACAS,8362,125,7872,139,226,351,2021-03-17
317204,JAKARTA UTARA,CILINCING,7100,50,6872,137,41,91,2021-03-17
317406,JAKARTA SELATAN,CILANDAK,7069,54,6829,107,79,133,2021-03-17
317301,JAKARTA BARAT,CENGKARENG,11601,106,11156,234,105,211,2021-03-17
317105,JAKARTA PUSAT,CEMPAKA PUTIH,4484,41,4324,66,53,94,2021-03-17
317506,JAKARTA TIMUR,CAKUNG,10685,87,10318,189,91,178,2021-03-17
111111,Luar DKI & Proses Update,Luar DKI & Proses Update,143008,137,141294,1273,304,441,2021-03-17
317407,JAKARTA SELATAN,KEBAYORAN BARU,5517,31,5342,86,58,89,2021-03-17
317408,JAKARTA SELATAN,PANCORAN,5592,65,5392,88,47,112,2021-03-17
317404,JAKARTA SELATAN,PASAR MINGGU,10119,72,9748,179,120,192,2021-03-17
317505,JAKARTA TIMUR,PASAR REBO,7191,100,6889,127,75,175,2021-03-17
317401,JAKARTA SELATAN,TEBET,6889,59,6625,130,75,134,2021-03-17
317202,JAKARTA UTARA,TANJUNG PRIOK,11270,95,10867,187,121,216,2021-03-17
317107,JAKARTA PUSAT,TANAH ABANG,5315,46,5142,106,21,67,2021-03-17
317304,JAKARTA BARAT,TAMBORA,5261,64,5066,109,22,86,2021-03-17
317303,JAKARTA BARAT,TAMAN SARI,3482,48,3352,52,30,78,2021-03-17
317201,JAKARTA UTARA,PENJARINGAN,6846,83,6601,97,65,148,2021-03-17
317104,JAKARTA PUSAT,SENEN,4025,37,3877,81,30,67,2021-03-17
317102,JAKARTA PUSAT,SAWAH BESAR,3626,37,3492,67,30,67,2021-03-17
317502,JAKARTA TIMUR,PULO GADUNG,8649,87,8313,156,93,180,2021-03-17
317410,JAKARTA SELATAN,PESANGGRAHAN,6697,55,6492,104,46,101,2021-03-17
317402,JAKARTA SELATAN,SETIA BUDI,4761,39,4624,80,18,57,2021-03-17
317508,JAKARTA TIMUR,MAKASAR,7782,80,7506,123,73,153,2021-03-18
317403,JAKARTA SELATAN,MAMPANG PRAPATAN,5313,28,5125,93,67,95,2021-03-18
317106,JAKARTA PUSAT,MENTENG,2909,38,2792,62,17,55,2021-03-18
317205,JAKARTA UTARA,PADEMANGAN,4312,45,4136,74,57,102,2021-03-18
317408,JAKARTA SELATAN,PANCORAN,5611,63,5402,88,58,121,2021-03-18
317404,JAKARTA SELATAN,PASAR MINGGU,10166,74,9806,180,106,180,2021-03-18
317505,JAKARTA TIMUR,PASAR REBO,7232,94,6936,131,71,165,2021-03-18
317201,JAKARTA UTARA,PENJARINGAN,6883,93,6636,97,57,150,2021-03-18
317410,JAKARTA SELATAN,PESANGGRAHAN,6716,58,6526,104,28,86,2021-03-18
317102,JAKARTA PUSAT,SAWAH BESAR,3636,36,3498,68,34,70,2021-03-18
317504,JAKARTA TIMUR,KRAMAT JATI,8873,79,8502,166,126,205,2021-03-18
317104,JAKARTA PUSAT,SENEN,4040,38,3886,81,35,73,2021-03-18
317402,JAKARTA SELATAN,SETIA BUDI,4785,47,4641,80,17,64,2021-03-18
317303,JAKARTA BARAT,TAMAN SARI,3496,45,3362,52,37,82,2021-03-18
317304,JAKARTA BARAT,TAMBORA,5284,66,5080,109,29,95,2021-03-18
317107,JAKARTA PUSAT,TANAH ABANG,5325,52,5144,106,23,75,2021-03-18
317202,JAKARTA UTARA,TANJUNG PRIOK,11328,99,10963,188,78,177,2021-03-18
317401,JAKARTA SELATAN,TEBET,6936,72,6658,130,76,148,2021-03-18
111111,Luar DKI & Proses Update,Luar DKI & Proses Update,143008,137,141294,1273,304,441,2021-03-18
317502,JAKARTA TIMUR,PULO GADUNG,8710,105,8334,156,115,220,2021-03-18
317203,JAKARTA UTARA,KOJA,7749,57,7502,138,52,109,2021-03-18
317307,JAKARTA BARAT,PALMERAH,7052,62,6765,155,70,132,2021-03-18
310102,KAB.ADM.KEP.SERIBU,KEP. SERIBU SELATAN,237,0,234,3,0,0,2021-03-18
317506,JAKARTA TIMUR,CAKUNG,10717,95,10329,189,104,199,2021-03-18
317105,JAKARTA PUSAT,CEMPAKA PUTIH,4503,41,4336,67,59,100,2021-03-18
310101,KAB.ADM.KEP.SERIBU,KEP. SERIBU UTARA,299,1,293,4,1,2,2021-03-18
317301,JAKARTA BARAT,CENGKARENG,11647,110,11180,235,122,232,2021-03-18
317406,JAKARTA SELATAN,CILANDAK,7110,58,6864,107,81,139,2021-03-18
317204,JAKARTA UTARA,CILINCING,7132,54,6892,137,49,103,2021-03-18
317510,JAKARTA TIMUR,CIPAYUNG,9186,70,8892,103,121,191,2021-03-18
317509,JAKARTA TIMUR,CIRACAS,8432,130,7907,141,254,384,2021-03-18
317507,JAKARTA TIMUR,DUREN SAWIT,12696,107,12146,263,180,287,2021-03-18
317101,JAKARTA PUSAT,GAMBIR,3446,32,3321,56,37,69,2021-03-18
317302,JAKARTA BARAT,GROGOL PETAMBURAN,7344,101,7024,149,70,171,2021-03-18
317501,JAKARTA TIMUR,MATRAMAN,5785,37,5551,121,76,113,2021-03-18
317503,JAKARTA TIMUR,JATINEGARA,8032,49,7734,152,97,146,2021-03-18
317409,JAKARTA SELATAN,JAGAKARSA,10293,92,9842,170,189,281,2021-03-18
317103,JAKARTA PUSAT,KEMAYORAN,8871,85,8546,158,82,167,2021-03-18
317305,JAKARTA BARAT,KEBON JERUK,9524,88,9185,168,83,171,2021-03-18
317405,JAKARTA SELATAN,KEBAYORAN LAMA,8341,80,8056,155,50,130,2021-03-18
317206,JAKARTA UTARA,KELAPA GADING,5157,60,4965,82,50,110,2021-03-18
317407,JAKARTA SELATAN,KEBAYORAN BARU,5532,35,5354,86,57,92,2021-03-18
317306,JAKARTA BARAT,KALI DERES,6849,76,6589,131,53,129,2021-03-18
317108,JAKARTA PUSAT,JOHAR BARU,3846,36,3652,96,62,98,2021-03-18
317308,JAKARTA BARAT,KEMBANGAN,8211,78,7939,108,86,164,2021-03-18
317305,JAKARTA BARAT,KEBON JERUK,9570,97,9235,169,69,166,2021-03-19
317409,JAKARTA SELATAN,JAGAKARSA,10378,103,9952,171,152,255,2021-03-19
317405,JAKARTA SELATAN,KEBAYORAN LAMA,8406,83,8092,155,76,159,2021-03-19
317407,JAKARTA SELATAN,KEBAYORAN BARU,5571,38,5377,86,70,108,2021-03-19
317306,JAKARTA BARAT,KALI DERES,6904,88,6639,132,45,133,2021-03-19
317108,JAKARTA PUSAT,JOHAR BARU,3868,38,3668,96,66,104,2021-03-19
317503,JAKARTA TIMUR,JATINEGARA,8076,49,7747,154,126,175,2021-03-19
317302,JAKARTA BARAT,GROGOL PETAMBURAN,7389,107,7050,151,81,188,2021-03-19
317204,JAKARTA UTARA,CILINCING,7162,67,6898,138,59,126,2021-03-19
317507,JAKARTA TIMUR,DUREN SAWIT,12737,107,12167,265,198,305,2021-03-19
317509,JAKARTA TIMUR,CIRACAS,8510,141,7925,142,302,443,2021-03-19
317510,JAKARTA TIMUR,CIPAYUNG,9286,82,8903,103,198,280,2021-03-19
317406,JAKARTA SELATAN,CILANDAK,7141,58,6882,109,92,150,2021-03-19
317301,JAKARTA BARAT,CENGKARENG,11716,139,11225,235,117,256,2021-03-19
317105,JAKARTA PUSAT,CEMPAKA PUTIH,4534,57,4363,67,47,104,2021-03-19
317506,JAKARTA TIMUR,CAKUNG,10777,97,10390,189,101,198,2021-03-19
111111,Luar DKI & Proses Update,Luar DKI & Proses Update,143008,137,141294,1273,304,441,2021-03-19
317103,JAKARTA PUSAT,KEMAYORAN,8907,101,8586,158,62,163,2021-03-19
317101,JAKARTA PUSAT,GAMBIR,3454,34,3330,56,34,68,2021-03-19
317206,JAKARTA UTARA,KELAPA GADING,5206,70,4979,82,75,145,2021-03-19
317308,JAKARTA BARAT,KEMBANGAN,8243,90,7991,108,54,144,2021-03-19
317107,JAKARTA PUSAT,TANAH ABANG,5347,65,5157,106,19,84,2021-03-19
317401,JAKARTA SELATAN,TEBET,6989,67,6703,131,88,155,2021-03-19
317202,JAKARTA UTARA,TANJUNG PRIOK,11382,104,10998,190,90,194,2021-03-19
317304,JAKARTA BARAT,TAMBORA,5312,77,5093,109,33,110,2021-03-19
317303,JAKARTA BARAT,TAMAN SARI,3514,50,3380,52,32,82,2021-03-19
317402,JAKARTA SELATAN,SETIA BUDI,4812,46,4657,80,29,75,2021-03-19
317104,JAKARTA PUSAT,SENEN,4059,48,3903,81,27,75,2021-03-19
317102,JAKARTA PUSAT,SAWAH BESAR,3657,40,3515,68,34,74,2021-03-19
317410,JAKARTA SELATAN,PESANGGRAHAN,6752,57,6537,104,54,111,2021-03-19
317201,JAKARTA UTARA,PENJARINGAN,6917,95,6658,97,67,162,2021-03-19
317505,JAKARTA TIMUR,PASAR REBO,7271,102,6952,131,86,188,2021-03-19
317404,JAKARTA SELATAN,PASAR MINGGU,10221,83,9824,180,134,217,2021-03-19
317502,JAKARTA TIMUR,PULO GADUNG,8773,116,8354,157,146,262,2021-03-19
317307,JAKARTA BARAT,PALMERAH,7080,61,6816,156,47,108,2021-03-19
310102,KAB.ADM.KEP.SERIBU,KEP. SERIBU SELATAN,237,0,234,3,0,0,2021-03-19
317408,JAKARTA SELATAN,PANCORAN,5640,60,5418,88,74,134,2021-03-19
317203,JAKARTA UTARA,KOJA,7795,77,7512,138,68,145,2021-03-19
317504,JAKARTA TIMUR,KRAMAT JATI,8947,95,8522,167,163,258,2021-03-19
317508,JAKARTA TIMUR,MAKASAR,7820,84,7521,125,90,174,2021-03-19
310101,KAB.ADM.KEP.SERIBU,KEP. SERIBU UTARA,299,1,293,4,1,2,2021-03-19
317501,JAKARTA TIMUR,MATRAMAN,5826,42,5561,121,102,144,2021-03-19
317106,JAKARTA PUSAT,MENTENG,2914,37,2804,62,11,48,2021-03-19
317205,JAKARTA UTARA,PADEMANGAN,4332,50,4149,74,59,109,2021-03-19
317403,JAKARTA SELATAN,MAMPANG PRAPATAN,5344,29,5152,93,70,99,2021-03-19
317505,JAKARTA TIMUR,PASAR REBO,7371,78,7024,132,137,215,2021-03-20
317304,JAKARTA BARAT,TAMBORA,5321,60,5120,109,32,92,2021-03-20
317303,JAKARTA BARAT,TAMAN SARI,3529,44,3399,52,34,78,2021-03-20
317402,JAKARTA SELATAN,SETIA BUDI,4845,45,4673,81,46,91,2021-03-20
317104,JAKARTA PUSAT,SENEN,4081,47,3916,81,37,84,2021-03-20
317102,JAKARTA PUSAT,SAWAH BESAR,3670,32,3531,68,39,71,2021-03-20
317502,JAKARTA TIMUR,PULO GADUNG,8813,111,8421,157,124,235,2021-03-20
317410,JAKARTA SELATAN,PESANGGRAHAN,6808,58,6554,104,92,150,2021-03-20
317201,JAKARTA UTARA,PENJARINGAN,6951,97,6700,99,55,152,2021-03-20
317308,JAKARTA BARAT,KEMBANGAN,8264,84,8019,108,53,137,2021-03-20
317404,JAKARTA SELATAN,PASAR MINGGU,10270,76,9866,181,147,223,2021-03-20
317307,JAKARTA BARAT,PALMERAH,7096,57,6831,156,52,109,2021-03-20
317205,JAKARTA UTARA,PADEMANGAN,4357,47,4163,75,72,119,2021-03-20
317106,JAKARTA PUSAT,MENTENG,2919,34,2811,62,12,46,2021-03-20
317501,JAKARTA TIMUR,MATRAMAN,5843,38,5620,121,64,102,2021-03-20
317403,JAKARTA SELATAN,MAMPANG PRAPATAN,5359,24,5165,93,77,101,2021-03-20
317508,JAKARTA TIMUR,MAKASAR,7871,81,7569,126,95,176,2021-03-20
317504,JAKARTA TIMUR,KRAMAT JATI,9019,101,8610,168,140,241,2021-03-20
317203,JAKARTA UTARA,KOJA,7830,71,7543,138,78,149,2021-03-20
317107,JAKARTA PUSAT,TANAH ABANG,5367,64,5178,106,19,83,2021-03-20
317408,JAKARTA SELATAN,PANCORAN,5681,48,5466,89,78,126,2021-03-20
317202,JAKARTA UTARA,TANJUNG PRIOK,11418,98,11032,190,98,196,2021-03-20
317302,JAKARTA BARAT,GROGOL PETAMBURAN,7429,94,7091,151,93,187,2021-03-20
317103,JAKARTA PUSAT,KEMAYORAN,8944,87,8623,158,76,163,2021-03-20
317506,JAKARTA TIMUR,CAKUNG,10828,96,10443,189,100,196,2021-03-20
317105,JAKARTA PUSAT,CEMPAKA PUTIH,4562,59,4409,67,27,86,2021-03-20
317301,JAKARTA BARAT,CENGKARENG,11757,114,11281,236,126,240,2021-03-20
317406,JAKARTA SELATAN,CILANDAK,7171,51,6910,110,100,151,2021-03-20
317204,JAKARTA UTARA,CILINCING,7189,64,6931,139,55,119,2021-03-20
317510,JAKARTA TIMUR,CIPAYUNG,9329,81,8988,103,157,238,2021-03-20
317509,JAKARTA TIMUR,CIRACAS,8554,134,8026,144,250,384,2021-03-20
317507,JAKARTA TIMUR,DUREN SAWIT,12810,110,12273,265,162,272,2021-03-20
317101,JAKARTA PUSAT,GAMBIR,3458,23,3351,56,28,51,2021-03-20
310101,KAB.ADM.KEP.SERIBU,KEP. SERIBU UTARA,299,0,294,4,1,1,2021-03-20
317409,JAKARTA SELATAN,JAGAKARSA,10416,101,9997,171,147,248,2021-03-20
317503,JAKARTA TIMUR,JATINEGARA,8108,56,7801,154,97,153,2021-03-20
111111,Luar DKI & Proses Update,Luar DKI & Proses Update,143008,137,141294,1273,304,441,2021-03-20
317108,JAKARTA PUSAT,JOHAR BARU,3892,33,3685,96,78,111,2021-03-20
317306,JAKARTA BARAT,KALI DERES,6941,82,6674,132,53,135,2021-03-20
317407,JAKARTA SELATAN,KEBAYORAN BARU,5615,39,5413,87,76,115,2021-03-20
317405,JAKARTA SELATAN,KEBAYORAN LAMA,8439,68,8136,156,79,147,2021-03-20
317305,JAKARTA BARAT,KEBON JERUK,9587,82,9261,169,75,157,2021-03-20
317206,JAKARTA UTARA,KELAPA GADING,5233,64,5008,82,79,143,2021-03-20
317401,JAKARTA SELATAN,TEBET,7024,71,6731,131,91,162,2021-03-20
310102,KAB.ADM.KEP.SERIBU,KEP. SERIBU SELATAN,238,0,234,3,1,1,2021-03-20
317302,JAKARTA BARAT,GROGOL PETAMBURAN,7456,75,7154,151,76,151,2021-03-21
317506,JAKARTA TIMUR,CAKUNG,10868,103,10457,190,118,221,2021-03-21
317205,JAKARTA UTARA,PADEMANGAN,4369,46,4209,75,39,85,2021-03-21
317507,JAKARTA TIMUR,DUREN SAWIT,12861,111,12308,267,175,286,2021-03-21
317501,JAKARTA TIMUR,MATRAMAN,5867,33,5630,121,83,116,2021-03-21
317403,JAKARTA SELATAN,MAMPANG PRAPATAN,5377,22,5185,93,77,99,2021-03-21
317508,JAKARTA TIMUR,MAKASAR,7913,72,7610,127,104,176,2021-03-21
317504,JAKARTA TIMUR,KRAMAT JATI,9061,98,8641,168,154,252,2021-03-21
317203,JAKARTA UTARA,KOJA,7871,85,7581,138,67,152,2021-03-21
310101,KAB.ADM.KEP.SERIBU,KEP. SERIBU UTARA,299,0,295,4,0,0,2021-03-21
310102,KAB.ADM.KEP.SERIBU,KEP. SERIBU SELATAN,239,0,234,3,2,2,2021-03-21
317308,JAKARTA BARAT,KEMBANGAN,8305,83,8054,108,60,143,2021-03-21
317103,JAKARTA PUSAT,KEMAYORAN,8990,80,8689,158,63,143,2021-03-21
317206,JAKARTA UTARA,KELAPA GADING,5258,61,5037,83,77,138,2021-03-21
317305,JAKARTA BARAT,KEBON JERUK,9638,54,9322,170,92,146,2021-03-21
317405,JAKARTA SELATAN,KEBAYORAN LAMA,8473,49,8182,156,86,135,2021-03-21
317407,JAKARTA SELATAN,KEBAYORAN BARU,5644,37,5443,89,75,112,2021-03-21
317306,JAKARTA BARAT,KALI DERES,6960,75,6697,132,56,131,2021-03-21
317108,JAKARTA PUSAT,JOHAR BARU,3903,30,3727,96,50,80,2021-03-21
317503,JAKARTA TIMUR,JATINEGARA,8137,52,7833,154,98,150,2021-03-21
317409,JAKARTA SELATAN,JAGAKARSA,10448,81,10059,171,137,218,2021-03-21
317307,JAKARTA BARAT,PALMERAH,7122,60,6861,156,45,105,2021-03-21
317101,JAKARTA PUSAT,GAMBIR,3470,25,3376,56,13,38,2021-03-21
317408,JAKARTA SELATAN,PANCORAN,5713,46,5483,90,94,140,2021-03-21
317505,JAKARTA TIMUR,PASAR REBO,7412,71,7048,132,161,232,2021-03-21
317105,JAKARTA PUSAT,CEMPAKA PUTIH,4570,52,4430,67,21,73,2021-03-21
317301,JAKARTA BARAT,CENGKARENG,11799,101,11368,236,94,195,2021-03-21
317406,JAKARTA SELATAN,CILANDAK,7225,54,6959,110,102,156,2021-03-21
317204,JAKARTA UTARA,CILINCING,7212,62,6951,139,60,122,2021-03-21
317510,JAKARTA TIMUR,CIPAYUNG,9378,72,9022,103,181,253,2021-03-21
317509,JAKARTA TIMUR,CIRACAS,8592,109,8185,145,153,262,2021-03-21
111111,Luar DKI & Proses Update,Luar DKI & Proses Update,143008,137,141294,1273,304,441,2021-03-21
317401,JAKARTA SELATAN,TEBET,7072,73,6764,131,104,177,2021-03-21
317404,JAKARTA SELATAN,PASAR MINGGU,10322,66,9942,181,133,199,2021-03-21
317202,JAKARTA UTARA,TANJUNG PRIOK,11472,106,11073,192,101,207,2021-03-21
317304,JAKARTA BARAT,TAMBORA,5337,55,5136,109,37,92,2021-03-21
317303,JAKARTA BARAT,TAMAN SARI,3539,40,3428,52,19,59,2021-03-21
317402,JAKARTA SELATAN,SETIA BUDI,4872,57,4682,83,50,107,2021-03-21
317104,JAKARTA PUSAT,SENEN,4101,38,3932,83,48,86,2021-03-21
317102,JAKARTA PUSAT,SAWAH BESAR,3683,34,3550,68,31,65,2021-03-21
317502,JAKARTA TIMUR,PULO GADUNG,8855,101,8455,158,141,242,2021-03-21
317410,JAKARTA SELATAN,PESANGGRAHAN,6827,50,6584,104,89,139,2021-03-21
317201,JAKARTA UTARA,PENJARINGAN,6974,96,6729,99,50,146,2021-03-21
317107,JAKARTA PUSAT,TANAH ABANG,5385,67,5191,108,19,86,2021-03-21
317106,JAKARTA PUSAT,MENTENG,2935,45,2819,62,9,54,2021-03-21
111111,Luar DKI & Proses Update,Luar DKI & Proses Update,143008,137,141294,1273,304,441,2021-03-22
317205,JAKARTA UTARA,PADEMANGAN,4405,39,4224,76,66,105,2021-03-22
317202,JAKARTA UTARA,TANJUNG PRIOK,11487,103,11093,194,97,200,2021-03-22
317203,JAKARTA UTARA,KOJA,7880,81,7611,139,49,130,2021-03-22
317504,JAKARTA TIMUR,KRAMAT JATI,9088,97,8705,169,117,214,2021-03-22
317508,JAKARTA TIMUR,MAKASAR,7938,73,7665,128,72,145,2021-03-22
317403,JAKARTA SELATAN,MAMPANG PRAPATAN,5398,22,5217,94,65,87,2021-03-22
317501,JAKARTA TIMUR,MATRAMAN,5876,36,5670,121,49,85,2021-03-22
317106,JAKARTA PUSAT,MENTENG,2943,38,2833,62,10,48,2021-03-22
317307,JAKARTA BARAT,PALMERAH,7126,47,6885,157,37,84,2021-03-22
317408,JAKARTA SELATAN,PANCORAN,5719,33,5509,91,86,119,2021-03-22
310101,KAB.ADM.KEP.SERIBU,KEP. SERIBU UTARA,298,0,294,4,0,0,2021-03-22
317404,JAKARTA SELATAN,PASAR MINGGU,10338,66,9966,182,124,190,2021-03-22
317201,JAKARTA UTARA,PENJARINGAN,6992,96,6751,99,46,142,2021-03-22
317410,JAKARTA SELATAN,PESANGGRAHAN,6839,44,6599,106,90,134,2021-03-22
317502,JAKARTA TIMUR,PULO GADUNG,8882,90,8538,159,95,185,2021-03-22
317102,JAKARTA PUSAT,SAWAH BESAR,3690,30,3563,69,28,58,2021-03-22
317104,JAKARTA PUSAT,SENEN,4112,40,3951,83,38,78,2021-03-22
317402,JAKARTA SELATAN,SETIA BUDI,4893,53,4695,84,61,114,2021-03-22
317303,JAKARTA BARAT,TAMAN SARI,3547,37,3443,52,15,52,2021-03-22
317304,JAKARTA BARAT,TAMBORA,5349,51,5151,109,38,89,2021-03-22
317505,JAKARTA TIMUR,PASAR REBO,7432,67,7100,132,133,200,2021-03-22
317107,JAKARTA PUSAT,TANAH ABANG,5400,56,5219,108,17,73,2021-03-22
310102,KAB.ADM.KEP.SERIBU,KEP. SERIBU SELATAN,239,0,234,3,2,2,2021-03-22
317103,JAKARTA PUSAT,KEMAYORAN,9012,95,8707,158,52,147,2021-03-22
317506,JAKARTA TIMUR,CAKUNG,10891,80,10551,191,69,149,2021-03-22
317105,JAKARTA PUSAT,CEMPAKA PUTIH,4587,56,4448,69,14,70,2021-03-22
317301,JAKARTA BARAT,CENGKARENG,11820,102,11404,236,78,180,2021-03-22
317406,JAKARTA SELATAN,CILANDAK,7243,57,6976,111,99,156,2021-03-22
317204,JAKARTA UTARA,CILINCING,7224,64,6986,139,35,99,2021-03-22
317510,JAKARTA TIMUR,CIPAYUNG,9392,67,9082,104,139,206,2021-03-22
317509,JAKARTA TIMUR,CIRACAS,8623,89,8279,145,110,199,2021-03-22
317507,JAKARTA TIMUR,DUREN SAWIT,12877,106,12411,268,92,198,2021-03-22
317101,JAKARTA PUSAT,GAMBIR,3478,26,3386,56,10,36,2021-03-22
317302,JAKARTA BARAT,GROGOL PETAMBURAN,7469,65,7185,151,68,133,2021-03-22
317409,JAKARTA SELATAN,JAGAKARSA,10488,81,10125,173,109,190,2021-03-22
317503,JAKARTA TIMUR,JATINEGARA,8163,47,7881,154,81,128,2021-03-22
317108,JAKARTA PUSAT,JOHAR BARU,3903,27,3746,96,34,61,2021-03-22
317306,JAKARTA BARAT,KALI DERES,6983,76,6725,132,50,126,2021-03-22
317407,JAKARTA SELATAN,KEBAYORAN BARU,5683,38,5455,90,100,138,2021-03-22
317405,JAKARTA SELATAN,KEBAYORAN LAMA,8495,50,8203,158,84,134,2021-03-22
317305,JAKARTA BARAT,KEBON JERUK,9647,48,9359,170,70,118,2021-03-22
317206,JAKARTA UTARA,KELAPA GADING,5266,56,5058,83,69,125,2021-03-22
317308,JAKARTA BARAT,KEMBANGAN,8319,71,8097,108,43,114,2021-03-22
317401,JAKARTA SELATAN,TEBET,7112,61,6813,131,107,168,2021-03-22
111111,Luar DKI & Proses Update,Luar DKI & Proses Update,143008,137,141294,1273,304,441,2021-03-23
317104,JAKARTA PUSAT,SENEN,4117,40,3961,83,33,73,2021-03-23
317506,JAKARTA TIMUR,CAKUNG,10910,77,10592,191,50,127,2021-03-23
317508,JAKARTA TIMUR,MAKASAR,7960,55,7703,128,74,129,2021-03-23
317403,JAKARTA SELATAN,MAMPANG PRAPATAN,5399,15,5250,94,40,55,2021-03-23
317501,JAKARTA TIMUR,MATRAMAN,5904,28,5693,121,62,90,2021-03-23
317106,JAKARTA PUSAT,MENTENG,2950,22,2856,62,10,32,2021-03-23
317205,JAKARTA UTARA,PADEMANGAN,4418,29,4258,76,55,84,2021-03-23
317307,JAKARTA BARAT,PALMERAH,7143,45,6909,157,32,77,2021-03-23
317408,JAKARTA SELATAN,PANCORAN,5737,31,5542,91,73,104,2021-03-23
317404,JAKARTA SELATAN,PASAR MINGGU,10350,58,10046,182,64,122,2021-03-23
317504,JAKARTA TIMUR,KRAMAT JATI,9114,84,8753,171,106,190,2021-03-23
317505,JAKARTA TIMUR,PASAR REBO,7447,54,7126,132,135,189,2021-03-23
317410,JAKARTA SELATAN,PESANGGRAHAN,6863,45,6657,106,55,100,2021-03-23
317502,JAKARTA TIMUR,PULO GADUNG,8898,62,8584,159,93,155,2021-03-23
317401,JAKARTA SELATAN,TEBET,7129,37,6871,132,89,126,2021-03-23
317202,JAKARTA UTARA,TANJUNG PRIOK,11506,85,11151,195,75,160,2021-03-23
317107,JAKARTA PUSAT,TANAH ABANG,5408,50,5235,108,15,65,2021-03-23
317304,JAKARTA BARAT,TAMBORA,5358,44,5182,110,22,66,2021-03-23
317303,JAKARTA BARAT,TAMAN SARI,3552,33,3459,52,8,41,2021-03-23
317402,JAKARTA SELATAN,SETIA BUDI,4899,41,4729,84,45,86,2021-03-23
317201,JAKARTA UTARA,PENJARINGAN,7015,81,6791,99,44,125,2021-03-23
317203,JAKARTA UTARA,KOJA,7898,71,7637,139,51,122,2021-03-23
310101,KAB.ADM.KEP.SERIBU,KEP. SERIBU UTARA,298,0,294,4,0,0,2021-03-23
310102,KAB.ADM.KEP.SERIBU,KEP. SERIBU SELATAN,240,0,235,3,2,2,2021-03-23
317105,JAKARTA PUSAT,CEMPAKA PUTIH,4611,68,4466,69,8,76,2021-03-23
317301,JAKARTA BARAT,CENGKARENG,11849,91,11458,237,63,154,2021-03-23
317406,JAKARTA SELATAN,CILANDAK,7268,51,7026,114,77,128,2021-03-23
317204,JAKARTA UTARA,CILINCING,7238,51,7005,140,42,93,2021-03-23
317510,JAKARTA TIMUR,CIPAYUNG,9416,54,9173,104,85,139,2021-03-23
317509,JAKARTA TIMUR,CIRACAS,8634,60,8319,147,108,168,2021-03-23
317507,JAKARTA TIMUR,DUREN SAWIT,12946,90,12462,268,126,216,2021-03-23
317101,JAKARTA PUSAT,GAMBIR,3486,21,3396,56,13,34,2021-03-23
317302,JAKARTA BARAT,GROGOL PETAMBURAN,7486,66,7225,151,44,110,2021-03-23
317409,JAKARTA SELATAN,JAGAKARSA,10530,70,10201,173,86,156,2021-03-23
317503,JAKARTA TIMUR,JATINEGARA,8183,42,7903,154,84,126,2021-03-23
317108,JAKARTA PUSAT,JOHAR BARU,3910,23,3769,97,21,44,2021-03-23
317306,JAKARTA BARAT,KALI DERES,7006,62,6775,133,36,98,2021-03-23
317407,JAKARTA SELATAN,KEBAYORAN BARU,5691,36,5493,90,72,108,2021-03-23
317405,JAKARTA SELATAN,KEBAYORAN LAMA,8532,47,8265,159,61,108,2021-03-23
317305,JAKARTA BARAT,KEBON JERUK,9664,48,9397,170,49,97,2021-03-23
317206,JAKARTA UTARA,KELAPA GADING,5291,37,5089,83,82,119,2021-03-23
317103,JAKARTA PUSAT,KEMAYORAN,9034,92,8742,158,42,134,2021-03-23
317308,JAKARTA BARAT,KEMBANGAN,8337,68,8126,109,34,102,2021-03-23
317102,JAKARTA PUSAT,SAWAH BESAR,3698,26,3585,70,17,43,2021-03-23
111111,Luar DKI & Proses Update,Luar DKI & Proses Update,143008,137,141294,1273,304,441,2021-03-24
317407,JAKARTA SELATAN,KEBAYORAN BARU,5725,40,5505,90,90,130,2021-03-24
317107,JAKARTA PUSAT,TANAH ABANG,5448,69,5252,108,19,88,2021-03-24
317508,JAKARTA TIMUR,MAKASAR,8020,67,7733,130,90,157,2021-03-24
317403,JAKARTA SELATAN,MAMPANG PRAPATAN,5421,22,5253,95,51,73,2021-03-24
317501,JAKARTA TIMUR,MATRAMAN,5928,29,5722,121,56,85,2021-03-24
317106,JAKARTA PUSAT,MENTENG,2970,32,2865,62,11,43,2021-03-24
317205,JAKARTA UTARA,PADEMANGAN,4442,37,4266,76,63,100,2021-03-24
317307,JAKARTA BARAT,PALMERAH,7176,49,6915,157,55,104,2021-03-24
317404,JAKARTA SELATAN,PASAR MINGGU,10425,84,10052,182,107,191,2021-03-24
317505,JAKARTA TIMUR,PASAR REBO,7503,68,7150,132,153,221,2021-03-24
317504,JAKARTA TIMUR,KRAMAT JATI,9186,94,8794,172,126,220,2021-03-24
317201,JAKARTA UTARA,PENJARINGAN,7059,96,6803,99,61,157,2021-03-24
317502,JAKARTA TIMUR,PULO GADUNG,8941,74,8627,159,81,155,2021-03-24
317102,JAKARTA PUSAT,SAWAH BESAR,3718,30,3587,70,31,61,2021-03-24
317104,JAKARTA PUSAT,SENEN,4134,41,3967,83,43,84,2021-03-24
317402,JAKARTA SELATAN,SETIA BUDI,4905,42,4730,85,48,90,2021-03-24
317303,JAKARTA BARAT,TAMAN SARI,3560,32,3465,52,11,43,2021-03-24
317304,JAKARTA BARAT,TAMBORA,5369,49,5187,110,23,72,2021-03-24
317202,JAKARTA UTARA,TANJUNG PRIOK,11540,86,11176,195,83,169,2021-03-24
317401,JAKARTA SELATAN,TEBET,7151,47,6874,132,98,145,2021-03-24
317410,JAKARTA SELATAN,PESANGGRAHAN,6910,57,6661,106,86,143,2021-03-24
317203,JAKARTA UTARA,KOJA,7937,72,7663,140,62,134,2021-03-24
317408,JAKARTA SELATAN,PANCORAN,5753,38,5543,91,81,119,2021-03-24
310102,KAB.ADM.KEP.SERIBU,KEP. SERIBU SELATAN,240,0,235,3,2,2,2021-03-24
317506,JAKARTA TIMUR,CAKUNG,10947,86,10601,191,69,155,2021-03-24
317105,JAKARTA PUSAT,CEMPAKA PUTIH,4629,63,4476,69,21,84,2021-03-24
310101,KAB.ADM.KEP.SERIBU,KEP. SERIBU UTARA,305,2,294,4,5,7,2021-03-24
317301,JAKARTA BARAT,CENGKARENG,11900,99,11474,238,89,188,2021-03-24
317406,JAKARTA SELATAN,CILANDAK,7336,62,7032,114,128,190,2021-03-24
317204,JAKARTA UTARA,CILINCING,7264,52,7022,141,49,101,2021-03-24
317510,JAKARTA TIMUR,CIPAYUNG,9500,61,9204,106,129,190,2021-03-24
317507,JAKARTA TIMUR,DUREN SAWIT,12995,104,12490,269,132,236,2021-03-24
317101,JAKARTA PUSAT,GAMBIR,3506,28,3399,56,23,51,2021-03-24
317302,JAKARTA BARAT,GROGOL PETAMBURAN,7535,89,7234,151,61,150,2021-03-24
317509,JAKARTA TIMUR,CIRACAS,8705,74,8371,149,111,185,2021-03-24
317503,JAKARTA TIMUR,JATINEGARA,8222,56,7934,154,78,134,2021-03-24
317308,JAKARTA BARAT,KEMBANGAN,8385,81,8137,109,58,139,2021-03-24
317409,JAKARTA SELATAN,JAGAKARSA,10569,76,10209,175,109,185,2021-03-24
317206,JAKARTA UTARA,KELAPA GADING,5320,53,5115,84,68,121,2021-03-24
317305,JAKARTA BARAT,KEBON JERUK,9718,65,9405,171,77,142,2021-03-24
317103,JAKARTA PUSAT,KEMAYORAN,9077,100,8750,158,69,169,2021-03-24
317306,JAKARTA BARAT,KALI DERES,7049,72,6797,133,47,119,2021-03-24
317108,JAKARTA PUSAT,JOHAR BARU,3924,29,3773,97,25,54,2021-03-24
317405,JAKARTA SELATAN,KEBAYORAN LAMA,8586,65,8284,159,78,143,2021-03-24
317106,JAKARTA PUSAT,MENTENG,2988,41,2869,62,16,57,2021-03-25
310101,KAB.ADM.KEP.SERIBU,KEP. SERIBU UTARA,306,2,294,4,6,8,2021-03-25
317203,JAKARTA UTARA,KOJA,7950,70,7671,140,69,139,2021-03-25
317504,JAKARTA TIMUR,KRAMAT JATI,9233,101,8800,173,159,260,2021-03-25
317508,JAKARTA TIMUR,MAKASAR,8036,66,7745,131,94,160,2021-03-25
317403,JAKARTA SELATAN,MAMPANG PRAPATAN,5424,21,5255,95,53,74,2021-03-25
317501,JAKARTA TIMUR,MATRAMAN,5935,30,5722,123,60,90,2021-03-25
317205,JAKARTA UTARA,PADEMANGAN,4449,35,4278,76,60,95,2021-03-25
317104,JAKARTA PUSAT,SENEN,4174,47,3972,83,72,119,2021-03-25
317408,JAKARTA SELATAN,PANCORAN,5793,40,5547,92,114,154,2021-03-25
317404,JAKARTA SELATAN,PASAR MINGGU,10440,88,10079,184,89,177,2021-03-25
317505,JAKARTA TIMUR,PASAR REBO,7538,77,7157,134,170,247,2021-03-25
317201,JAKARTA UTARA,PENJARINGAN,7087,99,6826,99,63,162,2021-03-25
317410,JAKARTA SELATAN,PESANGGRAHAN,6922,64,6699,106,53,117,2021-03-25
317502,JAKARTA TIMUR,PULO GADUNG,8977,86,8631,159,101,187,2021-03-25
317102,JAKARTA PUSAT,SAWAH BESAR,3740,40,3587,70,43,83,2021-03-25
310102,KAB.ADM.KEP.SERIBU,KEP. SERIBU SELATAN,240,0,236,3,1,1,2021-03-25
317307,JAKARTA BARAT,PALMERAH,7205,59,6926,157,63,122,2021-03-25
317308,JAKARTA BARAT,KEMBANGAN,8421,89,8147,109,76,165,2021-03-25
317303,JAKARTA BARAT,TAMAN SARI,3594,40,3470,52,32,72,2021-03-25
317206,JAKARTA UTARA,KELAPA GADING,5335,59,5122,84,70,129,2021-03-25
111111,Luar DKI & Proses Update,Luar DKI & Proses Update,143008,137,141294,1273,304,441,2021-03-25
317506,JAKARTA TIMUR,CAKUNG,10979,90,10606,191,92,182,2021-03-25
317105,JAKARTA PUSAT,CEMPAKA PUTIH,4644,72,4485,69,18,90,2021-03-25
317301,JAKARTA BARAT,CENGKARENG,11940,92,11523,238,87,179,2021-03-25
317406,JAKARTA SELATAN,CILANDAK,7371,74,7052,114,131,205,2021-03-25
317204,JAKARTA UTARA,CILINCING,7308,65,7026,142,75,140,2021-03-25
317510,JAKARTA TIMUR,CIPAYUNG,9553,83,9216,106,148,231,2021-03-25
317509,JAKARTA TIMUR,CIRACAS,8746,78,8386,149,133,211,2021-03-25
317507,JAKARTA TIMUR,DUREN SAWIT,13043,122,12501,270,150,272,2021-03-25
317302,JAKARTA BARAT,GROGOL PETAMBURAN,7582,98,7264,151,69,167,2021-03-25
317409,JAKARTA SELATAN,JAGAKARSA,10599,94,10214,176,115,209,2021-03-25
317503,JAKARTA TIMUR,JATINEGARA,8265,68,7938,154,105,173,2021-03-25
317108,JAKARTA PUSAT,JOHAR BARU,3934,32,3775,97,30,62,2021-03-25
317306,JAKARTA BARAT,KALI DERES,7091,69,6831,134,57,126,2021-03-25
317407,JAKARTA SELATAN,KEBAYORAN BARU,5743,45,5511,90,97,142,2021-03-25
317405,JAKARTA SELATAN,KEBAYORAN LAMA,8617,70,8291,159,97,167,2021-03-25
317305,JAKARTA BARAT,KEBON JERUK,9743,70,9427,171,75,145,2021-03-25
317103,JAKARTA PUSAT,KEMAYORAN,9109,107,8762,158,82,189,2021-03-25
317402,JAKARTA SELATAN,SETIA BUDI,4927,46,4734,85,62,108,2021-03-25
317101,JAKARTA PUSAT,GAMBIR,3514,32,3401,56,25,57,2021-03-25
317304,JAKARTA BARAT,TAMBORA,5393,63,5190,110,30,93,2021-03-25
317107,JAKARTA PUSAT,TANAH ABANG,5463,78,5258,108,19,97,2021-03-25
317202,JAKARTA UTARA,TANJUNG PRIOK,11575,87,11199,198,91,178,2021-03-25
317401,JAKARTA SELATAN,TEBET,7194,56,6882,134,122,178,2021-03-25
317307,JAKARTA BARAT,PALMERAH,7227,66,6929,157,75,141,2021-03-26
317508,JAKARTA TIMUR,MAKASAR,8080,76,7766,132,106,182,2021-03-26
317403,JAKARTA SELATAN,MAMPANG PRAPATAN,5437,23,5268,95,51,74,2021-03-26
317501,JAKARTA TIMUR,MATRAMAN,5955,35,5729,123,68,103,2021-03-26
317106,JAKARTA PUSAT,MENTENG,2998,46,2874,62,16,62,2021-03-26
317205,JAKARTA UTARA,PADEMANGAN,4473,42,4278,77,76,118,2021-03-26
317408,JAKARTA SELATAN,PANCORAN,5820,42,5582,92,104,146,2021-03-26
317404,JAKARTA SELATAN,PASAR MINGGU,10486,97,10089,185,115,212,2021-03-26
317505,JAKARTA TIMUR,PASAR REBO,7568,82,7197,134,155,237,2021-03-26
317201,JAKARTA UTARA,PENJARINGAN,7131,121,6828,99,83,204,2021-03-26
317102,JAKARTA PUSAT,SAWAH BESAR,3759,46,3598,70,45,91,2021-03-26
317502,JAKARTA TIMUR,PULO GADUNG,9010,99,8642,159,110,209,2021-03-26
111111,Luar DKI & Proses Update,Luar DKI & Proses Update,143008,137,141294,1273,304,441,2021-03-26
317104,JAKARTA PUSAT,SENEN,4181,44,3990,85,62,106,2021-03-26
317402,JAKARTA SELATAN,SETIA BUDI,4938,46,4764,85,43,89,2021-03-26
317303,JAKARTA BARAT,TAMAN SARI,3613,52,3473,53,35,87,2021-03-26
317304,JAKARTA BARAT,TAMBORA,5421,75,5200,111,35,110,2021-03-26
317107,JAKARTA PUSAT,TANAH ABANG,5477,86,5265,108,18,104,2021-03-26
317202,JAKARTA UTARA,TANJUNG PRIOK,11617,108,11200,199,110,218,2021-03-26
317401,JAKARTA SELATAN,TEBET,7233,59,6897,135,142,201,2021-03-26
317410,JAKARTA SELATAN,PESANGGRAHAN,6953,68,6714,106,65,133,2021-03-26
317203,JAKARTA UTARA,KOJA,7997,90,7673,142,92,182,2021-03-26
317504,JAKARTA TIMUR,KRAMAT JATI,9270,107,8847,173,143,250,2021-03-26
310102,KAB.ADM.KEP.SERIBU,KEP. SERIBU SELATAN,240,0,236,3,1,1,2021-03-26
317506,JAKARTA TIMUR,CAKUNG,11010,90,10637,191,92,182,2021-03-26
317105,JAKARTA PUSAT,CEMPAKA PUTIH,4662,83,4487,69,23,106,2021-03-26
317301,JAKARTA BARAT,CENGKARENG,11984,109,11522,240,113,222,2021-03-26
317406,JAKARTA SELATAN,CILANDAK,7412,76,7067,116,153,229,2021-03-26
317204,JAKARTA UTARA,CILINCING,7330,74,7027,142,87,161,2021-03-26
317510,JAKARTA TIMUR,CIPAYUNG,9593,89,9235,106,163,252,2021-03-26
310101,KAB.ADM.KEP.SERIBU,KEP. SERIBU UTARA,306,2,294,4,6,8,2021-03-26
317507,JAKARTA TIMUR,DUREN SAWIT,13116,134,12549,270,163,297,2021-03-26
317101,JAKARTA PUSAT,GAMBIR,3526,36,3406,56,28,64,2021-03-26
317302,JAKARTA BARAT,GROGOL PETAMBURAN,7620,118,7266,151,85,203,2021-03-26
317509,JAKARTA TIMUR,CIRACAS,8786,85,8418,150,133,218,2021-03-26
317503,JAKARTA TIMUR,JATINEGARA,8289,72,7954,154,109,181,2021-03-26
317409,JAKARTA SELATAN,JAGAKARSA,10646,98,10245,176,127,225,2021-03-26
317103,JAKARTA PUSAT,KEMAYORAN,9124,106,8788,159,71,177,2021-03-26
317206,JAKARTA UTARA,KELAPA GADING,5351,71,5122,86,72,143,2021-03-26
317305,JAKARTA BARAT,KEBON JERUK,9775,78,9430,172,95,173,2021-03-26
317308,JAKARTA BARAT,KEMBANGAN,8444,88,8158,109,89,177,2021-03-26
317407,JAKARTA SELATAN,KEBAYORAN BARU,5771,48,5549,90,84,132,2021-03-26
317306,JAKARTA BARAT,KALI DERES,7129,80,6840,134,75,155,2021-03-26
317108,JAKARTA PUSAT,JOHAR BARU,3949,33,3794,97,25,58,2021-03-26
317405,JAKARTA SELATAN,KEBAYORAN LAMA,8641,77,8315,159,90,167,2021-03-26
317206,JAKARTA UTARA,KELAPA GADING,5370,72,5160,86,52,124,2021-03-27
317305,JAKARTA BARAT,KEBON JERUK,9795,78,9473,172,72,150,2021-03-27
317405,JAKARTA SELATAN,KEBAYORAN LAMA,8700,87,8344,160,109,196,2021-03-27
317407,JAKARTA SELATAN,KEBAYORAN BARU,5818,49,5585,91,93,142,2021-03-27
317306,JAKARTA BARAT,KALI DERES,7224,81,6932,135,76,157,2021-03-27
317108,JAKARTA PUSAT,JOHAR BARU,3954,29,3800,97,28,57,2021-03-27
317503,JAKARTA TIMUR,JATINEGARA,8336,70,7974,155,137,207,2021-03-27
317409,JAKARTA SELATAN,JAGAKARSA,10685,111,10254,176,144,255,2021-03-27
317302,JAKARTA BARAT,GROGOL PETAMBURAN,7665,124,7300,151,90,214,2021-03-27
317502,JAKARTA TIMUR,PULO GADUNG,9056,87,8711,161,97,184,2021-03-27
317507,JAKARTA TIMUR,DUREN SAWIT,13163,133,12592,270,168,301,2021-03-27
317509,JAKARTA TIMUR,CIRACAS,8814,96,8428,150,140,236,2021-03-27
317510,JAKARTA TIMUR,CIPAYUNG,9616,91,9248,106,171,262,2021-03-27
317204,JAKARTA UTARA,CILINCING,7359,81,7056,143,79,160,2021-03-27
317406,JAKARTA SELATAN,CILANDAK,7440,81,7105,117,137,218,2021-03-27
317301,JAKARTA BARAT,CENGKARENG,12063,113,11607,240,103,216,2021-03-27
317105,JAKARTA PUSAT,CEMPAKA PUTIH,4680,83,4504,69,24,107,2021-03-27
317506,JAKARTA TIMUR,CAKUNG,11039,98,10666,191,84,182,2021-03-27
317103,JAKARTA PUSAT,KEMAYORAN,9145,108,8811,159,67,175,2021-03-27
317101,JAKARTA PUSAT,GAMBIR,3533,38,3415,56,24,62,2021-03-27
317308,JAKARTA BARAT,KEMBANGAN,8468,86,8203,109,70,156,2021-03-27
310102,KAB.ADM.KEP.SERIBU,KEP. SERIBU SELATAN,240,0,237,3,0,0,2021-03-27
310101,KAB.ADM.KEP.SERIBU,KEP. SERIBU UTARA,307,2,294,4,7,9,2021-03-27
317410,JAKARTA SELATAN,PESANGGRAHAN,6974,66,6733,106,69,135,2021-03-27
317202,JAKARTA UTARA,TANJUNG PRIOK,11657,118,11217,200,122,240,2021-03-27
317107,JAKARTA PUSAT,TANAH ABANG,5499,92,5278,108,21,113,2021-03-27
317304,JAKARTA BARAT,TAMBORA,5441,79,5214,113,35,114,2021-03-27
317303,JAKARTA BARAT,TAMAN SARI,3620,51,3481,53,35,86,2021-03-27
317402,JAKARTA SELATAN,SETIA BUDI,4958,48,4776,86,48,96,2021-03-27
317104,JAKARTA PUSAT,SENEN,4196,46,4007,85,58,104,2021-03-27
317102,JAKARTA PUSAT,SAWAH BESAR,3768,50,3606,70,42,92,2021-03-27
111111,Luar DKI & Proses Update,Luar DKI & Proses Update,143008,137,141294,1273,304,441,2021-03-27
317505,JAKARTA TIMUR,PASAR REBO,7615,103,7254,134,124,227,2021-03-27
317401,JAKARTA SELATAN,TEBET,7261,58,6936,137,130,188,2021-03-27
317408,JAKARTA SELATAN,PANCORAN,5854,44,5611,93,106,150,2021-03-27
317203,JAKARTA UTARA,KOJA,8024,90,7714,142,78,168,2021-03-27
317404,JAKARTA SELATAN,PASAR MINGGU,10540,107,10122,188,123,230,2021-03-27
317504,JAKARTA TIMUR,KRAMAT JATI,9339,107,8868,175,189,296,2021-03-27
317508,JAKARTA TIMUR,MAKASAR,8111,77,7777,133,124,201,2021-03-27
317201,JAKARTA UTARA,PENJARINGAN,7164,117,6861,99,87,204,2021-03-27
317501,JAKARTA TIMUR,MATRAMAN,5966,39,5754,123,50,89,2021-03-27
317106,JAKARTA PUSAT,MENTENG,3005,50,2879,62,14,64,2021-03-27
317307,JAKARTA BARAT,PALMERAH,7246,69,6940,158,79,148,2021-03-27
317205,JAKARTA UTARA,PADEMANGAN,4493,46,4296,77,74,120,2021-03-27
317403,JAKARTA SELATAN,MAMPANG PRAPATAN,5454,23,5283,95,53,76,2021-03-27
317305,JAKARTA BARAT,KEBON JERUK,9825,84,9481,172,88,172,2021-03-28
317405,JAKARTA SELATAN,KEBAYORAN LAMA,8718,90,8361,160,107,197,2021-03-28
317407,JAKARTA SELATAN,KEBAYORAN BARU,5839,44,5625,91,79,123,2021-03-28
317306,JAKARTA BARAT,KALI DERES,7247,81,6949,135,82,163,2021-03-28
317108,JAKARTA PUSAT,JOHAR BARU,3972,27,3808,97,40,67,2021-03-28
317503,JAKARTA TIMUR,JATINEGARA,8361,65,8006,156,134,199,2021-03-28
317409,JAKARTA SELATAN,JAGAKARSA,10729,90,10328,177,134,224,2021-03-28
317101,JAKARTA PUSAT,GAMBIR,3551,39,3423,56,33,72,2021-03-28
317507,JAKARTA TIMUR,DUREN SAWIT,13207,118,12620,271,198,316,2021-03-28
317509,JAKARTA TIMUR,CIRACAS,8837,91,8466,151,129,220,2021-03-28
317204,JAKARTA UTARA,CILINCING,7385,80,7067,143,95,175,2021-03-28
317406,JAKARTA SELATAN,CILANDAK,7452,70,7134,117,131,201,2021-03-28
317301,JAKARTA BARAT,CENGKARENG,12103,118,11618,241,126,244,2021-03-28
317105,JAKARTA PUSAT,CEMPAKA PUTIH,4700,90,4515,69,26,116,2021-03-28
317506,JAKARTA TIMUR,CAKUNG,11053,84,10692,191,86,170,2021-03-28
317206,JAKARTA UTARA,KELAPA GADING,5390,78,5170,86,56,134,2021-03-28
317302,JAKARTA BARAT,GROGOL PETAMBURAN,7696,132,7311,151,102,234,2021-03-28
317510,JAKARTA TIMUR,CIPAYUNG,9648,88,9290,108,162,250,2021-03-28
317508,JAKARTA TIMUR,MAKASAR,8119,74,7808,134,103,177,2021-03-28
310102,KAB.ADM.KEP.SERIBU,KEP. SERIBU SELATAN,240,0,237,3,0,0,2021-03-28
111111,Luar DKI & Proses Update,Luar DKI & Proses Update,143008,137,141294,1273,304,441,2021-03-28
317401,JAKARTA SELATAN,TEBET,7295,54,6981,137,123,177,2021-03-28
317202,JAKARTA UTARA,TANJUNG PRIOK,11692,117,11260,201,114,231,2021-03-28
317107,JAKARTA PUSAT,TANAH ABANG,5507,88,5289,109,21,109,2021-03-28
317304,JAKARTA BARAT,TAMBORA,5442,77,5222,114,29,106,2021-03-28
317303,JAKARTA BARAT,TAMAN SARI,3625,54,3485,53,33,87,2021-03-28
317402,JAKARTA SELATAN,SETIA BUDI,4967,43,4797,87,40,83,2021-03-28
317104,JAKARTA PUSAT,SENEN,4209,40,4021,86,62,102,2021-03-28
317102,JAKARTA PUSAT,SAWAH BESAR,3783,52,3612,70,49,101,2021-03-28
317502,JAKARTA TIMUR,PULO GADUNG,9081,88,8735,163,95,183,2021-03-28
317308,JAKARTA BARAT,KEMBANGAN,8480,80,8216,109,75,155,2021-03-28
317410,JAKARTA SELATAN,PESANGGRAHAN,6988,62,6743,106,77,139,2021-03-28
317505,JAKARTA TIMUR,PASAR REBO,7639,104,7280,134,121,225,2021-03-28
317404,JAKARTA SELATAN,PASAR MINGGU,10570,95,10149,188,138,233,2021-03-28
317408,JAKARTA SELATAN,PANCORAN,5878,43,5623,93,119,162,2021-03-28
317307,JAKARTA BARAT,PALMERAH,7260,62,6959,158,81,143,2021-03-28
317205,JAKARTA UTARA,PADEMANGAN,4505,49,4332,77,47,96,2021-03-28
317106,JAKARTA PUSAT,MENTENG,3008,43,2892,62,11,54,2021-03-28
317501,JAKARTA TIMUR,MATRAMAN,6000,42,5761,123,74,116,2021-03-28
317403,JAKARTA SELATAN,MAMPANG PRAPATAN,5469,23,5303,95,48,71,2021-03-28
317504,JAKARTA TIMUR,KRAMAT JATI,9375,105,8902,175,193,298,2021-03-28
317203,JAKARTA UTARA,KOJA,8034,90,7722,144,78,168,2021-03-28
310101,KAB.ADM.KEP.SERIBU,KEP. SERIBU UTARA,308,2,294,4,8,10,2021-03-28
317201,JAKARTA UTARA,PENJARINGAN,7190,118,6878,101,93,211,2021-03-28
317103,JAKARTA PUSAT,KEMAYORAN,9162,90,8838,159,75,165,2021-03-28
111111,Luar DKI & Proses Update,Luar DKI & Proses Update,143008,137,141294,1273,304,441,2021-03-29
317308,JAKARTA BARAT,KEMBANGAN,8483,82,8240,109,52,134,2021-03-29
317107,JAKARTA PUSAT,TANAH ABANG,5508,81,5303,109,15,96,2021-03-29
317504,JAKARTA TIMUR,KRAMAT JATI,9394,110,8919,174,191,301,2021-03-29
317508,JAKARTA TIMUR,MAKASAR,8129,70,7843,134,82,152,2021-03-29
317403,JAKARTA SELATAN,MAMPANG PRAPATAN,5478,25,5316,95,42,67,2021-03-29
317501,JAKARTA TIMUR,MATRAMAN,6010,45,5784,123,58,103,2021-03-29
317106,JAKARTA PUSAT,MENTENG,3012,37,2901,62,12,49,2021-03-29
317205,JAKARTA UTARA,PADEMANGAN,4521,46,4346,77,52,98,2021-03-29
317307,JAKARTA BARAT,PALMERAH,7266,60,6993,158,55,115,2021-03-29
317408,JAKARTA SELATAN,PANCORAN,5893,41,5647,93,112,153,2021-03-29
317203,JAKARTA UTARA,KOJA,8033,69,7746,144,74,143,2021-03-29
317404,JAKARTA SELATAN,PASAR MINGGU,10582,90,10204,188,100,190,2021-03-29
317201,JAKARTA UTARA,PENJARINGAN,7198,112,6904,101,81,193,2021-03-29
317410,JAKARTA SELATAN,PESANGGRAHAN,6993,53,6786,106,48,101,2021-03-29
317502,JAKARTA TIMUR,PULO GADUNG,9090,83,8749,163,95,178,2021-03-29
317102,JAKARTA PUSAT,SAWAH BESAR,3786,46,3639,70,31,77,2021-03-29
317104,JAKARTA PUSAT,SENEN,4210,37,4033,87,53,90,2021-03-29
317402,JAKARTA SELATAN,SETIA BUDI,4969,31,4816,87,35,66,2021-03-29
317303,JAKARTA BARAT,TAMAN SARI,3631,50,3494,53,34,84,2021-03-29
317304,JAKARTA BARAT,TAMBORA,5438,74,5223,114,27,101,2021-03-29
317505,JAKARTA TIMUR,PASAR REBO,7642,89,7297,134,122,211,2021-03-29
310101,KAB.ADM.KEP.SERIBU,KEP. SERIBU UTARA,308,2,299,4,3,5,2021-03-29
310102,KAB.ADM.KEP.SERIBU,KEP. SERIBU SELATAN,240,0,237,3,0,0,2021-03-29
317103,JAKARTA PUSAT,KEMAYORAN,9166,72,8884,159,51,123,2021-03-29
317506,JAKARTA TIMUR,CAKUNG,11057,83,10719,191,64,147,2021-03-29
317105,JAKARTA PUSAT,CEMPAKA PUTIH,4698,78,4535,69,16,94,2021-03-29
317301,JAKARTA BARAT,CENGKARENG,12123,110,11669,242,102,212,2021-03-29
317406,JAKARTA SELATAN,CILANDAK,7465,67,7201,117,80,147,2021-03-29
317204,JAKARTA UTARA,CILINCING,7386,72,7085,143,86,158,2021-03-29
317510,JAKARTA TIMUR,CIPAYUNG,9663,94,9324,108,137,231,2021-03-29
317509,JAKARTA TIMUR,CIRACAS,8845,97,8472,151,125,222,2021-03-29
317507,JAKARTA TIMUR,DUREN SAWIT,13212,120,12662,271,159,279,2021-03-29
317401,JAKARTA SELATAN,TEBET,7300,50,7004,138,108,158,2021-03-29
317101,JAKARTA PUSAT,GAMBIR,3558,37,3440,56,25,62,2021-03-29
317409,JAKARTA SELATAN,JAGAKARSA,10745,83,10382,177,103,186,2021-03-29
317503,JAKARTA TIMUR,JATINEGARA,8375,61,8015,157,142,203,2021-03-29
317108,JAKARTA PUSAT,JOHAR BARU,3966,19,3814,97,36,55,2021-03-29
317306,JAKARTA BARAT,KALI DERES,7280,85,6969,135,91,176,2021-03-29
317407,JAKARTA SELATAN,KEBAYORAN BARU,5843,41,5650,91,61,102,2021-03-29
317405,JAKARTA SELATAN,KEBAYORAN LAMA,8722,81,8401,160,80,161,2021-03-29
317305,JAKARTA BARAT,KEBON JERUK,9838,90,9511,172,65,155,2021-03-29
317206,JAKARTA UTARA,KELAPA GADING,5386,69,5195,86,36,105,2021-03-29
317302,JAKARTA BARAT,GROGOL PETAMBURAN,7710,129,7340,151,90,219,2021-03-29
317202,JAKARTA UTARA,TANJUNG PRIOK,11703,107,11300,201,95,202,2021-03-29
111111,Luar DKI & Proses Update,Luar DKI & Proses Update,143008,137,141294,1273,304,441,2021-03-30
317202,JAKARTA UTARA,TANJUNG PRIOK,11727,125,11327,201,74,199,2021-03-30
317506,JAKARTA TIMUR,CAKUNG,11061,73,10732,192,64,137,2021-03-30
317504,JAKARTA TIMUR,KRAMAT JATI,9422,98,9026,175,123,221,2021-03-30
317508,JAKARTA TIMUR,MAKASAR,8176,83,7876,134,83,166,2021-03-30
317403,JAKARTA SELATAN,MAMPANG PRAPATAN,5487,29,5320,95,43,72,2021-03-30
317501,JAKARTA TIMUR,MATRAMAN,6022,48,5807,123,44,92,2021-03-30
317106,JAKARTA PUSAT,MENTENG,3026,42,2910,62,12,54,2021-03-30
317205,JAKARTA UTARA,PADEMANGAN,4527,51,4353,77,46,97,2021-03-30
317307,JAKARTA BARAT,PALMERAH,7285,61,7017,158,49,110,2021-03-30
317408,JAKARTA SELATAN,PANCORAN,5911,47,5655,95,114,161,2021-03-30
317203,JAKARTA UTARA,KOJA,8054,77,7781,144,52,129,2021-03-30
317404,JAKARTA SELATAN,PASAR MINGGU,10596,96,10213,188,99,195,2021-03-30
317201,JAKARTA UTARA,PENJARINGAN,7234,124,6937,101,72,196,2021-03-30
317410,JAKARTA SELATAN,PESANGGRAHAN,7012,52,6802,106,52,104,2021-03-30
317502,JAKARTA TIMUR,PULO GADUNG,9124,87,8786,163,88,175,2021-03-30
317102,JAKARTA PUSAT,SAWAH BESAR,3801,51,3647,70,33,84,2021-03-30
317104,JAKARTA PUSAT,SENEN,4217,37,4038,87,55,92,2021-03-30
317402,JAKARTA SELATAN,SETIA BUDI,4983,38,4819,87,39,77,2021-03-30
317303,JAKARTA BARAT,TAMAN SARI,3635,47,3520,54,14,61,2021-03-30
317304,JAKARTA BARAT,TAMBORA,5440,67,5232,115,26,93,2021-03-30
317505,JAKARTA TIMUR,PASAR REBO,7652,80,7362,134,76,156,2021-03-30
317401,JAKARTA SELATAN,TEBET,7319,56,7011,138,114,170,2021-03-30
310101,KAB.ADM.KEP.SERIBU,KEP. SERIBU UTARA,306,1,299,4,2,3,2021-03-30
317308,JAKARTA BARAT,KEMBANGAN,8511,83,8277,109,42,125,2021-03-30
317105,JAKARTA PUSAT,CEMPAKA PUTIH,4727,88,4546,70,23,111,2021-03-30
317301,JAKARTA BARAT,CENGKARENG,12168,121,11708,243,96,217,2021-03-30
317406,JAKARTA SELATAN,CILANDAK,7486,70,7215,117,84,154,2021-03-30
317204,JAKARTA UTARA,CILINCING,7420,84,7119,143,74,158,2021-03-30
317510,JAKARTA TIMUR,CIPAYUNG,9684,91,9405,109,79,170,2021-03-30
317509,JAKARTA TIMUR,CIRACAS,8862,92,8554,151,65,157,2021-03-30
317507,JAKARTA TIMUR,DUREN SAWIT,13252,122,12702,273,155,277,2021-03-30
317101,JAKARTA PUSAT,GAMBIR,3565,38,3442,57,28,66,2021-03-30
310102,KAB.ADM.KEP.SERIBU,KEP. SERIBU SELATAN,239,0,236,3,0,0,2021-03-30
317302,JAKARTA BARAT,GROGOL PETAMBURAN,7734,134,7378,151,71,205,2021-03-30
317503,JAKARTA TIMUR,JATINEGARA,8395,69,8045,157,124,193,2021-03-30
317108,JAKARTA PUSAT,JOHAR BARU,3969,21,3815,97,36,57,2021-03-30
317306,JAKARTA BARAT,KALI DERES,7305,84,7012,135,74,158,2021-03-30
317407,JAKARTA SELATAN,KEBAYORAN BARU,5862,41,5664,91,66,107,2021-03-30
317405,JAKARTA SELATAN,KEBAYORAN LAMA,8742,87,8416,161,78,165,2021-03-30
317305,JAKARTA BARAT,KEBON JERUK,9864,94,9528,172,70,164,2021-03-30
317206,JAKARTA UTARA,KELAPA GADING,5401,74,5208,86,33,107,2021-03-30
317103,JAKARTA PUSAT,KEMAYORAN,9186,70,8893,160,63,133,2021-03-30
317409,JAKARTA SELATAN,JAGAKARSA,10767,85,10394,177,111,196,2021-03-30
317107,JAKARTA PUSAT,TANAH ABANG,5528,90,5312,109,17,107,2021-03-30
111111,Luar DKI & Proses Update,Luar DKI & Proses Update,143008,137,141294,1273,304,441,2021-03-31
317506,JAKARTA TIMUR,CAKUNG,11085,73,10765,192,55,128,2021-03-31
317509,JAKARTA TIMUR,CIRACAS,8913,102,8569,151,91,193,2021-03-31
317501,JAKARTA TIMUR,MATRAMAN,6037,50,5810,124,53,103,2021-03-31
317106,JAKARTA PUSAT,MENTENG,3033,38,2921,62,12,50,2021-03-31
317205,JAKARTA UTARA,PADEMANGAN,4546,48,4364,77,57,105,2021-03-31
317307,JAKARTA BARAT,PALMERAH,7303,60,7026,158,59,119,2021-03-31
317408,JAKARTA SELATAN,PANCORAN,5925,45,5696,95,89,134,2021-03-31
317404,JAKARTA SELATAN,PASAR MINGGU,10628,96,10223,188,121,217,2021-03-31
317505,JAKARTA TIMUR,PASAR REBO,7683,84,7373,134,92,176,2021-03-31
317201,JAKARTA UTARA,PENJARINGAN,7263,113,6970,101,79,192,2021-03-31
317403,JAKARTA SELATAN,MAMPANG PRAPATAN,5512,33,5322,95,62,95,2021-03-31
317410,JAKARTA SELATAN,PESANGGRAHAN,7033,50,6808,106,69,119,2021-03-31
317102,JAKARTA PUSAT,SAWAH BESAR,3814,50,3661,70,33,83,2021-03-31
317104,JAKARTA PUSAT,SENEN,4239,38,4072,87,42,80,2021-03-31
317402,JAKARTA SELATAN,SETIA BUDI,5014,47,4834,87,46,93,2021-03-31
317303,JAKARTA BARAT,TAMAN SARI,3643,44,3530,54,15,59,2021-03-31
317304,JAKARTA BARAT,TAMBORA,5456,70,5245,115,26,96,2021-03-31
317107,JAKARTA PUSAT,TANAH ABANG,5552,90,5336,109,17,107,2021-03-31
317202,JAKARTA UTARA,TANJUNG PRIOK,11769,123,11346,201,99,222,2021-03-31
317401,JAKARTA SELATAN,TEBET,7346,62,7042,138,104,166,2021-03-31
317502,JAKARTA TIMUR,PULO GADUNG,9159,87,8821,163,88,175,2021-03-31
317508,JAKARTA TIMUR,MAKASAR,8199,88,7882,134,95,183,2021-03-31
317510,JAKARTA TIMUR,CIPAYUNG,9712,97,9409,109,97,194,2021-03-31
317203,JAKARTA UTARA,KOJA,8079,73,7812,144,50,123,2021-03-31
317504,JAKARTA TIMUR,KRAMAT JATI,9467,94,9042,175,156,250,2021-03-31
317204,JAKARTA UTARA,CILINCING,7440,83,7146,143,68,151,2021-03-31
317406,JAKARTA SELATAN,CILANDAK,7528,76,7230,117,105,181,2021-03-31
317301,JAKARTA BARAT,CENGKARENG,12221,126,11736,243,116,242,2021-03-31
317105,JAKARTA PUSAT,CEMPAKA PUTIH,4733,72,4563,71,27,99,2021-03-31
317507,JAKARTA TIMUR,DUREN SAWIT,13319,136,12739,273,171,307,2021-03-31
317101,JAKARTA PUSAT,GAMBIR,3568,31,3453,57,27,58,2021-03-31
317409,JAKARTA SELATAN,JAGAKARSA,10828,94,10399,178,157,251,2021-03-31
317503,JAKARTA TIMUR,JATINEGARA,8417,63,8085,157,112,175,2021-03-31
317108,JAKARTA PUSAT,JOHAR BARU,3994,21,3822,97,54,75,2021-03-31
317302,JAKARTA BARAT,GROGOL PETAMBURAN,7759,122,7399,151,87,209,2021-03-31
317407,JAKARTA SELATAN,KEBAYORAN BARU,5882,44,5679,91,68,112,2021-03-31
310101,KAB.ADM.KEP.SERIBU,KEP. SERIBU UTARA,306,1,299,4,2,3,2021-03-31
317306,JAKARTA BARAT,KALI DERES,7367,83,7061,135,88,171,2021-03-31
317308,JAKARTA BARAT,KEMBANGAN,8528,83,8286,109,50,133,2021-03-31
317103,JAKARTA PUSAT,KEMAYORAN,9216,67,8917,160,72,139,2021-03-31
310102,KAB.ADM.KEP.SERIBU,KEP. SERIBU SELATAN,239,0,236,3,0,0,2021-03-31
317206,JAKARTA UTARA,KELAPA GADING,5429,68,5230,86,45,113,2021-03-31
317305,JAKARTA BARAT,KEBON JERUK,9886,88,9546,172,80,168,2021-03-31
317405,JAKARTA SELATAN,KEBAYORAN LAMA,8758,90,8438,161,69,159,2021-03-31
317505,JAKARTA TIMUR,PASAR REBO,7716,79,7406,135,96,175,2021-04-01
317501,JAKARTA TIMUR,MATRAMAN,6051,56,5820,125,50,106,2021-04-01
317106,JAKARTA PUSAT,MENTENG,3037,36,2928,62,11,47,2021-04-01
317205,JAKARTA UTARA,PADEMANGAN,4568,51,4386,78,53,104,2021-04-01
317307,JAKARTA BARAT,PALMERAH,7325,60,7051,158,56,116,2021-04-01
317408,JAKARTA SELATAN,PANCORAN,5939,43,5723,95,78,121,2021-04-01
317404,JAKARTA SELATAN,PASAR MINGGU,10668,76,10276,188,128,204,2021-04-01
317403,JAKARTA SELATAN,MAMPANG PRAPATAN,5528,28,5337,95,68,96,2021-04-01
317201,JAKARTA UTARA,PENJARINGAN,7305,126,7001,101,77,203,2021-04-01
111111,Luar DKI & Proses Update,Luar DKI & Proses Update,143008,137,141294,1273,304,441,2021-04-01
317502,JAKARTA TIMUR,PULO GADUNG,9191,86,8846,163,96,182,2021-04-01
317102,JAKARTA PUSAT,SAWAH BESAR,3824,49,3679,70,26,75,2021-04-01
317104,JAKARTA PUSAT,SENEN,4252,38,4080,87,47,85,2021-04-01
317402,JAKARTA SELATAN,SETIA BUDI,5038,58,4843,87,50,108,2021-04-01
317303,JAKARTA BARAT,TAMAN SARI,3653,44,3536,54,19,63,2021-04-01
317304,JAKARTA BARAT,TAMBORA,5478,74,5266,115,23,97,2021-04-01
317107,JAKARTA PUSAT,TANAH ABANG,5562,84,5349,109,20,104,2021-04-01
317202,JAKARTA UTARA,TANJUNG PRIOK,11819,131,11374,201,113,244,2021-04-01
317508,JAKARTA TIMUR,MAKASAR,8230,84,7931,134,81,165,2021-04-01
317401,JAKARTA SELATAN,TEBET,7378,62,7086,138,92,154,2021-04-01
317410,JAKARTA SELATAN,PESANGGRAHAN,7060,42,6843,107,68,110,2021-04-01
317504,JAKARTA TIMUR,KRAMAT JATI,9493,96,9070,175,152,248,2021-04-01
317306,JAKARTA BARAT,KALI DERES,7422,83,7106,135,98,181,2021-04-01
310101,KAB.ADM.KEP.SERIBU,KEP. SERIBU UTARA,306,0,300,4,2,2,2021-04-01
317506,JAKARTA TIMUR,CAKUNG,11120,70,10800,192,58,128,2021-04-01
317105,JAKARTA PUSAT,CEMPAKA PUTIH,4752,72,4582,71,27,99,2021-04-01
317406,JAKARTA SELATAN,CILANDAK,7553,74,7273,117,89,163,2021-04-01
317204,JAKARTA UTARA,CILINCING,7464,92,7166,143,63,155,2021-04-01
317510,JAKARTA TIMUR,CIPAYUNG,9745,94,9455,109,87,181,2021-04-01
317509,JAKARTA TIMUR,CIRACAS,8943,101,8604,151,87,188,2021-04-01
317507,JAKARTA TIMUR,DUREN SAWIT,13350,129,12807,274,140,269,2021-04-01
317101,JAKARTA PUSAT,GAMBIR,3576,31,3462,57,26,57,2021-04-01
317203,JAKARTA UTARA,KOJA,8095,74,7831,144,46,120,2021-04-01
317409,JAKARTA SELATAN,JAGAKARSA,10899,93,10438,178,190,283,2021-04-01
317302,JAKARTA BARAT,GROGOL PETAMBURAN,7794,120,7438,151,85,205,2021-04-01
317108,JAKARTA PUSAT,JOHAR BARU,3999,20,3834,97,48,68,2021-04-01
317407,JAKARTA SELATAN,KEBAYORAN BARU,5903,48,5698,91,66,114,2021-04-01
317405,JAKARTA SELATAN,KEBAYORAN LAMA,8812,85,8470,161,96,181,2021-04-01
317305,JAKARTA BARAT,KEBON JERUK,9919,81,9583,172,83,164,2021-04-01
317206,JAKARTA UTARA,KELAPA GADING,5454,64,5244,87,59,123,2021-04-01
317103,JAKARTA PUSAT,KEMAYORAN,9233,60,8938,160,75,135,2021-04-01
317308,JAKARTA BARAT,KEMBANGAN,8544,76,8317,109,42,118,2021-04-01
310102,KAB.ADM.KEP.SERIBU,KEP. SERIBU SELATAN,239,0,236,3,0,0,2021-04-01
317503,JAKARTA TIMUR,JATINEGARA,8454,62,8120,157,115,177,2021-04-01
317301,JAKARTA BARAT,CENGKARENG,12291,130,11787,244,130,260,2021-04-01
317105,JAKARTA PUSAT,CEMPAKA PUTIH,4760,71,4591,71,27,98,2021-04-02
111111,Luar DKI & Proses Update,Luar DKI & Proses Update,143008,137,141294,1273,304,441,2021-04-02
317506,JAKARTA TIMUR,CAKUNG,11152,79,10822,192,59,138,2021-04-02
317301,JAKARTA BARAT,CENGKARENG,12332,133,11831,244,124,257,2021-04-02
317401,JAKARTA SELATAN,TEBET,7397,64,7109,138,86,150,2021-04-02
317403,JAKARTA SELATAN,MAMPANG PRAPATAN,5532,30,5349,95,58,88,2021-04-02
317501,JAKARTA TIMUR,MATRAMAN,6064,59,5825,125,55,114,2021-04-02
317106,JAKARTA PUSAT,MENTENG,3040,30,2938,62,10,40,2021-04-02
317205,JAKARTA UTARA,PADEMANGAN,4581,52,4396,80,53,105,2021-04-02
317307,JAKARTA BARAT,PALMERAH,7345,64,7074,158,49,113,2021-04-02
317408,JAKARTA SELATAN,PANCORAN,5972,44,5757,95,76,120,2021-04-02
317404,JAKARTA SELATAN,PASAR MINGGU,10704,76,10320,188,120,196,2021-04-02
317201,JAKARTA UTARA,PENJARINGAN,7335,117,7030,101,87,204,2021-04-02
317410,JAKARTA SELATAN,PESANGGRAHAN,7071,42,6859,107,63,105,2021-04-02
317502,JAKARTA TIMUR,PULO GADUNG,9227,89,8884,164,90,179,2021-04-02
317102,JAKARTA PUSAT,SAWAH BESAR,3832,49,3685,70,28,77,2021-04-02
317104,JAKARTA PUSAT,SENEN,4261,34,4094,87,46,80,2021-04-02
317402,JAKARTA SELATAN,SETIA BUDI,5068,64,4863,87,54,118,2021-04-02
317303,JAKARTA BARAT,TAMAN SARI,3655,40,3543,54,18,58,2021-04-02
317304,JAKARTA BARAT,TAMBORA,5489,73,5278,115,23,96,2021-04-02
317107,JAKARTA PUSAT,TANAH ABANG,5566,78,5364,109,15,93,2021-04-02
317202,JAKARTA UTARA,TANJUNG PRIOK,11849,133,11401,201,114,247,2021-04-02
317508,JAKARTA TIMUR,MAKASAR,8244,88,7956,134,66,154,2021-04-02
317504,JAKARTA TIMUR,KRAMAT JATI,9524,88,9137,175,124,212,2021-04-02
317505,JAKARTA TIMUR,PASAR REBO,7746,70,7444,135,97,167,2021-04-02
310101,KAB.ADM.KEP.SERIBU,KEP. SERIBU UTARA,306,0,301,4,1,1,2021-04-02
317203,JAKARTA UTARA,KOJA,8117,76,7854,144,43,119,2021-04-02
317204,JAKARTA UTARA,CILINCING,7484,95,7192,144,53,148,2021-04-02
317510,JAKARTA TIMUR,CIPAYUNG,9773,78,9489,110,96,174,2021-04-02
317509,JAKARTA TIMUR,CIRACAS,8973,98,8630,151,94,192,2021-04-02
317507,JAKARTA TIMUR,DUREN SAWIT,13396,130,12857,274,135,265,2021-04-02
317101,JAKARTA PUSAT,GAMBIR,3587,28,3472,57,30,58,2021-04-02
317302,JAKARTA BARAT,GROGOL PETAMBURAN,7830,118,7483,151,78,196,2021-04-02
317409,JAKARTA SELATAN,JAGAKARSA,10914,79,10479,178,178,257,2021-04-02
317503,JAKARTA TIMUR,JATINEGARA,8489,63,8174,157,95,158,2021-04-02
317406,JAKARTA SELATAN,CILANDAK,7569,63,7307,117,82,145,2021-04-02
310102,KAB.ADM.KEP.SERIBU,KEP. SERIBU SELATAN,239,0,236,3,0,0,2021-04-02
317306,JAKARTA BARAT,KALI DERES,7494,96,7160,135,103,199,2021-04-02
317407,JAKARTA SELATAN,KEBAYORAN BARU,5925,49,5729,91,56,105,2021-04-02
317405,JAKARTA SELATAN,KEBAYORAN LAMA,8838,85,8517,161,75,160,2021-04-02
317305,JAKARTA BARAT,KEBON JERUK,9939,83,9608,172,76,159,2021-04-02
317206,JAKARTA UTARA,KELAPA GADING,5479,63,5262,87,67,130,2021-04-02
317103,JAKARTA PUSAT,KEMAYORAN,9246,54,8961,160,71,125,2021-04-02
317308,JAKARTA BARAT,KEMBANGAN,8574,75,8337,109,53,128,2021-04-02
317108,JAKARTA PUSAT,JOHAR BARU,4009,21,3844,97,47,68,2021-04-02
317206,JAKARTA UTARA,KELAPA GADING,5487,64,5272,87,64,128,2021-04-03
317103,JAKARTA PUSAT,KEMAYORAN,9260,56,8981,160,63,119,2021-04-03
317308,JAKARTA BARAT,KEMBANGAN,8577,67,8354,110,46,113,2021-04-03
317508,JAKARTA TIMUR,MAKASAR,8257,86,7966,134,71,157,2021-04-03
310101,KAB.ADM.KEP.SERIBU,KEP. SERIBU UTARA,306,0,302,4,0,0,2021-04-03
317203,JAKARTA UTARA,KOJA,8127,75,7864,144,44,119,2021-04-03
317305,JAKARTA BARAT,KEBON JERUK,9950,78,9641,172,59,137,2021-04-03
317301,JAKARTA BARAT,CENGKARENG,12350,117,11879,244,110,227,2021-04-03
310102,KAB.ADM.KEP.SERIBU,KEP. SERIBU SELATAN,239,0,236,3,0,0,2021-04-03
317405,JAKARTA SELATAN,KEBAYORAN LAMA,8865,81,8535,161,88,169,2021-04-03
317409,JAKARTA SELATAN,JAGAKARSA,10957,67,10537,178,175,242,2021-04-03
317306,JAKARTA BARAT,KALI DERES,7517,93,7189,135,100,193,2021-04-03
317108,JAKARTA PUSAT,JOHAR BARU,4016,19,3862,97,38,57,2021-04-03
317503,JAKARTA TIMUR,JATINEGARA,8496,61,8200,158,77,138,2021-04-03
317302,JAKARTA BARAT,GROGOL PETAMBURAN,7850,99,7525,151,75,174,2021-04-03
317101,JAKARTA PUSAT,GAMBIR,3599,28,3492,57,22,50,2021-04-03
317507,JAKARTA TIMUR,DUREN SAWIT,13438,132,12904,274,128,260,2021-04-03
317509,JAKARTA TIMUR,CIRACAS,8989,101,8649,151,88,189,2021-04-03
317510,JAKARTA TIMUR,CIPAYUNG,9801,79,9513,110,99,178,2021-04-03
317407,JAKARTA SELATAN,KEBAYORAN BARU,5938,41,5754,91,52,93,2021-04-03
317403,JAKARTA SELATAN,MAMPANG PRAPATAN,5556,28,5367,95,66,94,2021-04-03
317504,JAKARTA TIMUR,KRAMAT JATI,9545,81,9183,175,106,187,2021-04-03
317106,JAKARTA PUSAT,MENTENG,3045,29,2943,62,11,40,2021-04-03
111111,Luar DKI & Proses Update,Luar DKI & Proses Update,143008,137,141294,1273,304,441,2021-04-03
317204,JAKARTA UTARA,CILINCING,7491,97,7197,144,53,150,2021-04-03
317506,JAKARTA TIMUR,CAKUNG,11158,76,10834,192,56,132,2021-04-03
317105,JAKARTA PUSAT,CEMPAKA PUTIH,4769,70,4605,71,23,93,2021-04-03
317401,JAKARTA SELATAN,TEBET,7405,61,7144,138,62,123,2021-04-03
317202,JAKARTA UTARA,TANJUNG PRIOK,11869,134,11440,201,94,228,2021-04-03
317107,JAKARTA PUSAT,TANAH ABANG,5573,69,5379,109,16,85,2021-04-03
317304,JAKARTA BARAT,TAMBORA,5490,58,5296,115,21,79,2021-04-03
317303,JAKARTA BARAT,TAMAN SARI,3664,31,3559,54,20,51,2021-04-03
317501,JAKARTA TIMUR,MATRAMAN,6067,54,5836,125,52,106,2021-04-03
317402,JAKARTA SELATAN,SETIA BUDI,5080,67,4872,87,54,121,2021-04-03
317102,JAKARTA PUSAT,SAWAH BESAR,3841,44,3706,70,21,65,2021-04-03
317502,JAKARTA TIMUR,PULO GADUNG,9251,85,8893,165,108,193,2021-04-03
317410,JAKARTA SELATAN,PESANGGRAHAN,7086,37,6878,107,64,101,2021-04-03
317201,JAKARTA UTARA,PENJARINGAN,7348,116,7058,101,73,189,2021-04-03
317505,JAKARTA TIMUR,PASAR REBO,7766,68,7468,135,95,163,2021-04-03
317404,JAKARTA SELATAN,PASAR MINGGU,10715,66,10349,188,112,178,2021-04-03
317408,JAKARTA SELATAN,PANCORAN,5983,45,5777,96,65,110,2021-04-03
317307,JAKARTA BARAT,PALMERAH,7357,64,7094,158,41,105,2021-04-03
317205,JAKARTA UTARA,PADEMANGAN,4600,51,4403,80,66,117,2021-04-03
317104,JAKARTA PUSAT,SENEN,4277,31,4109,87,50,81,2021-04-03
317406,JAKARTA SELATAN,CILANDAK,7589,58,7325,117,89,147,2021-04-03
317509,JAKARTA TIMUR,CIRACAS,8991,91,8664,152,84,175,2021-04-04
317506,JAKARTA TIMUR,CAKUNG,11166,72,10848,192,54,126,2021-04-04
317204,JAKARTA UTARA,CILINCING,7514,98,7228,144,44,142,2021-04-04
317508,JAKARTA TIMUR,MAKASAR,8267,82,7975,134,76,158,2021-04-04
317504,JAKARTA TIMUR,KRAMAT JATI,9557,80,9210,175,92,172,2021-04-04
317203,JAKARTA UTARA,KOJA,8144,69,7885,144,46,115,2021-04-04
310101,KAB.ADM.KEP.SERIBU,KEP. SERIBU UTARA,306,0,302,4,0,0,2021-04-04
310102,KAB.ADM.KEP.SERIBU,KEP. SERIBU SELATAN,239,0,236,3,0,0,2021-04-04
317308,JAKARTA BARAT,KEMBANGAN,8585,63,8377,110,35,98,2021-04-04
317103,JAKARTA PUSAT,KEMAYORAN,9273,56,9008,161,48,104,2021-04-04
317206,JAKARTA UTARA,KELAPA GADING,5518,72,5287,87,72,144,2021-04-04
317305,JAKARTA BARAT,KEBON JERUK,9968,87,9662,172,47,134,2021-04-04
317405,JAKARTA SELATAN,KEBAYORAN LAMA,8874,80,8551,161,82,162,2021-04-04
317407,JAKARTA SELATAN,KEBAYORAN BARU,5953,44,5764,91,54,98,2021-04-04
317306,JAKARTA BARAT,KALI DERES,7540,87,7240,135,78,165,2021-04-04
317108,JAKARTA PUSAT,JOHAR BARU,4026,28,3866,97,35,63,2021-04-04
317503,JAKARTA TIMUR,JATINEGARA,8508,64,8219,161,64,128,2021-04-04
317409,JAKARTA SELATAN,JAGAKARSA,10971,74,10556,178,163,237,2021-04-04
317302,JAKARTA BARAT,GROGOL PETAMBURAN,7865,86,7561,152,66,152,2021-04-04
317101,JAKARTA PUSAT,GAMBIR,3603,28,3498,57,20,48,2021-04-04
317507,JAKARTA TIMUR,DUREN SAWIT,13453,130,12929,274,120,250,2021-04-04
317501,JAKARTA TIMUR,MATRAMAN,6072,51,5864,125,32,83,2021-04-04
317510,JAKARTA TIMUR,CIPAYUNG,9807,76,9532,110,89,165,2021-04-04
317106,JAKARTA PUSAT,MENTENG,3051,25,2955,62,9,34,2021-04-04
317307,JAKARTA BARAT,PALMERAH,7368,68,7112,158,30,98,2021-04-04
317105,JAKARTA PUSAT,CEMPAKA PUTIH,4779,60,4629,71,19,79,2021-04-04
317301,JAKARTA BARAT,CENGKARENG,12365,106,11925,244,90,196,2021-04-04
317406,JAKARTA SELATAN,CILANDAK,7595,57,7345,118,75,132,2021-04-04
111111,Luar DKI & Proses Update,Luar DKI & Proses Update,143008,137,141294,1273,304,441,2021-04-04
317401,JAKARTA SELATAN,TEBET,7420,65,7164,138,53,118,2021-04-04
317202,JAKARTA UTARA,TANJUNG PRIOK,11900,134,11458,201,107,241,2021-04-04
317107,JAKARTA PUSAT,TANAH ABANG,5580,66,5396,110,8,74,2021-04-04
317304,JAKARTA BARAT,TAMBORA,5498,60,5305,115,18,78,2021-04-04
317205,JAKARTA UTARA,PADEMANGAN,4617,52,4429,80,56,108,2021-04-04
317303,JAKARTA BARAT,TAMAN SARI,3668,31,3568,54,15,46,2021-04-04
317104,JAKARTA PUSAT,SENEN,4280,28,4116,87,49,77,2021-04-04
317102,JAKARTA PUSAT,SAWAH BESAR,3847,46,3713,70,18,64,2021-04-04
317502,JAKARTA TIMUR,PULO GADUNG,9263,87,8935,165,76,163,2021-04-04
317410,JAKARTA SELATAN,PESANGGRAHAN,7091,36,6893,107,55,91,2021-04-04
317201,JAKARTA UTARA,PENJARINGAN,7381,111,7093,102,75,186,2021-04-04
317505,JAKARTA TIMUR,PASAR REBO,7777,61,7492,135,89,150,2021-04-04
317404,JAKARTA SELATAN,PASAR MINGGU,10739,72,10377,188,102,174,2021-04-04
317408,JAKARTA SELATAN,PANCORAN,5991,46,5796,96,53,99,2021-04-04
317402,JAKARTA SELATAN,SETIA BUDI,5087,70,4883,88,46,116,2021-04-04
317403,JAKARTA SELATAN,MAMPANG PRAPATAN,5560,28,5378,96,58,86,2021-04-04
111111,Luar DKI & Proses Update,Luar DKI & Proses Update,143008,137,141294,1273,304,441,2021-04-05
317501,JAKARTA TIMUR,MATRAMAN,6077,45,5874,126,32,77,2021-04-05
317202,JAKARTA UTARA,TANJUNG PRIOK,11917,125,11478,201,113,238,2021-04-05
317203,JAKARTA UTARA,KOJA,8150,66,7891,144,49,115,2021-04-05
317504,JAKARTA TIMUR,KRAMAT JATI,9567,77,9223,175,92,169,2021-04-05
317508,JAKARTA TIMUR,MAKASAR,8286,86,8002,134,64,150,2021-04-05
317403,JAKARTA SELATAN,MAMPANG PRAPATAN,5567,28,5381,96,62,90,2021-04-05
317106,JAKARTA PUSAT,MENTENG,3054,25,2954,63,12,37,2021-04-05
317205,JAKARTA UTARA,PADEMANGAN,4618,42,4439,80,57,99,2021-04-05
317307,JAKARTA BARAT,PALMERAH,7371,72,7121,158,20,92,2021-04-05
317408,JAKARTA SELATAN,PANCORAN,6009,49,5806,96,58,107,2021-04-05
310101,KAB.ADM.KEP.SERIBU,KEP. SERIBU UTARA,306,0,302,4,0,0,2021-04-05
317404,JAKARTA SELATAN,PASAR MINGGU,10767,75,10391,188,113,188,2021-04-05
317201,JAKARTA UTARA,PENJARINGAN,7388,109,7102,102,75,184,2021-04-05
317410,JAKARTA SELATAN,PESANGGRAHAN,7097,34,6899,107,57,91,2021-04-05
317502,JAKARTA TIMUR,PULO GADUNG,9265,83,8944,166,72,155,2021-04-05
317102,JAKARTA PUSAT,SAWAH BESAR,3854,51,3720,70,13,64,2021-04-05
317104,JAKARTA PUSAT,SENEN,4284,30,4132,87,35,65,2021-04-05
317402,JAKARTA SELATAN,SETIA BUDI,5094,73,4888,88,45,118,2021-04-05
317303,JAKARTA BARAT,TAMAN SARI,3670,32,3572,54,12,44,2021-04-05
317304,JAKARTA BARAT,TAMBORA,5506,64,5307,115,20,84,2021-04-05
317505,JAKARTA TIMUR,PASAR REBO,7779,56,7502,135,86,142,2021-04-05
317107,JAKARTA PUSAT,TANAH ABANG,5586,61,5403,110,12,73,2021-04-05
310102,KAB.ADM.KEP.SERIBU,KEP. SERIBU SELATAN,239,0,236,3,0,0,2021-04-05
317103,JAKARTA PUSAT,KEMAYORAN,9279,57,9028,161,33,90,2021-04-05
317506,JAKARTA TIMUR,CAKUNG,11174,67,10859,192,56,123,2021-04-05
317105,JAKARTA PUSAT,CEMPAKA PUTIH,4783,62,4633,71,17,79,2021-04-05
317301,JAKARTA BARAT,CENGKARENG,12378,115,11938,244,81,196,2021-04-05
317406,JAKARTA SELATAN,CILANDAK,7611,62,7353,118,78,140,2021-04-05
317204,JAKARTA UTARA,CILINCING,7519,92,7241,144,42,134,2021-04-05
317510,JAKARTA TIMUR,CIPAYUNG,9813,79,9539,110,85,164,2021-04-05
317509,JAKARTA TIMUR,CIRACAS,9000,84,8683,152,81,165,2021-04-05
317507,JAKARTA TIMUR,DUREN SAWIT,13465,130,12939,275,121,251,2021-04-05
317101,JAKARTA PUSAT,GAMBIR,3605,27,3502,57,19,46,2021-04-05
317302,JAKARTA BARAT,GROGOL PETAMBURAN,7874,86,7576,152,60,146,2021-04-05
317409,JAKARTA SELATAN,JAGAKARSA,10995,75,10572,178,170,245,2021-04-05
317503,JAKARTA TIMUR,JATINEGARA,8512,60,8228,162,62,122,2021-04-05
317108,JAKARTA PUSAT,JOHAR BARU,4029,32,3889,97,11,43,2021-04-05
317306,JAKARTA BARAT,KALI DERES,7553,91,7259,135,68,159,2021-04-05
317407,JAKARTA SELATAN,KEBAYORAN BARU,5963,43,5776,92,52,95,2021-04-05
317405,JAKARTA SELATAN,KEBAYORAN LAMA,8884,74,8561,162,87,161,2021-04-05
317305,JAKARTA BARAT,KEBON JERUK,9977,87,9673,172,45,132,2021-04-05
317206,JAKARTA UTARA,KELAPA GADING,5532,65,5305,87,75,140,2021-04-05
317308,JAKARTA BARAT,KEMBANGAN,8591,66,8385,110,30,96,2021-04-05
317401,JAKARTA SELATAN,TEBET,7430,65,7169,138,58,123,2021-04-05
111111,Luar DKI & Proses Update,Luar DKI & Proses Update,143008,137,141294,1273,304,441,2021-04-06
317202,JAKARTA UTARA,TANJUNG PRIOK,11935,129,11493,201,112,241,2021-04-06
317506,JAKARTA TIMUR,CAKUNG,11186,68,10879,192,47,115,2021-04-06
317508,JAKARTA TIMUR,MAKASAR,8308,90,8009,135,74,164,2021-04-06
317403,JAKARTA SELATAN,MAMPANG PRAPATAN,5581,37,5384,96,64,101,2021-04-06
317501,JAKARTA TIMUR,MATRAMAN,6086,44,5891,127,24,68,2021-04-06
317106,JAKARTA PUSAT,MENTENG,3058,24,2957,63,14,38,2021-04-06
317205,JAKARTA UTARA,PADEMANGAN,4639,50,4452,80,57,107,2021-04-06
317307,JAKARTA BARAT,PALMERAH,7395,87,7123,159,26,113,2021-04-06
317408,JAKARTA SELATAN,PANCORAN,6031,57,5811,96,67,124,2021-04-06
317404,JAKARTA SELATAN,PASAR MINGGU,10787,75,10404,189,119,194,2021-04-06
317504,JAKARTA TIMUR,KRAMAT JATI,9576,72,9238,176,90,162,2021-04-06
317505,JAKARTA TIMUR,PASAR REBO,7794,61,7507,136,90,151,2021-04-06
317410,JAKARTA SELATAN,PESANGGRAHAN,7120,48,6904,107,61,109,2021-04-06
317502,JAKARTA TIMUR,PULO GADUNG,9282,77,8979,166,60,137,2021-04-06
317102,JAKARTA PUSAT,SAWAH BESAR,3859,46,3727,70,16,62,2021-04-06
317104,JAKARTA PUSAT,SENEN,4287,27,4135,87,38,65,2021-04-06
317402,JAKARTA SELATAN,SETIA BUDI,5111,78,4907,88,38,116,2021-04-06
317303,JAKARTA BARAT,TAMAN SARI,3677,29,3576,54,18,47,2021-04-06
317304,JAKARTA BARAT,TAMBORA,5519,61,5314,115,29,90,2021-04-06
317107,JAKARTA PUSAT,TANAH ABANG,5591,59,5407,110,15,74,2021-04-06
317201,JAKARTA UTARA,PENJARINGAN,7416,116,7119,102,79,195,2021-04-06
317203,JAKARTA UTARA,KOJA,8165,68,7908,144,45,113,2021-04-06
310101,KAB.ADM.KEP.SERIBU,KEP. SERIBU UTARA,306,0,302,4,0,0,2021-04-06
310102,KAB.ADM.KEP.SERIBU,KEP. SERIBU SELATAN,239,0,236,3,0,0,2021-04-06
317105,JAKARTA PUSAT,CEMPAKA PUTIH,4787,51,4647,71,18,69,2021-04-06
317301,JAKARTA BARAT,CENGKARENG,12411,125,11951,244,91,216,2021-04-06
317406,JAKARTA SELATAN,CILANDAK,7635,71,7356,118,90,161,2021-04-06
317204,JAKARTA UTARA,CILINCING,7530,86,7266,145,33,119,2021-04-06
317510,JAKARTA TIMUR,CIPAYUNG,9828,74,9552,110,92,166,2021-04-06
317509,JAKARTA TIMUR,CIRACAS,9018,92,8693,152,81,173,2021-04-06
317507,JAKARTA TIMUR,DUREN SAWIT,13487,127,12987,275,98,225,2021-04-06
317101,JAKARTA PUSAT,GAMBIR,3612,27,3504,57,24,51,2021-04-06
317302,JAKARTA BARAT,GROGOL PETAMBURAN,7889,85,7584,153,67,152,2021-04-06
317409,JAKARTA SELATAN,JAGAKARSA,11021,93,10574,178,176,269,2021-04-06
317503,JAKARTA TIMUR,JATINEGARA,8532,63,8250,162,57,120,2021-04-06
317108,JAKARTA PUSAT,JOHAR BARU,4032,30,3893,97,12,42,2021-04-06
317306,JAKARTA BARAT,KALI DERES,7572,91,7268,136,77,168,2021-04-06
317407,JAKARTA SELATAN,KEBAYORAN BARU,5972,42,5779,92,59,101,2021-04-06
317405,JAKARTA SELATAN,KEBAYORAN LAMA,8907,74,8572,162,99,173,2021-04-06
317305,JAKARTA BARAT,KEBON JERUK,10021,112,9681,172,56,168,2021-04-06
317206,JAKARTA UTARA,KELAPA GADING,5551,70,5329,87,65,135,2021-04-06
317103,JAKARTA PUSAT,KEMAYORAN,9297,67,9032,161,37,104,2021-04-06
317308,JAKARTA BARAT,KEMBANGAN,8617,81,8389,112,35,116,2021-04-06
317401,JAKARTA SELATAN,TEBET,7451,73,7189,139,50,123,2021-04-06
111111,Luar DKI & Proses Update,Luar DKI & Proses Update,143008,137,141294,1273,304,441,2021-04-07
317205,JAKARTA UTARA,PADEMANGAN,4656,53,4461,80,62,115,2021-04-07
317505,JAKARTA TIMUR,PASAR REBO,7808,62,7525,138,83,145,2021-04-07
317504,JAKARTA TIMUR,KRAMAT JATI,9623,74,9279,176,94,168,2021-04-07
317508,JAKARTA TIMUR,MAKASAR,8339,94,8035,135,75,169,2021-04-07
317501,JAKARTA TIMUR,MATRAMAN,6114,43,5899,127,45,88,2021-04-07
317106,JAKARTA PUSAT,MENTENG,3067,30,2958,63,16,46,2021-04-07
317307,JAKARTA BARAT,PALMERAH,7406,83,7130,162,31,114,2021-04-07
317408,JAKARTA SELATAN,PANCORAN,6067,61,5814,97,95,156,2021-04-07
317404,JAKARTA SELATAN,PASAR MINGGU,10816,78,10412,190,136,214,2021-04-07
317201,JAKARTA UTARA,PENJARINGAN,7464,137,7138,102,87,224,2021-04-07
317203,JAKARTA UTARA,KOJA,8185,64,7920,144,57,121,2021-04-07
317410,JAKARTA SELATAN,PESANGGRAHAN,7140,54,6910,108,68,122,2021-04-07
317102,JAKARTA PUSAT,SAWAH BESAR,3866,46,3733,71,16,62,2021-04-07
317104,JAKARTA PUSAT,SENEN,4309,31,4139,87,52,83,2021-04-07
317402,JAKARTA SELATAN,SETIA BUDI,5130,82,4911,88,49,131,2021-04-07
317303,JAKARTA BARAT,TAMAN SARI,3684,27,3583,54,20,47,2021-04-07
317304,JAKARTA BARAT,TAMBORA,5530,62,5325,115,28,90,2021-04-07
317107,JAKARTA PUSAT,TANAH ABANG,5605,71,5409,110,15,86,2021-04-07
317202,JAKARTA UTARA,TANJUNG PRIOK,11968,135,11508,202,123,258,2021-04-07
317401,JAKARTA SELATAN,TEBET,7481,77,7191,139,74,151,2021-04-07
317502,JAKARTA TIMUR,PULO GADUNG,9341,86,8995,166,94,180,2021-04-07
310101,KAB.ADM.KEP.SERIBU,KEP. SERIBU UTARA,306,0,302,4,0,0,2021-04-07
317403,JAKARTA SELATAN,MAMPANG PRAPATAN,5590,37,5398,96,59,96,2021-04-07
317308,JAKARTA BARAT,KEMBANGAN,8634,80,8400,113,41,121,2021-04-07
317506,JAKARTA TIMUR,CAKUNG,11233,78,10890,193,72,150,2021-04-07
317105,JAKARTA PUSAT,CEMPAKA PUTIH,4792,54,4648,72,18,72,2021-04-07
317301,JAKARTA BARAT,CENGKARENG,12457,139,11970,244,104,243,2021-04-07
317406,JAKARTA SELATAN,CILANDAK,7670,74,7376,118,102,176,2021-04-07
317204,JAKARTA UTARA,CILINCING,7544,84,7273,146,41,125,2021-04-07
317510,JAKARTA TIMUR,CIPAYUNG,9866,74,9579,110,103,177,2021-04-07
310102,KAB.ADM.KEP.SERIBU,KEP. SERIBU SELATAN,239,0,236,3,0,0,2021-04-07
317507,JAKARTA TIMUR,DUREN SAWIT,13540,139,13002,275,124,263,2021-04-07
317101,JAKARTA PUSAT,GAMBIR,3613,24,3507,58,24,48,2021-04-07
317302,JAKARTA BARAT,GROGOL PETAMBURAN,7913,85,7593,153,82,167,2021-04-07
317509,JAKARTA TIMUR,CIRACAS,9062,101,8730,153,78,179,2021-04-07
317103,JAKARTA PUSAT,KEMAYORAN,9333,92,9037,161,43,135,2021-04-07
317503,JAKARTA TIMUR,JATINEGARA,8554,70,8253,162,69,139,2021-04-07
317108,JAKARTA PUSAT,JOHAR BARU,4048,30,3894,97,27,57,2021-04-07
317306,JAKARTA BARAT,KALI DERES,7629,96,7296,136,101,197,2021-04-07
317407,JAKARTA SELATAN,KEBAYORAN BARU,5996,46,5784,92,74,120,2021-04-07
317405,JAKARTA SELATAN,KEBAYORAN LAMA,8921,72,8583,162,104,176,2021-04-07
317305,JAKARTA BARAT,KEBON JERUK,10048,114,9697,173,64,178,2021-04-07
317206,JAKARTA UTARA,KELAPA GADING,5581,81,5333,87,80,161,2021-04-07
317409,JAKARTA SELATAN,JAGAKARSA,11061,88,10612,178,183,271,2021-04-07
317505,JAKARTA TIMUR,PASAR REBO,7825,65,7532,138,90,155,2021-04-08
317404,JAKARTA SELATAN,PASAR MINGGU,10851,83,10435,191,142,225,2021-04-08
317408,JAKARTA SELATAN,PANCORAN,6088,59,5828,97,104,163,2021-04-08
317205,JAKARTA UTARA,PADEMANGAN,4668,56,4470,80,62,118,2021-04-08
317508,JAKARTA TIMUR,MAKASAR,8367,99,8046,135,87,186,2021-04-08
317501,JAKARTA TIMUR,MATRAMAN,6120,42,5903,127,48,90,2021-04-08
317403,JAKARTA SELATAN,MAMPANG PRAPATAN,5597,37,5419,96,45,82,2021-04-08
317201,JAKARTA UTARA,PENJARINGAN,7497,136,7162,103,96,232,2021-04-08
317106,JAKARTA PUSAT,MENTENG,3080,33,2966,63,18,51,2021-04-08
317410,JAKARTA SELATAN,PESANGGRAHAN,7157,51,6939,108,59,110,2021-04-08
317307,JAKARTA BARAT,PALMERAH,7437,94,7135,162,46,140,2021-04-08
317102,JAKARTA PUSAT,SAWAH BESAR,3871,41,3740,72,18,59,2021-04-08
317104,JAKARTA PUSAT,SENEN,4325,35,4142,87,61,96,2021-04-08
317402,JAKARTA SELATAN,SETIA BUDI,5156,83,4928,88,57,140,2021-04-08
317303,JAKARTA BARAT,TAMAN SARI,3694,31,3584,54,25,56,2021-04-08
317304,JAKARTA BARAT,TAMBORA,5545,65,5331,117,32,97,2021-04-08
317107,JAKARTA PUSAT,TANAH ABANG,5618,67,5423,110,18,85,2021-04-08
317202,JAKARTA UTARA,TANJUNG PRIOK,11995,142,11536,203,114,256,2021-04-08
317401,JAKARTA SELATAN,TEBET,7501,74,7208,140,79,153,2021-04-08
111111,Luar DKI & Proses Update,Luar DKI & Proses Update,143008,137,141294,1273,304,441,2021-04-08
317504,JAKARTA TIMUR,KRAMAT JATI,9652,80,9282,176,114,194,2021-04-08
317502,JAKARTA TIMUR,PULO GADUNG,9365,86,9003,166,110,196,2021-04-08
317203,JAKARTA UTARA,KOJA,8198,61,7925,144,68,129,2021-04-08
317204,JAKARTA UTARA,CILINCING,7567,77,7291,147,52,129,2021-04-08
310102,KAB.ADM.KEP.SERIBU,KEP. SERIBU SELATAN,239,0,236,3,0,0,2021-04-08
317506,JAKARTA TIMUR,CAKUNG,11251,78,10898,195,80,158,2021-04-08
317105,JAKARTA PUSAT,CEMPAKA PUTIH,4805,47,4669,72,17,64,2021-04-08
317301,JAKARTA BARAT,CENGKARENG,12489,126,12007,244,112,238,2021-04-08
317406,JAKARTA SELATAN,CILANDAK,7704,78,7407,118,101,179,2021-04-08
310101,KAB.ADM.KEP.SERIBU,KEP. SERIBU UTARA,306,0,302,4,0,0,2021-04-08
317509,JAKARTA TIMUR,CIRACAS,9088,101,8740,154,93,194,2021-04-08
317507,JAKARTA TIMUR,DUREN SAWIT,13581,134,13026,275,146,280,2021-04-08
317101,JAKARTA PUSAT,GAMBIR,3624,25,3518,58,23,48,2021-04-08
317302,JAKARTA BARAT,GROGOL PETAMBURAN,7935,85,7608,153,89,174,2021-04-08
317510,JAKARTA TIMUR,CIPAYUNG,9889,74,9587,110,118,192,2021-04-08
317503,JAKARTA TIMUR,JATINEGARA,8581,70,8263,163,85,155,2021-04-08
317108,JAKARTA PUSAT,JOHAR BARU,4061,28,3899,97,37,65,2021-04-08
317306,JAKARTA BARAT,KALI DERES,7664,95,7323,136,110,205,2021-04-08
317407,JAKARTA SELATAN,KEBAYORAN BARU,6012,45,5791,92,84,129,2021-04-08
317405,JAKARTA SELATAN,KEBAYORAN LAMA,8943,73,8594,162,114,187,2021-04-08
317308,JAKARTA BARAT,KEMBANGAN,8656,79,8413,113,51,130,2021-04-08
317305,JAKARTA BARAT,KEBON JERUK,10072,124,9706,173,69,193,2021-04-08
317206,JAKARTA UTARA,KELAPA GADING,5596,86,5338,87,85,171,2021-04-08
317103,JAKARTA PUSAT,KEMAYORAN,9366,101,9050,162,53,154,2021-04-08
317409,JAKARTA SELATAN,JAGAKARSA,11097,88,10692,178,139,227,2021-04-08
317507,JAKARTA TIMUR,DUREN SAWIT,13627,127,13047,275,178,305,2021-04-09
317509,JAKARTA TIMUR,CIRACAS,9105,97,8754,156,98,195,2021-04-09
317510,JAKARTA TIMUR,CIPAYUNG,9913,68,9592,113,140,208,2021-04-09
317506,JAKARTA TIMUR,CAKUNG,11277,91,10905,195,86,177,2021-04-09
317406,JAKARTA SELATAN,CILANDAK,7747,72,7432,118,125,197,2021-04-09
317301,JAKARTA BARAT,CENGKARENG,12514,119,12065,244,86,205,2021-04-09
317105,JAKARTA PUSAT,CEMPAKA PUTIH,4809,47,4674,72,16,63,2021-04-09
111111,Luar DKI & Proses Update,Luar DKI & Proses Update,143008,137,141294,1273,304,441,2021-04-09
317204,JAKARTA UTARA,CILINCING,7583,79,7302,147,55,134,2021-04-09
317101,JAKARTA PUSAT,GAMBIR,3627,22,3524,58,23,45,2021-04-09
317302,JAKARTA BARAT,GROGOL PETAMBURAN,7955,83,7625,153,94,177,2021-04-09
317104,JAKARTA PUSAT,SENEN,4331,35,4154,87,55,90,2021-04-09
317205,JAKARTA UTARA,PADEMANGAN,4677,54,4483,80,60,114,2021-04-09
317307,JAKARTA BARAT,PALMERAH,7443,90,7150,162,41,131,2021-04-09
317404,JAKARTA SELATAN,PASAR MINGGU,10868,79,10472,192,125,204,2021-04-09
317505,JAKARTA TIMUR,PASAR REBO,7849,61,7539,138,111,172,2021-04-09
317201,JAKARTA UTARA,PENJARINGAN,7524,128,7183,103,110,238,2021-04-09
317410,JAKARTA SELATAN,PESANGGRAHAN,7163,48,6948,108,59,107,2021-04-09
317106,JAKARTA PUSAT,MENTENG,3087,32,2972,63,20,52,2021-04-09
317502,JAKARTA TIMUR,PULO GADUNG,9395,84,9017,166,128,212,2021-04-09
317402,JAKARTA SELATAN,SETIA BUDI,5172,83,4943,88,58,141,2021-04-09
317303,JAKARTA BARAT,TAMAN SARI,3707,33,3597,54,23,56,2021-04-09
317304,JAKARTA BARAT,TAMBORA,5560,65,5338,117,40,105,2021-04-09
317107,JAKARTA PUSAT,TANAH ABANG,5624,49,5445,111,19,68,2021-04-09
317202,JAKARTA UTARA,TANJUNG PRIOK,12018,122,11595,203,98,220,2021-04-09
317401,JAKARTA SELATAN,TEBET,7524,72,7224,140,88,160,2021-04-09
317102,JAKARTA PUSAT,SAWAH BESAR,3881,45,3745,73,18,63,2021-04-09
317501,JAKARTA TIMUR,MATRAMAN,6151,40,5910,127,74,114,2021-04-09
317408,JAKARTA SELATAN,PANCORAN,6117,65,5840,97,115,180,2021-04-09
317508,JAKARTA TIMUR,MAKASAR,8392,92,8059,136,105,197,2021-04-09
317409,JAKARTA SELATAN,JAGAKARSA,11132,84,10710,178,160,244,2021-04-09
317503,JAKARTA TIMUR,JATINEGARA,8597,69,8277,163,88,157,2021-04-09
317108,JAKARTA PUSAT,JOHAR BARU,4071,28,3903,97,43,71,2021-04-09
317306,JAKARTA BARAT,KALI DERES,7708,97,7375,136,100,197,2021-04-09
317403,JAKARTA SELATAN,MAMPANG PRAPATAN,5606,33,5429,96,48,81,2021-04-09
317405,JAKARTA SELATAN,KEBAYORAN LAMA,8964,78,8631,162,93,171,2021-04-09
317305,JAKARTA BARAT,KEBON JERUK,10098,127,9734,173,64,191,2021-04-09
317407,JAKARTA SELATAN,KEBAYORAN BARU,6030,45,5809,92,84,129,2021-04-09
317103,JAKARTA PUSAT,KEMAYORAN,9413,105,9088,162,58,163,2021-04-09
317308,JAKARTA BARAT,KEMBANGAN,8682,86,8423,113,60,146,2021-04-09
310102,KAB.ADM.KEP.SERIBU,KEP. SERIBU SELATAN,240,0,236,3,1,1,2021-04-09
310101,KAB.ADM.KEP.SERIBU,KEP. SERIBU UTARA,306,0,302,4,0,0,2021-04-09
317203,JAKARTA UTARA,KOJA,8214,54,7945,144,71,125,2021-04-09
317504,JAKARTA TIMUR,KRAMAT JATI,9682,80,9293,177,132,212,2021-04-09
317206,JAKARTA UTARA,KELAPA GADING,5608,70,5365,87,86,156,2021-04-09
317404,JAKARTA SELATAN,PASAR MINGGU,10904,75,10508,193,128,203,2021-04-10
317408,JAKARTA SELATAN,PANCORAN,6132,66,5870,97,99,165,2021-04-10
317307,JAKARTA BARAT,PALMERAH,7460,75,7179,162,44,119,2021-04-10
317205,JAKARTA UTARA,PADEMANGAN,4703,47,4508,81,67,114,2021-04-10
317403,JAKARTA SELATAN,MAMPANG PRAPATAN,5619,33,5434,96,56,89,2021-04-10
317501,JAKARTA TIMUR,MATRAMAN,6167,38,5929,128,72,110,2021-04-10
317505,JAKARTA TIMUR,PASAR REBO,7866,58,7594,138,76,134,2021-04-10
317508,JAKARTA TIMUR,MAKASAR,8408,80,8096,136,96,176,2021-04-10
317106,JAKARTA PUSAT,MENTENG,3094,31,2976,63,24,55,2021-04-10
317201,JAKARTA UTARA,PENJARINGAN,7550,111,7235,103,101,212,2021-04-10
317507,JAKARTA TIMUR,DUREN SAWIT,13667,112,13112,276,167,279,2021-04-10
317502,JAKARTA TIMUR,PULO GADUNG,9430,82,9054,166,128,210,2021-04-10
111111,Luar DKI & Proses Update,Luar DKI & Proses Update,143008,137,141294,1273,304,441,2021-04-10
317102,JAKARTA PUSAT,SAWAH BESAR,3890,38,3761,73,18,56,2021-04-10
317104,JAKARTA PUSAT,SENEN,4336,32,4167,87,50,82,2021-04-10
317402,JAKARTA SELATAN,SETIA BUDI,5195,71,4978,88,58,129,2021-04-10
317303,JAKARTA BARAT,TAMAN SARI,3722,40,3603,55,24,64,2021-04-10
317304,JAKARTA BARAT,TAMBORA,5578,61,5360,117,40,101,2021-04-10
317107,JAKARTA PUSAT,TANAH ABANG,5644,44,5455,111,34,78,2021-04-10
317202,JAKARTA UTARA,TANJUNG PRIOK,12035,108,11640,205,82,190,2021-04-10
317504,JAKARTA TIMUR,KRAMAT JATI,9710,77,9336,179,118,195,2021-04-10
317410,JAKARTA SELATAN,PESANGGRAHAN,7190,47,6961,108,74,121,2021-04-10
317203,JAKARTA UTARA,KOJA,8226,49,7960,144,73,122,2021-04-10
317510,JAKARTA TIMUR,CIPAYUNG,9949,63,9642,114,130,193,2021-04-10
310102,KAB.ADM.KEP.SERIBU,KEP. SERIBU SELATAN,240,0,236,3,1,1,2021-04-10
317506,JAKARTA TIMUR,CAKUNG,11320,89,10954,195,82,171,2021-04-10
317105,JAKARTA PUSAT,CEMPAKA PUTIH,4821,32,4697,72,20,52,2021-04-10
317301,JAKARTA BARAT,CENGKARENG,12531,92,12112,244,83,175,2021-04-10
317406,JAKARTA SELATAN,CILANDAK,7777,71,7454,118,134,205,2021-04-10
317204,JAKARTA UTARA,CILINCING,7603,65,7326,147,65,130,2021-04-10
317401,JAKARTA SELATAN,TEBET,7555,60,7257,140,98,158,2021-04-10
317509,JAKARTA TIMUR,CIRACAS,9132,91,8801,156,84,175,2021-04-10
317101,JAKARTA PUSAT,GAMBIR,3638,24,3538,59,17,41,2021-04-10
310101,KAB.ADM.KEP.SERIBU,KEP. SERIBU UTARA,307,0,302,4,1,1,2021-04-10
317302,JAKARTA BARAT,GROGOL PETAMBURAN,7976,69,7668,153,86,155,2021-04-10
317503,JAKARTA TIMUR,JATINEGARA,8620,55,8317,163,85,140,2021-04-10
317108,JAKARTA PUSAT,JOHAR BARU,4076,27,3912,97,40,67,2021-04-10
317306,JAKARTA BARAT,KALI DERES,7737,86,7417,136,98,184,2021-04-10
317407,JAKARTA SELATAN,KEBAYORAN BARU,6049,41,5832,92,84,125,2021-04-10
317405,JAKARTA SELATAN,KEBAYORAN LAMA,8989,66,8668,162,93,159,2021-04-10
317305,JAKARTA BARAT,KEBON JERUK,10118,124,9752,173,69,193,2021-04-10
317206,JAKARTA UTARA,KELAPA GADING,5629,70,5385,87,87,157,2021-04-10
317103,JAKARTA PUSAT,KEMAYORAN,9460,104,9134,163,59,163,2021-04-10
317308,JAKARTA BARAT,KEMBANGAN,8711,88,8450,114,59,147,2021-04-10
317409,JAKARTA SELATAN,JAGAKARSA,11172,87,10732,179,174,261,2021-04-10
317301,JAKARTA BARAT,CENGKARENG,12562,86,12143,244,89,175,2021-04-11
317105,JAKARTA PUSAT,CEMPAKA PUTIH,4836,26,4715,73,22,48,2021-04-11
310102,KAB.ADM.KEP.SERIBU,KEP. SERIBU SELATAN,241,0,236,3,2,2,2021-04-11
317406,JAKARTA SELATAN,CILANDAK,7799,71,7489,118,121,192,2021-04-11
317506,JAKARTA TIMUR,CAKUNG,11326,75,10975,195,81,156,2021-04-11
317204,JAKARTA UTARA,CILINCING,7607,48,7352,147,60,108,2021-04-11
317510,JAKARTA TIMUR,CIPAYUNG,9964,54,9680,114,116,170,2021-04-11
317509,JAKARTA TIMUR,CIRACAS,9154,83,8826,156,89,172,2021-04-11
317307,JAKARTA BARAT,PALMERAH,7465,63,7200,162,40,103,2021-04-11
317408,JAKARTA SELATAN,PANCORAN,6150,67,5889,97,97,164,2021-04-11
317505,JAKARTA TIMUR,PASAR REBO,7879,51,7623,138,67,118,2021-04-11
317201,JAKARTA UTARA,PENJARINGAN,7578,114,7271,103,90,204,2021-04-11
317410,JAKARTA SELATAN,PESANGGRAHAN,7197,46,6978,108,65,111,2021-04-11
317502,JAKARTA TIMUR,PULO GADUNG,9443,67,9109,167,100,167,2021-04-11
317102,JAKARTA PUSAT,SAWAH BESAR,3894,30,3774,73,17,47,2021-04-11
317104,JAKARTA PUSAT,SENEN,4343,34,4187,87,35,69,2021-04-11
317402,JAKARTA SELATAN,SETIA BUDI,5202,55,5004,88,55,110,2021-04-11
317303,JAKARTA BARAT,TAMAN SARI,3729,34,3617,55,23,57,2021-04-11
317304,JAKARTA BARAT,TAMBORA,5598,64,5377,117,40,104,2021-04-11
317107,JAKARTA PUSAT,TANAH ABANG,5650,37,5467,111,35,72,2021-04-11
317202,JAKARTA UTARA,TANJUNG PRIOK,12056,92,11676,205,83,175,2021-04-11
317401,JAKARTA SELATAN,TEBET,7564,46,7284,142,92,138,2021-04-11
317308,JAKARTA BARAT,KEMBANGAN,8726,78,8467,114,67,145,2021-04-11
317205,JAKARTA UTARA,PADEMANGAN,4722,39,4548,81,54,93,2021-04-11
317106,JAKARTA PUSAT,MENTENG,3097,27,2988,63,19,46,2021-04-11
317404,JAKARTA SELATAN,PASAR MINGGU,10931,68,10543,193,127,195,2021-04-11
317403,JAKARTA SELATAN,MAMPANG PRAPATAN,5626,28,5466,96,36,64,2021-04-11
317507,JAKARTA TIMUR,DUREN SAWIT,13691,89,13174,276,152,241,2021-04-11
317101,JAKARTA PUSAT,GAMBIR,3640,20,3550,60,10,30,2021-04-11
317302,JAKARTA BARAT,GROGOL PETAMBURAN,7995,61,7708,153,73,134,2021-04-11
317501,JAKARTA TIMUR,MATRAMAN,6184,35,5947,129,73,108,2021-04-11
317503,JAKARTA TIMUR,JATINEGARA,8638,50,8350,163,75,125,2021-04-11
317108,JAKARTA PUSAT,JOHAR BARU,4080,15,3929,97,39,54,2021-04-11
317306,JAKARTA BARAT,KALI DERES,7747,63,7463,136,85,148,2021-04-11
317407,JAKARTA SELATAN,KEBAYORAN BARU,6052,36,5854,92,70,106,2021-04-11
317409,JAKARTA SELATAN,JAGAKARSA,11199,81,10789,179,150,231,2021-04-11
317305,JAKARTA BARAT,KEBON JERUK,10132,105,9786,174,67,172,2021-04-11
317508,JAKARTA TIMUR,MAKASAR,8418,71,8121,136,90,161,2021-04-11
317405,JAKARTA SELATAN,KEBAYORAN LAMA,9009,61,8703,162,83,144,2021-04-11
317504,JAKARTA TIMUR,KRAMAT JATI,9734,68,9372,179,115,183,2021-04-11
317203,JAKARTA UTARA,KOJA,8235,37,7989,145,64,101,2021-04-11
317103,JAKARTA PUSAT,KEMAYORAN,9504,97,9180,164,63,160,2021-04-11
310101,KAB.ADM.KEP.SERIBU,KEP. SERIBU UTARA,307,0,302,4,1,1,2021-04-11
111111,Luar DKI & Proses Update,Luar DKI & Proses Update,143008,137,141294,1273,304,441,2021-04-11
317206,JAKARTA UTARA,KELAPA GADING,5633,54,5422,87,70,124,2021-04-11
317506,JAKARTA TIMUR,CAKUNG,11367,72,11018,195,82,154,2021-04-12
317105,JAKARTA PUSAT,CEMPAKA PUTIH,4846,26,4725,74,21,47,2021-04-12
317406,JAKARTA SELATAN,CILANDAK,7809,61,7506,118,124,185,2021-04-12
317204,JAKARTA UTARA,CILINCING,7644,43,7388,147,66,109,2021-04-12
317510,JAKARTA TIMUR,CIPAYUNG,9975,51,9690,115,119,170,2021-04-12
317509,JAKARTA TIMUR,CIRACAS,9168,80,8838,159,91,171,2021-04-12
317507,JAKARTA TIMUR,DUREN SAWIT,13722,83,13211,276,152,235,2021-04-12
317101,JAKARTA PUSAT,GAMBIR,3647,21,3554,60,12,33,2021-04-12
317302,JAKARTA BARAT,GROGOL PETAMBURAN,8013,62,7723,154,74,136,2021-04-12
317301,JAKARTA BARAT,CENGKARENG,12581,74,12173,245,89,163,2021-04-12
317206,JAKARTA UTARA,KELAPA GADING,5645,50,5447,87,61,111,2021-04-12
317108,JAKARTA PUSAT,JOHAR BARU,4083,14,3933,97,39,53,2021-04-12
111111,Luar DKI & Proses Update,Luar DKI & Proses Update,143008,137,141294,1273,304,441,2021-04-12
317401,JAKARTA SELATAN,TEBET,7582,45,7301,143,93,138,2021-04-12
317202,JAKARTA UTARA,TANJUNG PRIOK,12069,90,11707,208,64,154,2021-04-12
317107,JAKARTA PUSAT,TANAH ABANG,5657,39,5474,111,33,72,2021-04-12
317304,JAKARTA BARAT,TAMBORA,5614,69,5388,117,40,109,2021-04-12
317303,JAKARTA BARAT,TAMAN SARI,3742,36,3625,55,26,62,2021-04-12
317402,JAKARTA SELATAN,SETIA BUDI,5214,54,5012,88,60,114,2021-04-12
317104,JAKARTA PUSAT,SENEN,4356,36,4195,87,38,74,2021-04-12
317102,JAKARTA PUSAT,SAWAH BESAR,3904,27,3790,73,14,41,2021-04-12
317502,JAKARTA TIMUR,PULO GADUNG,9476,67,9137,167,105,172,2021-04-12
317410,JAKARTA SELATAN,PESANGGRAHAN,7203,47,6985,109,62,109,2021-04-12
317201,JAKARTA UTARA,PENJARINGAN,7608,109,7316,104,79,188,2021-04-12
317505,JAKARTA TIMUR,PASAR REBO,7894,43,7648,138,65,108,2021-04-12
317404,JAKARTA SELATAN,PASAR MINGGU,10996,75,10571,194,156,231,2021-04-12
317409,JAKARTA SELATAN,JAGAKARSA,11217,69,10818,180,150,219,2021-04-12
317408,JAKARTA SELATAN,PANCORAN,6174,63,5914,98,99,162,2021-04-12
317205,JAKARTA UTARA,PADEMANGAN,4745,41,4568,81,55,96,2021-04-12
317306,JAKARTA BARAT,KALI DERES,7766,63,7480,136,87,150,2021-04-12
317407,JAKARTA SELATAN,KEBAYORAN BARU,6061,36,5870,92,63,99,2021-04-12
317405,JAKARTA SELATAN,KEBAYORAN LAMA,9019,62,8715,162,80,142,2021-04-12
317305,JAKARTA BARAT,KEBON JERUK,10137,106,9791,176,64,170,2021-04-12
317103,JAKARTA PUSAT,KEMAYORAN,9533,102,9207,164,60,162,2021-04-12
317308,JAKARTA BARAT,KEMBANGAN,8734,78,8474,114,68,146,2021-04-12
317307,JAKARTA BARAT,PALMERAH,7474,67,7205,162,40,107,2021-04-12
310102,KAB.ADM.KEP.SERIBU,KEP. SERIBU SELATAN,241,0,236,3,2,2,2021-04-12
317203,JAKARTA UTARA,KOJA,8263,36,8026,145,56,92,2021-04-12
317504,JAKARTA TIMUR,KRAMAT JATI,9753,66,9389,179,119,185,2021-04-12
317508,JAKARTA TIMUR,MAKASAR,8433,62,8148,139,84,146,2021-04-12
317403,JAKARTA SELATAN,MAMPANG PRAPATAN,5631,26,5478,96,31,57,2021-04-12
317501,JAKARTA TIMUR,MATRAMAN,6188,32,5953,130,73,105,2021-04-12
317106,JAKARTA PUSAT,MENTENG,3105,27,2992,63,23,50,2021-04-12
310101,KAB.ADM.KEP.SERIBU,KEP. SERIBU UTARA,307,0,302,4,1,1,2021-04-12
317503,JAKARTA TIMUR,JATINEGARA,8660,49,8373,163,75,124,2021-04-12
111111,Luar DKI & Proses Update,Luar DKI & Proses Update,143008,137,141294,1273,304,441,2021-04-13
317108,JAKARTA PUSAT,JOHAR BARU,4084,15,3934,97,38,53,2021-04-13
317407,JAKARTA SELATAN,KEBAYORAN BARU,6073,42,5879,92,60,102,2021-04-13
317503,JAKARTA TIMUR,JATINEGARA,8668,54,8377,163,74,128,2021-04-13
317307,JAKARTA BARAT,PALMERAH,7498,54,7230,162,52,106,2021-04-13
317408,JAKARTA SELATAN,PANCORAN,6179,56,5930,98,95,151,2021-04-13
317404,JAKARTA SELATAN,PASAR MINGGU,11010,71,10596,195,148,219,2021-04-13
317505,JAKARTA TIMUR,PASAR REBO,7895,39,7655,138,63,102,2021-04-13
317201,JAKARTA UTARA,PENJARINGAN,7619,107,7330,104,78,185,2021-04-13
317410,JAKARTA SELATAN,PESANGGRAHAN,7214,48,6990,109,67,115,2021-04-13
317306,JAKARTA BARAT,KALI DERES,7779,68,7491,137,83,151,2021-04-13
317106,JAKARTA PUSAT,MENTENG,3111,30,2995,63,23,53,2021-04-13
317502,JAKARTA TIMUR,PULO GADUNG,9492,70,9148,167,107,177,2021-04-13
317104,JAKARTA PUSAT,SENEN,4366,42,4197,87,40,82,2021-04-13
317402,JAKARTA SELATAN,SETIA BUDI,5217,45,5029,88,55,100,2021-04-13
317303,JAKARTA BARAT,TAMAN SARI,3746,36,3629,55,26,62,2021-04-13
317304,JAKARTA BARAT,TAMBORA,5625,72,5394,119,40,112,2021-04-13
317107,JAKARTA PUSAT,TANAH ABANG,5662,40,5479,111,32,72,2021-04-13
317202,JAKARTA UTARA,TANJUNG PRIOK,12108,92,11748,208,60,152,2021-04-13
317401,JAKARTA SELATAN,TEBET,7594,42,7324,143,85,127,2021-04-13
317405,JAKARTA SELATAN,KEBAYORAN LAMA,9025,61,8730,162,72,133,2021-04-13
317102,JAKARTA PUSAT,SAWAH BESAR,3908,29,3793,73,13,42,2021-04-13
317501,JAKARTA TIMUR,MATRAMAN,6199,37,5954,130,78,115,2021-04-13
317205,JAKARTA UTARA,PADEMANGAN,4753,29,4589,81,54,83,2021-04-13
317508,JAKARTA TIMUR,MAKASAR,8447,67,8160,139,81,148,2021-04-13
317305,JAKARTA BARAT,KEBON JERUK,10157,89,9830,176,62,151,2021-04-13
317506,JAKARTA TIMUR,CAKUNG,11383,80,11026,196,81,161,2021-04-13
317105,JAKARTA PUSAT,CEMPAKA PUTIH,4850,27,4726,74,23,50,2021-04-13
317301,JAKARTA BARAT,CENGKARENG,12600,75,12188,245,92,167,2021-04-13
317406,JAKARTA SELATAN,CILANDAK,7834,62,7515,118,139,201,2021-04-13
317204,JAKARTA UTARA,CILINCING,7650,44,7394,147,65,109,2021-04-13
317403,JAKARTA SELATAN,MAMPANG PRAPATAN,5638,17,5490,97,34,51,2021-04-13
317509,JAKARTA TIMUR,CIRACAS,9178,72,8856,159,91,163,2021-04-13
317507,JAKARTA TIMUR,DUREN SAWIT,13742,93,13231,276,142,235,2021-04-13
317510,JAKARTA TIMUR,CIPAYUNG,9986,50,9703,115,118,168,2021-04-13
317302,JAKARTA BARAT,GROGOL PETAMBURAN,8028,70,7731,154,73,143,2021-04-13
317409,JAKARTA SELATAN,JAGAKARSA,11228,62,10835,180,151,213,2021-04-13
317206,JAKARTA UTARA,KELAPA GADING,5658,52,5466,87,53,105,2021-04-13
317103,JAKARTA PUSAT,KEMAYORAN,9545,100,9221,164,60,160,2021-04-13
317308,JAKARTA BARAT,KEMBANGAN,8760,73,8490,114,83,156,2021-04-13
310102,KAB.ADM.KEP.SERIBU,KEP. SERIBU SELATAN,241,0,236,3,2,2,2021-04-13
310101,KAB.ADM.KEP.SERIBU,KEP. SERIBU UTARA,307,0,302,4,1,1,2021-04-13
317203,JAKARTA UTARA,KOJA,8273,38,8036,146,53,91,2021-04-13
317504,JAKARTA TIMUR,KRAMAT JATI,9763,74,9394,179,116,190,2021-04-13
317101,JAKARTA PUSAT,GAMBIR,3657,23,3563,60,11,34,2021-04-13
317506,JAKARTA TIMUR,CAKUNG,11404,82,11035,196,91,173,2021-04-14
317105,JAKARTA PUSAT,CEMPAKA PUTIH,4856,27,4728,75,26,53,2021-04-14
317301,JAKARTA BARAT,CENGKARENG,12630,72,12236,245,77,149,2021-04-14
317406,JAKARTA SELATAN,CILANDAK,7877,63,7533,118,163,226,2021-04-14
317204,JAKARTA UTARA,CILINCING,7675,52,7401,147,75,127,2021-04-14
317509,JAKARTA TIMUR,CIRACAS,9216,80,8860,160,116,196,2021-04-14
317510,JAKARTA TIMUR,CIPAYUNG,10052,57,9708,115,172,229,2021-04-14
317101,JAKARTA PUSAT,GAMBIR,3666,27,3566,60,13,40,2021-04-14
317408,JAKARTA SELATAN,PANCORAN,6191,58,5934,98,101,159,2021-04-14
317404,JAKARTA SELATAN,PASAR MINGGU,11044,72,10602,195,175,247,2021-04-14
317505,JAKARTA TIMUR,PASAR REBO,7938,48,7659,139,92,140,2021-04-14
317201,JAKARTA UTARA,PENJARINGAN,7654,101,7354,104,95,196,2021-04-14
317410,JAKARTA SELATAN,PESANGGRAHAN,7229,41,7008,109,71,112,2021-04-14
317502,JAKARTA TIMUR,PULO GADUNG,9522,80,9155,168,119,199,2021-04-14
317102,JAKARTA PUSAT,SAWAH BESAR,3925,34,3796,74,21,55,2021-04-14
317104,JAKARTA PUSAT,SENEN,4378,45,4198,87,48,93,2021-04-14
317402,JAKARTA SELATAN,SETIA BUDI,5249,56,5035,88,70,126,2021-04-14
317303,JAKARTA BARAT,TAMAN SARI,3757,37,3638,56,26,63,2021-04-14
317304,JAKARTA BARAT,TAMBORA,5643,79,5406,119,39,118,2021-04-14
317107,JAKARTA PUSAT,TANAH ABANG,5674,43,5480,112,39,82,2021-04-14
317202,JAKARTA UTARA,TANJUNG PRIOK,12140,104,11751,209,76,180,2021-04-14
317401,JAKARTA SELATAN,TEBET,7622,45,7332,144,101,146,2021-04-14
111111,Luar DKI & Proses Update,Luar DKI & Proses Update,143008,137,141294,1273,304,441,2021-04-14
317307,JAKARTA BARAT,PALMERAH,7516,59,7244,162,51,110,2021-04-14
317205,JAKARTA UTARA,PADEMANGAN,4786,30,4594,81,81,111,2021-04-14
317106,JAKARTA PUSAT,MENTENG,3121,32,2997,63,29,61,2021-04-14
317501,JAKARTA TIMUR,MATRAMAN,6228,43,5959,130,96,139,2021-04-14
317302,JAKARTA BARAT,GROGOL PETAMBURAN,8068,78,7756,154,80,158,2021-04-14
317409,JAKARTA SELATAN,JAGAKARSA,11287,72,10845,181,189,261,2021-04-14
317503,JAKARTA TIMUR,JATINEGARA,8686,57,8392,163,74,131,2021-04-14
317108,JAKARTA PUSAT,JOHAR BARU,4089,15,3936,97,41,56,2021-04-14
317407,JAKARTA SELATAN,KEBAYORAN BARU,6094,47,5880,92,75,122,2021-04-14
317405,JAKARTA SELATAN,KEBAYORAN LAMA,9061,68,8739,163,91,159,2021-04-14
317305,JAKARTA BARAT,KEBON JERUK,10187,88,9860,177,62,150,2021-04-14
317507,JAKARTA TIMUR,DUREN SAWIT,13798,111,13240,276,171,282,2021-04-14
317206,JAKARTA UTARA,KELAPA GADING,5697,51,5475,87,84,135,2021-04-14
317308,JAKARTA BARAT,KEMBANGAN,8784,69,8514,114,87,156,2021-04-14
310102,KAB.ADM.KEP.SERIBU,KEP. SERIBU SELATAN,241,0,236,3,2,2,2021-04-14
310101,KAB.ADM.KEP.SERIBU,KEP. SERIBU UTARA,308,1,302,4,1,2,2021-04-14
317203,JAKARTA UTARA,KOJA,8304,45,8040,146,73,118,2021-04-14
317504,JAKARTA TIMUR,KRAMAT JATI,9795,76,9399,181,139,215,2021-04-14
317508,JAKARTA TIMUR,MAKASAR,8481,69,8177,139,96,165,2021-04-14
317403,JAKARTA SELATAN,MAMPANG PRAPATAN,5658,18,5493,97,50,68,2021-04-14
317103,JAKARTA PUSAT,KEMAYORAN,9584,103,9239,164,78,181,2021-04-14
317306,JAKARTA BARAT,KALI DERES,7809,74,7529,138,68,142,2021-04-14
317405,JAKARTA SELATAN,KEBAYORAN LAMA,9076,72,8765,163,76,148,2021-04-15
111111,Luar DKI & Proses Update,Luar DKI & Proses Update,143008,137,141294,1273,304,441,2021-04-15
317506,JAKARTA TIMUR,CAKUNG,11430,84,11073,196,77,161,2021-04-15
317105,JAKARTA PUSAT,CEMPAKA PUTIH,4865,29,4730,75,31,60,2021-04-15
317301,JAKARTA BARAT,CENGKARENG,12655,88,12245,245,77,165,2021-04-15
317406,JAKARTA SELATAN,CILANDAK,7890,56,7584,118,132,188,2021-04-15
317204,JAKARTA UTARA,CILINCING,7683,56,7412,147,68,124,2021-04-15
317510,JAKARTA TIMUR,CIPAYUNG,10077,61,9741,115,160,221,2021-04-15
317509,JAKARTA TIMUR,CIRACAS,9252,83,8899,160,110,193,2021-04-15
317507,JAKARTA TIMUR,DUREN SAWIT,13845,111,13282,277,175,286,2021-04-15
317101,JAKARTA PUSAT,GAMBIR,3675,31,3569,60,15,46,2021-04-15
317302,JAKARTA BARAT,GROGOL PETAMBURAN,8094,89,7770,154,81,170,2021-04-15
317409,JAKARTA SELATAN,JAGAKARSA,11313,79,10909,181,144,223,2021-04-15
317503,JAKARTA TIMUR,JATINEGARA,8710,60,8413,163,74,134,2021-04-15
317407,JAKARTA SELATAN,KEBAYORAN BARU,6113,47,5912,92,62,109,2021-04-15
317108,JAKARTA PUSAT,JOHAR BARU,4104,21,3959,97,27,48,2021-04-15
317306,JAKARTA BARAT,KALI DERES,7839,85,7548,139,67,152,2021-04-15
317303,JAKARTA BARAT,TAMAN SARI,3763,40,3645,56,22,62,2021-04-15
317401,JAKARTA SELATAN,TEBET,7643,46,7361,145,91,137,2021-04-15
317202,JAKARTA UTARA,TANJUNG PRIOK,12170,108,11770,209,83,191,2021-04-15
317107,JAKARTA PUSAT,TANAH ABANG,5681,44,5484,112,41,85,2021-04-15
317304,JAKARTA BARAT,TAMBORA,5654,85,5415,119,35,120,2021-04-15
317402,JAKARTA SELATAN,SETIA BUDI,5279,77,5047,89,66,143,2021-04-15
317104,JAKARTA PUSAT,SENEN,4390,48,4222,88,32,80,2021-04-15
317102,JAKARTA PUSAT,SAWAH BESAR,3940,34,3803,74,29,63,2021-04-15
317502,JAKARTA TIMUR,PULO GADUNG,9558,106,9193,168,91,197,2021-04-15
317410,JAKARTA SELATAN,PESANGGRAHAN,7240,42,7029,109,60,102,2021-04-15
317505,JAKARTA TIMUR,PASAR REBO,7959,57,7670,139,93,150,2021-04-15
317404,JAKARTA SELATAN,PASAR MINGGU,11074,78,10635,196,165,243,2021-04-15
317408,JAKARTA SELATAN,PANCORAN,6211,56,5975,98,82,138,2021-04-15
317307,JAKARTA BARAT,PALMERAH,7525,60,7261,163,41,101,2021-04-15
317201,JAKARTA UTARA,PENJARINGAN,7690,116,7378,104,92,208,2021-04-15
317106,JAKARTA PUSAT,MENTENG,3131,30,3007,63,31,61,2021-04-15
317305,JAKARTA BARAT,KEBON JERUK,10210,102,9869,177,62,164,2021-04-15
317206,JAKARTA UTARA,KELAPA GADING,5717,58,5500,87,72,130,2021-04-15
317205,JAKARTA UTARA,PADEMANGAN,4794,26,4608,81,79,105,2021-04-15
317308,JAKARTA BARAT,KEMBANGAN,8800,77,8524,114,85,162,2021-04-15
310102,KAB.ADM.KEP.SERIBU,KEP. SERIBU SELATAN,241,0,236,3,2,2,2021-04-15
310101,KAB.ADM.KEP.SERIBU,KEP. SERIBU UTARA,308,1,303,4,0,1,2021-04-15
317103,JAKARTA PUSAT,KEMAYORAN,9619,96,9293,164,66,162,2021-04-15
317504,JAKARTA TIMUR,KRAMAT JATI,9829,82,9440,181,126,208,2021-04-15
317508,JAKARTA TIMUR,MAKASAR,8510,80,8198,139,93,173,2021-04-15
317403,JAKARTA SELATAN,MAMPANG PRAPATAN,5664,17,5505,97,45,62,2021-04-15
317501,JAKARTA TIMUR,MATRAMAN,6235,44,5985,130,76,120,2021-04-15
317203,JAKARTA UTARA,KOJA,8320,55,8060,146,59,114,2021-04-15
317403,JAKARTA SELATAN,MAMPANG PRAPATAN,5681,21,5510,97,53,74,2021-04-16
317201,JAKARTA UTARA,PENJARINGAN,7729,116,7415,104,94,210,2021-04-16
317501,JAKARTA TIMUR,MATRAMAN,6248,42,6019,130,57,99,2021-04-16
317106,JAKARTA PUSAT,MENTENG,3141,29,3017,64,31,60,2021-04-16
317205,JAKARTA UTARA,PADEMANGAN,4807,28,4614,81,84,112,2021-04-16
317307,JAKARTA BARAT,PALMERAH,7541,64,7269,163,45,109,2021-04-16
317408,JAKARTA SELATAN,PANCORAN,6220,59,5999,98,64,123,2021-04-16
317404,JAKARTA SELATAN,PASAR MINGGU,11099,81,10661,196,161,242,2021-04-16
317505,JAKARTA TIMUR,PASAR REBO,7982,60,7687,139,96,156,2021-04-16
317410,JAKARTA SELATAN,PESANGGRAHAN,7261,43,7048,109,61,104,2021-04-16
111111,Luar DKI & Proses Update,Luar DKI & Proses Update,143008,137,141294,1273,304,441,2021-04-16
317102,JAKARTA PUSAT,SAWAH BESAR,3947,36,3809,74,28,64,2021-04-16
317104,JAKARTA PUSAT,SENEN,4395,47,4228,88,32,79,2021-04-16
317402,JAKARTA SELATAN,SETIA BUDI,5293,79,5072,89,53,132,2021-04-16
317303,JAKARTA BARAT,TAMAN SARI,3768,42,3650,56,20,62,2021-04-16
317304,JAKARTA BARAT,TAMBORA,5667,85,5432,119,31,116,2021-04-16
317107,JAKARTA PUSAT,TANAH ABANG,5694,40,5498,112,44,84,2021-04-16
317202,JAKARTA UTARA,TANJUNG PRIOK,12212,102,11798,210,102,204,2021-04-16
317401,JAKARTA SELATAN,TEBET,7671,51,7387,145,88,139,2021-04-16
317508,JAKARTA TIMUR,MAKASAR,8537,82,8223,139,93,175,2021-04-16
317502,JAKARTA TIMUR,PULO GADUNG,9583,97,9243,168,75,172,2021-04-16
317504,JAKARTA TIMUR,KRAMAT JATI,9849,82,9468,181,118,200,2021-04-16
317203,JAKARTA UTARA,KOJA,8346,59,8075,146,66,125,2021-04-16
317406,JAKARTA SELATAN,CILANDAK,7928,60,7601,118,149,209,2021-04-16
317506,JAKARTA TIMUR,CAKUNG,11458,89,11096,196,77,166,2021-04-16
317105,JAKARTA PUSAT,CEMPAKA PUTIH,4873,29,4737,75,32,61,2021-04-16
317301,JAKARTA BARAT,CENGKARENG,12694,86,12278,247,83,169,2021-04-16
317204,JAKARTA UTARA,CILINCING,7704,56,7436,147,65,121,2021-04-16
317510,JAKARTA TIMUR,CIPAYUNG,10108,63,9770,115,160,223,2021-04-16
317509,JAKARTA TIMUR,CIRACAS,9271,92,8922,161,96,188,2021-04-16
317507,JAKARTA TIMUR,DUREN SAWIT,13867,118,13340,278,131,249,2021-04-16
310101,KAB.ADM.KEP.SERIBU,KEP. SERIBU UTARA,308,1,303,4,0,1,2021-04-16
317302,JAKARTA BARAT,GROGOL PETAMBURAN,8123,99,7795,154,75,174,2021-04-16
317409,JAKARTA SELATAN,JAGAKARSA,11335,89,10914,181,151,240,2021-04-16
317101,JAKARTA PUSAT,GAMBIR,3682,32,3576,60,14,46,2021-04-16
317108,JAKARTA PUSAT,JOHAR BARU,4110,22,3970,97,21,43,2021-04-16
317306,JAKARTA BARAT,KALI DERES,7873,92,7583,139,59,151,2021-04-16
317407,JAKARTA SELATAN,KEBAYORAN BARU,6125,51,5926,92,56,107,2021-04-16
317405,JAKARTA SELATAN,KEBAYORAN LAMA,9106,81,8781,163,81,162,2021-04-16
317305,JAKARTA BARAT,KEBON JERUK,10232,104,9889,177,62,166,2021-04-16
317206,JAKARTA UTARA,KELAPA GADING,5741,68,5521,87,65,133,2021-04-16
317103,JAKARTA PUSAT,KEMAYORAN,9656,95,9335,164,62,157,2021-04-16
317308,JAKARTA BARAT,KEMBANGAN,8823,84,8540,114,85,169,2021-04-16
310102,KAB.ADM.KEP.SERIBU,KEP. SERIBU SELATAN,241,0,237,3,1,1,2021-04-16
317503,JAKARTA TIMUR,JATINEGARA,8730,59,8441,163,67,126,2021-04-16
317206,JAKARTA UTARA,KELAPA GADING,5763,70,5529,89,75,145,2021-04-17
317103,JAKARTA PUSAT,KEMAYORAN,9684,89,9371,165,59,148,2021-04-17
317308,JAKARTA BARAT,KEMBANGAN,8868,92,8566,115,95,187,2021-04-17
310102,KAB.ADM.KEP.SERIBU,KEP. SERIBU SELATAN,241,0,237,3,1,1,2021-04-17
310101,KAB.ADM.KEP.SERIBU,KEP. SERIBU UTARA,309,1,304,4,0,1,2021-04-17
317203,JAKARTA UTARA,KOJA,8370,69,8083,146,72,141,2021-04-17
317307,JAKARTA BARAT,PALMERAH,7556,62,7290,164,40,102,2021-04-17
317508,JAKARTA TIMUR,MAKASAR,8552,77,8254,139,82,159,2021-04-17
317403,JAKARTA SELATAN,MAMPANG PRAPATAN,5688,22,5525,97,44,66,2021-04-17
317501,JAKARTA TIMUR,MATRAMAN,6256,46,6022,130,58,104,2021-04-17
317106,JAKARTA PUSAT,MENTENG,3157,33,3026,64,34,67,2021-04-17
317205,JAKARTA UTARA,PADEMANGAN,4823,29,4623,81,90,119,2021-04-17
317305,JAKARTA BARAT,KEBON JERUK,10264,111,9920,177,56,167,2021-04-17
317504,JAKARTA TIMUR,KRAMAT JATI,9876,84,9510,181,101,185,2021-04-17
317405,JAKARTA SELATAN,KEBAYORAN LAMA,9133,86,8803,163,81,167,2021-04-17
317204,JAKARTA UTARA,CILINCING,7735,64,7446,148,77,141,2021-04-17
317306,JAKARTA BARAT,KALI DERES,7892,98,7606,140,48,146,2021-04-17
317108,JAKARTA PUSAT,JOHAR BARU,4114,23,3973,97,21,44,2021-04-17
317503,JAKARTA TIMUR,JATINEGARA,8752,62,8464,164,62,124,2021-04-17
317409,JAKARTA SELATAN,JAGAKARSA,11383,105,10970,182,126,231,2021-04-17
317302,JAKARTA BARAT,GROGOL PETAMBURAN,8144,106,7809,154,75,181,2021-04-17
317101,JAKARTA PUSAT,GAMBIR,3704,33,3590,60,21,54,2021-04-17
317507,JAKARTA TIMUR,DUREN SAWIT,13916,117,13389,278,132,249,2021-04-17
317509,JAKARTA TIMUR,CIRACAS,9280,87,8953,162,78,165,2021-04-17
317510,JAKARTA TIMUR,CIPAYUNG,10130,67,9819,115,129,196,2021-04-17
317406,JAKARTA SELATAN,CILANDAK,7940,62,7646,118,114,176,2021-04-17
317301,JAKARTA BARAT,CENGKARENG,12730,96,12297,247,90,186,2021-04-17
317105,JAKARTA PUSAT,CEMPAKA PUTIH,4886,26,4748,75,37,63,2021-04-17
317506,JAKARTA TIMUR,CAKUNG,11502,105,11129,197,71,176,2021-04-17
317407,JAKARTA SELATAN,KEBAYORAN BARU,6146,55,5943,92,56,111,2021-04-17
317404,JAKARTA SELATAN,PASAR MINGGU,11126,85,10700,196,145,230,2021-04-17
317505,JAKARTA TIMUR,PASAR REBO,7995,57,7712,139,87,144,2021-04-17
317408,JAKARTA SELATAN,PANCORAN,6249,61,6014,98,76,137,2021-04-17
317401,JAKARTA SELATAN,TEBET,7686,50,7418,145,73,123,2021-04-17
317202,JAKARTA UTARA,TANJUNG PRIOK,12219,95,11820,210,94,189,2021-04-17
317107,JAKARTA PUSAT,TANAH ABANG,5711,47,5520,112,32,79,2021-04-17
317304,JAKARTA BARAT,TAMBORA,5690,100,5442,122,26,126,2021-04-17
317303,JAKARTA BARAT,TAMAN SARI,3781,47,3656,57,21,68,2021-04-17
111111,Luar DKI & Proses Update,Luar DKI & Proses Update,143008,137,141294,1273,304,441,2021-04-17
317104,JAKARTA PUSAT,SENEN,4397,43,4237,88,29,72,2021-04-17
317102,JAKARTA PUSAT,SAWAH BESAR,3959,39,3816,74,30,69,2021-04-17
317502,JAKARTA TIMUR,PULO GADUNG,9609,106,9246,169,88,194,2021-04-17
317410,JAKARTA SELATAN,PESANGGRAHAN,7265,44,7072,109,40,84,2021-04-17
317201,JAKARTA UTARA,PENJARINGAN,7755,130,7430,104,91,221,2021-04-17
317402,JAKARTA SELATAN,SETIA BUDI,5317,87,5089,89,52,139,2021-04-17
310101,KAB.ADM.KEP.SERIBU,KEP. SERIBU UTARA,310,1,305,4,0,1,2021-04-18
317203,JAKARTA UTARA,KOJA,8377,66,8099,146,66,132,2021-04-18
317504,JAKARTA TIMUR,KRAMAT JATI,9904,93,9540,182,89,182,2021-04-18
317508,JAKARTA TIMUR,MAKASAR,8566,74,8274,140,78,152,2021-04-18
317403,JAKARTA SELATAN,MAMPANG PRAPATAN,5697,22,5530,98,47,69,2021-04-18
317501,JAKARTA TIMUR,MATRAMAN,6286,53,6042,130,61,114,2021-04-18
317106,JAKARTA PUSAT,MENTENG,3165,30,3040,64,31,61,2021-04-18
317205,JAKARTA UTARA,PADEMANGAN,4843,43,4656,81,63,106,2021-04-18
317404,JAKARTA SELATAN,PASAR MINGGU,11161,92,10750,197,122,214,2021-04-18
317408,JAKARTA SELATAN,PANCORAN,6279,59,6048,99,73,132,2021-04-18
317505,JAKARTA TIMUR,PASAR REBO,8013,61,7732,140,80,141,2021-04-18
317201,JAKARTA UTARA,PENJARINGAN,7776,138,7454,105,79,217,2021-04-18
317410,JAKARTA SELATAN,PESANGGRAHAN,7289,46,7079,109,55,101,2021-04-18
317502,JAKARTA TIMUR,PULO GADUNG,9644,115,9276,169,84,199,2021-04-18
317102,JAKARTA PUSAT,SAWAH BESAR,3965,40,3821,74,30,70,2021-04-18
317104,JAKARTA PUSAT,SENEN,4390,39,4238,88,25,64,2021-04-18
317307,JAKARTA BARAT,PALMERAH,7565,58,7299,164,44,102,2021-04-18
310102,KAB.ADM.KEP.SERIBU,KEP. SERIBU SELATAN,241,0,238,3,0,0,2021-04-18
317206,JAKARTA UTARA,KELAPA GADING,5771,69,5541,89,72,141,2021-04-18
317103,JAKARTA PUSAT,KEMAYORAN,9707,93,9390,165,59,152,2021-04-18
317506,JAKARTA TIMUR,CAKUNG,11525,95,11150,198,82,177,2021-04-18
317105,JAKARTA PUSAT,CEMPAKA PUTIH,4909,30,4763,75,41,71,2021-04-18
317301,JAKARTA BARAT,CENGKARENG,12746,96,12327,248,75,171,2021-04-18
317406,JAKARTA SELATAN,CILANDAK,7963,64,7673,118,108,172,2021-04-18
317204,JAKARTA UTARA,CILINCING,7765,61,7478,149,77,138,2021-04-18
317510,JAKARTA TIMUR,CIPAYUNG,10173,76,9821,115,161,237,2021-04-18
317509,JAKARTA TIMUR,CIRACAS,9298,88,8974,162,74,162,2021-04-18
317507,JAKARTA TIMUR,DUREN SAWIT,13959,127,13421,280,131,258,2021-04-18
317101,JAKARTA PUSAT,GAMBIR,3712,36,3597,60,19,55,2021-04-18
317302,JAKARTA BARAT,GROGOL PETAMBURAN,8168,115,7829,154,70,185,2021-04-18
317409,JAKARTA SELATAN,JAGAKARSA,11440,106,11004,184,146,252,2021-04-18
317503,JAKARTA TIMUR,JATINEGARA,8777,60,8483,164,70,130,2021-04-18
317108,JAKARTA PUSAT,JOHAR BARU,4121,23,3980,97,21,44,2021-04-18
317402,JAKARTA SELATAN,SETIA BUDI,5331,83,5103,89,56,139,2021-04-18
317407,JAKARTA SELATAN,KEBAYORAN BARU,6170,58,5955,92,65,123,2021-04-18
317405,JAKARTA SELATAN,KEBAYORAN LAMA,9158,88,8827,163,80,168,2021-04-18
317305,JAKARTA BARAT,KEBON JERUK,10283,114,9937,178,54,168,2021-04-18
317308,JAKARTA BARAT,KEMBANGAN,8888,82,8595,118,93,175,2021-04-18
317306,JAKARTA BARAT,KALI DERES,7897,90,7623,140,44,134,2021-04-18
111111,Luar DKI & Proses Update,Luar DKI & Proses Update,143008,137,141294,1273,304,441,2021-04-18
317107,JAKARTA PUSAT,TANAH ABANG,5720,45,5534,112,29,74,2021-04-18
317304,JAKARTA BARAT,TAMBORA,5714,107,5451,122,34,141,2021-04-18
317303,JAKARTA BARAT,TAMAN SARI,3797,53,3664,58,22,75,2021-04-18
317401,JAKARTA SELATAN,TEBET,7717,53,7431,145,88,141,2021-04-18
317202,JAKARTA UTARA,TANJUNG PRIOK,12238,99,11845,211,83,182,2021-04-18
317508,JAKARTA TIMUR,MAKASAR,8578,70,8292,140,76,146,2021-04-19
317403,JAKARTA SELATAN,MAMPANG PRAPATAN,5699,23,5537,98,41,64,2021-04-19
317501,JAKARTA TIMUR,MATRAMAN,6288,45,6060,130,53,98,2021-04-19
317106,JAKARTA PUSAT,MENTENG,3173,33,3044,65,31,64,2021-04-19
317205,JAKARTA UTARA,PADEMANGAN,4853,42,4672,81,58,100,2021-04-19
317307,JAKARTA BARAT,PALMERAH,7579,61,7321,164,33,94,2021-04-19
317408,JAKARTA SELATAN,PANCORAN,6288,56,6072,100,60,116,2021-04-19
317404,JAKARTA SELATAN,PASAR MINGGU,11190,89,10777,197,127,216,2021-04-19
317505,JAKARTA TIMUR,PASAR REBO,8020,56,7747,140,77,133,2021-04-19
317201,JAKARTA UTARA,PENJARINGAN,7797,124,7492,105,76,200,2021-04-19
317506,JAKARTA TIMUR,CAKUNG,11533,83,11171,198,81,164,2021-04-19
317102,JAKARTA PUSAT,SAWAH BESAR,3967,30,3832,74,31,61,2021-04-19
317104,JAKARTA PUSAT,SENEN,4394,40,4243,89,22,62,2021-04-19
317402,JAKARTA SELATAN,SETIA BUDI,5336,72,5121,89,54,126,2021-04-19
317303,JAKARTA BARAT,TAMAN SARI,3802,42,3683,58,19,61,2021-04-19
317304,JAKARTA BARAT,TAMBORA,5720,93,5472,122,33,126,2021-04-19
317107,JAKARTA PUSAT,TANAH ABANG,5723,41,5542,113,27,68,2021-04-19
317202,JAKARTA UTARA,TANJUNG PRIOK,12262,101,11872,211,78,179,2021-04-19
317401,JAKARTA SELATAN,TEBET,7727,49,7445,145,88,137,2021-04-19
111111,Luar DKI & Proses Update,Luar DKI & Proses Update,143008,137,141294,1273,304,441,2021-04-19
317502,JAKARTA TIMUR,PULO GADUNG,9650,100,9305,169,76,176,2021-04-19
317410,JAKARTA SELATAN,PESANGGRAHAN,7292,40,7096,110,46,86,2021-04-19
317504,JAKARTA TIMUR,KRAMAT JATI,9926,103,9559,182,82,185,2021-04-19
310102,KAB.ADM.KEP.SERIBU,KEP. SERIBU SELATAN,241,0,238,3,0,0,2021-04-19
317105,JAKARTA PUSAT,CEMPAKA PUTIH,4920,30,4770,75,45,75,2021-04-19
317301,JAKARTA BARAT,CENGKARENG,12749,91,12347,248,63,154,2021-04-19
317406,JAKARTA SELATAN,CILANDAK,7971,60,7701,118,92,152,2021-04-19
317204,JAKARTA UTARA,CILINCING,7763,59,7503,149,52,111,2021-04-19
317510,JAKARTA TIMUR,CIPAYUNG,10188,76,9838,115,159,235,2021-04-19
317509,JAKARTA TIMUR,CIRACAS,9312,87,8993,162,70,157,2021-04-19
317507,JAKARTA TIMUR,DUREN SAWIT,13971,118,13440,282,131,249,2021-04-19
317101,JAKARTA PUSAT,GAMBIR,3714,29,3606,61,18,47,2021-04-19
310101,KAB.ADM.KEP.SERIBU,KEP. SERIBU UTARA,310,1,305,4,0,1,2021-04-19
317302,JAKARTA BARAT,GROGOL PETAMBURAN,8174,105,7869,154,46,151,2021-04-19
317503,JAKARTA TIMUR,JATINEGARA,8787,62,8492,165,68,130,2021-04-19
317108,JAKARTA PUSAT,JOHAR BARU,4125,21,3985,97,22,43,2021-04-19
317306,JAKARTA BARAT,KALI DERES,7903,80,7647,140,36,116,2021-04-19
317407,JAKARTA SELATAN,KEBAYORAN BARU,6177,54,5970,92,61,115,2021-04-19
317405,JAKARTA SELATAN,KEBAYORAN LAMA,9170,83,8843,163,81,164,2021-04-19
317305,JAKARTA BARAT,KEBON JERUK,10301,116,9958,179,48,164,2021-04-19
317206,JAKARTA UTARA,KELAPA GADING,5785,63,5562,89,71,134,2021-04-19
317103,JAKARTA PUSAT,KEMAYORAN,9722,97,9404,165,56,153,2021-04-19
317308,JAKARTA BARAT,KEMBANGAN,8907,84,8628,118,77,161,2021-04-19
317409,JAKARTA SELATAN,JAGAKARSA,11450,98,11027,184,141,239,2021-04-19
317203,JAKARTA UTARA,KOJA,8393,66,8117,147,63,129,2021-04-19
111111,Luar DKI & Proses Update,Luar DKI & Proses Update,143008,137,141294,1273,304,441,2021-04-20
317107,JAKARTA PUSAT,TANAH ABANG,5740,47,5549,114,30,77,2021-04-20
317202,JAKARTA UTARA,TANJUNG PRIOK,12277,107,11879,211,80,187,2021-04-20
317203,JAKARTA UTARA,KOJA,8396,65,8119,147,65,130,2021-04-20
317504,JAKARTA TIMUR,KRAMAT JATI,9941,103,9566,182,90,193,2021-04-20
317508,JAKARTA TIMUR,MAKASAR,8589,71,8293,141,84,155,2021-04-20
317403,JAKARTA SELATAN,MAMPANG PRAPATAN,5701,23,5555,99,24,47,2021-04-20
317501,JAKARTA TIMUR,MATRAMAN,6293,46,6063,131,53,99,2021-04-20
317106,JAKARTA PUSAT,MENTENG,3184,34,3051,65,34,68,2021-04-20
317205,JAKARTA UTARA,PADEMANGAN,4858,42,4676,81,59,101,2021-04-20
317408,JAKARTA SELATAN,PANCORAN,6303,52,6093,100,58,110,2021-04-20
317404,JAKARTA SELATAN,PASAR MINGGU,11200,85,10812,199,104,189,2021-04-20
317505,JAKARTA TIMUR,PASAR REBO,8027,58,7748,141,80,138,2021-04-20
317201,JAKARTA UTARA,PENJARINGAN,7831,128,7511,106,86,214,2021-04-20
317410,JAKARTA SELATAN,PESANGGRAHAN,7297,42,7103,112,40,82,2021-04-20
317502,JAKARTA TIMUR,PULO GADUNG,9675,103,9316,170,86,189,2021-04-20
317102,JAKARTA PUSAT,SAWAH BESAR,3981,32,3839,74,36,68,2021-04-20
317104,JAKARTA PUSAT,SENEN,4399,39,4256,89,15,54,2021-04-20
317402,JAKARTA SELATAN,SETIA BUDI,5342,73,5128,89,52,125,2021-04-20
317303,JAKARTA BARAT,TAMAN SARI,3814,48,3694,58,14,62,2021-04-20
317304,JAKARTA BARAT,TAMBORA,5732,84,5493,122,33,117,2021-04-20
317401,JAKARTA SELATAN,TEBET,7734,47,7449,145,93,140,2021-04-20
310101,KAB.ADM.KEP.SERIBU,KEP. SERIBU UTARA,310,1,305,4,0,1,2021-04-20
310102,KAB.ADM.KEP.SERIBU,KEP. SERIBU SELATAN,241,0,238,3,0,0,2021-04-20
317307,JAKARTA BARAT,PALMERAH,7609,66,7333,164,46,112,2021-04-20
317103,JAKARTA PUSAT,KEMAYORAN,9728,91,9431,165,41,132,2021-04-20
317308,JAKARTA BARAT,KEMBANGAN,8934,91,8638,118,87,178,2021-04-20
317506,JAKARTA TIMUR,CAKUNG,11547,87,11174,198,88,175,2021-04-20
317105,JAKARTA PUSAT,CEMPAKA PUTIH,4931,29,4775,76,51,80,2021-04-20
317301,JAKARTA BARAT,CENGKARENG,12772,94,12358,249,71,165,2021-04-20
317406,JAKARTA SELATAN,CILANDAK,7986,65,7738,120,63,128,2021-04-20
317204,JAKARTA UTARA,CILINCING,7769,59,7508,149,53,112,2021-04-20
317509,JAKARTA TIMUR,CIRACAS,9317,80,9002,162,73,153,2021-04-20
317507,JAKARTA TIMUR,DUREN SAWIT,13988,123,13447,283,135,258,2021-04-20
317101,JAKARTA PUSAT,GAMBIR,3720,29,3610,61,20,49,2021-04-20
317510,JAKARTA TIMUR,CIPAYUNG,10199,75,9843,115,166,241,2021-04-20
317206,JAKARTA UTARA,KELAPA GADING,5791,61,5565,89,76,137,2021-04-20
317409,JAKARTA SELATAN,JAGAKARSA,11466,100,11071,184,111,211,2021-04-20
317503,JAKARTA TIMUR,JATINEGARA,8795,58,8500,166,71,129,2021-04-20
317108,JAKARTA PUSAT,JOHAR BARU,4128,21,3987,97,23,44,2021-04-20
317306,JAKARTA BARAT,KALI DERES,7918,85,7658,140,35,120,2021-04-20
317407,JAKARTA SELATAN,KEBAYORAN BARU,6181,54,5986,92,49,103,2021-04-20
317405,JAKARTA SELATAN,KEBAYORAN LAMA,9189,87,8872,163,67,154,2021-04-20
317305,JAKARTA BARAT,KEBON JERUK,10317,116,9977,179,45,161,2021-04-20
317302,JAKARTA BARAT,GROGOL PETAMBURAN,8184,99,7879,155,51,150,2021-04-20
317205,JAKARTA UTARA,PADEMANGAN,4895,44,4679,81,91,135,2021-04-21
317106,JAKARTA PUSAT,MENTENG,3189,35,3052,65,37,72,2021-04-21
317501,JAKARTA TIMUR,MATRAMAN,6322,44,6089,131,58,102,2021-04-21
317403,JAKARTA SELATAN,MAMPANG PRAPATAN,5711,22,5560,99,30,52,2021-04-21
310101,KAB.ADM.KEP.SERIBU,KEP. SERIBU UTARA,312,2,305,4,1,3,2021-04-21
317504,JAKARTA TIMUR,KRAMAT JATI,9970,96,9599,183,92,188,2021-04-21
317203,JAKARTA UTARA,KOJA,8407,66,8128,147,66,132,2021-04-21
317307,JAKARTA BARAT,PALMERAH,7628,62,7343,164,59,121,2021-04-21
317508,JAKARTA TIMUR,MAKASAR,8611,74,8321,141,75,149,2021-04-21
317408,JAKARTA SELATAN,PANCORAN,6325,59,6094,100,72,131,2021-04-21
317303,JAKARTA BARAT,TAMAN SARI,3826,51,3698,58,19,70,2021-04-21
317505,JAKARTA TIMUR,PASAR REBO,8066,58,7778,143,87,145,2021-04-21
317201,JAKARTA UTARA,PENJARINGAN,7861,133,7522,106,100,233,2021-04-21
317410,JAKARTA SELATAN,PESANGGRAHAN,7324,50,7107,113,54,104,2021-04-21
317502,JAKARTA TIMUR,PULO GADUNG,9703,103,9343,170,87,190,2021-04-21
317102,JAKARTA PUSAT,SAWAH BESAR,4005,43,3841,74,47,90,2021-04-21
317104,JAKARTA PUSAT,SENEN,4408,37,4263,89,19,56,2021-04-21
317304,JAKARTA BARAT,TAMBORA,5750,84,5503,122,41,125,2021-04-21
317402,JAKARTA SELATAN,SETIA BUDI,5369,79,5144,89,57,136,2021-04-21
310102,KAB.ADM.KEP.SERIBU,KEP. SERIBU SELATAN,241,0,238,3,0,0,2021-04-21
317404,JAKARTA SELATAN,PASAR MINGGU,11264,78,10833,199,154,232,2021-04-21
317308,JAKARTA BARAT,KEMBANGAN,8948,88,8648,118,94,182,2021-04-21
317107,JAKARTA PUSAT,TANAH ABANG,5747,48,5553,114,32,80,2021-04-21
317206,JAKARTA UTARA,KELAPA GADING,5800,60,5573,89,78,138,2021-04-21
111111,Luar DKI & Proses Update,Luar DKI & Proses Update,143008,137,141294,1273,304,441,2021-04-21
317401,JAKARTA SELATAN,TEBET,7770,52,7472,145,101,153,2021-04-21
317506,JAKARTA TIMUR,CAKUNG,11572,86,11198,198,90,176,2021-04-21
317105,JAKARTA PUSAT,CEMPAKA PUTIH,4936,25,4780,76,55,80,2021-04-21
317301,JAKARTA BARAT,CENGKARENG,12796,95,12369,249,83,178,2021-04-21
317406,JAKARTA SELATAN,CILANDAK,8037,67,7744,120,106,173,2021-04-21
317204,JAKARTA UTARA,CILINCING,7795,64,7524,149,58,122,2021-04-21
317510,JAKARTA TIMUR,CIPAYUNG,10255,79,9898,116,162,241,2021-04-21
317103,JAKARTA PUSAT,KEMAYORAN,9769,109,9443,165,52,161,2021-04-21
317509,JAKARTA TIMUR,CIRACAS,9362,77,9036,163,86,163,2021-04-21
317101,JAKARTA PUSAT,GAMBIR,3729,26,3619,61,23,49,2021-04-21
317302,JAKARTA BARAT,GROGOL PETAMBURAN,8204,93,7893,155,63,156,2021-04-21
317409,JAKARTA SELATAN,JAGAKARSA,11551,108,11078,184,181,289,2021-04-21
317503,JAKARTA TIMUR,JATINEGARA,8817,54,8518,166,79,133,2021-04-21
317108,JAKARTA PUSAT,JOHAR BARU,4140,25,3988,97,30,55,2021-04-21
317306,JAKARTA BARAT,KALI DERES,7938,82,7669,140,47,129,2021-04-21
317407,JAKARTA SELATAN,KEBAYORAN BARU,6216,58,5995,92,71,129,2021-04-21
317405,JAKARTA SELATAN,KEBAYORAN LAMA,9225,94,8874,164,93,187,2021-04-21
317305,JAKARTA BARAT,KEBON JERUK,10329,112,9984,181,52,164,2021-04-21
317507,JAKARTA TIMUR,DUREN SAWIT,14078,133,13497,283,165,298,2021-04-21
317202,JAKARTA UTARA,TANJUNG PRIOK,12306,107,11891,211,97,204,2021-04-21
111111,Luar DKI & Proses Update,Luar DKI & Proses Update,143008,137,141294,1273,304,441,2021-04-22
317203,JAKARTA UTARA,KOJA,8420,66,8156,147,51,117,2021-04-22
317506,JAKARTA TIMUR,CAKUNG,11600,90,11211,198,101,191,2021-04-22
317501,JAKARTA TIMUR,MATRAMAN,6332,46,6092,132,62,108,2021-04-22
317106,JAKARTA PUSAT,MENTENG,3193,36,3065,65,27,63,2021-04-22
317307,JAKARTA BARAT,PALMERAH,7639,62,7350,164,63,125,2021-04-22
317408,JAKARTA SELATAN,PANCORAN,6343,62,6113,100,68,130,2021-04-22
317404,JAKARTA SELATAN,PASAR MINGGU,11296,81,10855,199,161,242,2021-04-22
317505,JAKARTA TIMUR,PASAR REBO,8081,59,7779,143,100,159,2021-04-22
317201,JAKARTA UTARA,PENJARINGAN,7901,141,7557,106,97,238,2021-04-22
317410,JAKARTA SELATAN,PESANGGRAHAN,7336,48,7112,113,63,111,2021-04-22
317403,JAKARTA SELATAN,MAMPANG PRAPATAN,5719,23,5562,100,34,57,2021-04-22
317502,JAKARTA TIMUR,PULO GADUNG,9724,109,9350,171,94,203,2021-04-22
317104,JAKARTA PUSAT,SENEN,4417,38,4272,89,18,56,2021-04-22
317402,JAKARTA SELATAN,SETIA BUDI,5381,79,5155,89,58,137,2021-04-22
317303,JAKARTA BARAT,TAMAN SARI,3848,61,3703,58,26,87,2021-04-22
317304,JAKARTA BARAT,TAMBORA,5762,82,5518,122,40,122,2021-04-22
317107,JAKARTA PUSAT,TANAH ABANG,5758,55,5558,114,31,86,2021-04-22
317202,JAKARTA UTARA,TANJUNG PRIOK,12338,112,11912,211,103,215,2021-04-22
317401,JAKARTA SELATAN,TEBET,7789,58,7492,145,94,152,2021-04-22
310101,KAB.ADM.KEP.SERIBU,KEP. SERIBU UTARA,309,1,303,4,1,2,2021-04-22
317102,JAKARTA PUSAT,SAWAH BESAR,4016,44,3859,74,39,83,2021-04-22
317508,JAKARTA TIMUR,MAKASAR,8633,76,8325,141,91,167,2021-04-22
317205,JAKARTA UTARA,PADEMANGAN,4911,43,4719,82,67,110,2021-04-22
317308,JAKARTA BARAT,KEMBANGAN,8971,86,8669,118,98,184,2021-04-22
317105,JAKARTA PUSAT,CEMPAKA PUTIH,4948,35,4785,77,51,86,2021-04-22
317301,JAKARTA BARAT,CENGKARENG,12839,99,12387,250,103,202,2021-04-22
317406,JAKARTA SELATAN,CILANDAK,8066,63,7761,120,122,185,2021-04-22
317204,JAKARTA UTARA,CILINCING,7806,63,7529,149,65,128,2021-04-22
317510,JAKARTA TIMUR,CIPAYUNG,10279,81,9909,116,173,254,2021-04-22
310102,KAB.ADM.KEP.SERIBU,KEP. SERIBU SELATAN,241,0,238,3,0,0,2021-04-22
317507,JAKARTA TIMUR,DUREN SAWIT,14095,135,13504,285,171,306,2021-04-22
317101,JAKARTA PUSAT,GAMBIR,3738,23,3624,61,30,53,2021-04-22
317302,JAKARTA BARAT,GROGOL PETAMBURAN,8213,88,7918,155,52,140,2021-04-22
317504,JAKARTA TIMUR,KRAMAT JATI,9989,100,9603,183,103,203,2021-04-22
317509,JAKARTA TIMUR,CIRACAS,9382,78,9040,164,100,178,2021-04-22
317503,JAKARTA TIMUR,JATINEGARA,8839,54,8521,167,97,151,2021-04-22
317108,JAKARTA PUSAT,JOHAR BARU,4145,26,3997,99,23,49,2021-04-22
317306,JAKARTA BARAT,KALI DERES,7964,76,7694,140,54,130,2021-04-22
317407,JAKARTA SELATAN,KEBAYORAN BARU,6235,52,6018,92,73,125,2021-04-22
317405,JAKARTA SELATAN,KEBAYORAN LAMA,9244,90,8892,165,97,187,2021-04-22
317305,JAKARTA BARAT,KEBON JERUK,10362,121,10000,181,60,181,2021-04-22
317206,JAKARTA UTARA,KELAPA GADING,5820,66,5602,90,62,128,2021-04-22
317409,JAKARTA SELATAN,JAGAKARSA,11565,98,11112,184,171,269,2021-04-22
317103,JAKARTA PUSAT,KEMAYORAN,9788,105,9464,166,53,158,2021-04-22
317101,JAKARTA PUSAT,GAMBIR,3743,23,3629,61,30,53,2021-04-23
317507,JAKARTA TIMUR,DUREN SAWIT,14145,136,13558,285,166,302,2021-04-23
317509,JAKARTA TIMUR,CIRACAS,9415,80,9066,164,105,185,2021-04-23
317510,JAKARTA TIMUR,CIPAYUNG,10324,82,9956,116,170,252,2021-04-23
317105,JAKARTA PUSAT,CEMPAKA PUTIH,4954,40,4790,77,47,87,2021-04-23
317406,JAKARTA SELATAN,CILANDAK,8089,67,7765,121,136,203,2021-04-23
317301,JAKARTA BARAT,CENGKARENG,12878,103,12419,250,106,209,2021-04-23
317506,JAKARTA TIMUR,CAKUNG,11622,88,11234,198,102,190,2021-04-23
317302,JAKARTA BARAT,GROGOL PETAMBURAN,8221,84,7937,156,44,128,2021-04-23
317204,JAKARTA UTARA,CILINCING,7808,64,7539,149,56,120,2021-04-23
317409,JAKARTA SELATAN,JAGAKARSA,11604,106,11125,186,187,293,2021-04-23
310101,KAB.ADM.KEP.SERIBU,KEP. SERIBU UTARA,310,1,303,4,2,3,2021-04-23
317108,JAKARTA PUSAT,JOHAR BARU,4150,26,4002,99,23,49,2021-04-23
111111,Luar DKI & Proses Update,Luar DKI & Proses Update,143008,137,141294,1273,304,441,2021-04-23
317401,JAKARTA SELATAN,TEBET,7814,60,7517,145,92,152,2021-04-23
317202,JAKARTA UTARA,TANJUNG PRIOK,12373,116,11946,211,100,216,2021-04-23
317107,JAKARTA PUSAT,TANAH ABANG,5779,66,5568,114,31,97,2021-04-23
317304,JAKARTA BARAT,TAMBORA,5773,83,5527,122,41,124,2021-04-23
317303,JAKARTA BARAT,TAMAN SARI,3853,64,3708,58,23,87,2021-04-23
317402,JAKARTA SELATAN,SETIA BUDI,5398,71,5172,89,66,137,2021-04-23
317104,JAKARTA PUSAT,SENEN,4445,38,4291,89,27,65,2021-04-23
317102,JAKARTA PUSAT,SAWAH BESAR,4028,49,3866,74,39,88,2021-04-23
317502,JAKARTA TIMUR,PULO GADUNG,9751,109,9382,171,89,198,2021-04-23
317410,JAKARTA SELATAN,PESANGGRAHAN,7347,42,7122,114,69,111,2021-04-23
317201,JAKARTA UTARA,PENJARINGAN,7915,142,7591,106,76,218,2021-04-23
317505,JAKARTA TIMUR,PASAR REBO,8096,51,7807,143,95,146,2021-04-23
317404,JAKARTA SELATAN,PASAR MINGGU,11319,82,10863,201,173,255,2021-04-23
317408,JAKARTA SELATAN,PANCORAN,6340,63,6101,101,75,138,2021-04-23
317307,JAKARTA BARAT,PALMERAH,7650,59,7365,164,62,121,2021-04-23
317205,JAKARTA UTARA,PADEMANGAN,4935,49,4750,82,54,103,2021-04-23
317306,JAKARTA BARAT,KALI DERES,7976,81,7705,140,50,131,2021-04-23
317407,JAKARTA SELATAN,KEBAYORAN BARU,6248,54,6028,92,74,128,2021-04-23
317405,JAKARTA SELATAN,KEBAYORAN LAMA,9262,91,8900,165,106,197,2021-04-23
317305,JAKARTA BARAT,KEBON JERUK,10384,122,10021,181,60,182,2021-04-23
317206,JAKARTA UTARA,KELAPA GADING,5833,65,5619,90,59,124,2021-04-23
317103,JAKARTA PUSAT,KEMAYORAN,9816,105,9486,167,58,163,2021-04-23
317503,JAKARTA TIMUR,JATINEGARA,8866,51,8554,167,94,145,2021-04-23
317308,JAKARTA BARAT,KEMBANGAN,8987,89,8685,118,95,184,2021-04-23
317203,JAKARTA UTARA,KOJA,8432,66,8183,147,36,102,2021-04-23
317504,JAKARTA TIMUR,KRAMAT JATI,10013,103,9633,183,94,197,2021-04-23
317508,JAKARTA TIMUR,MAKASAR,8655,70,8351,141,93,163,2021-04-23
317403,JAKARTA SELATAN,MAMPANG PRAPATAN,5725,22,5566,100,37,59,2021-04-23
317501,JAKARTA TIMUR,MATRAMAN,6339,43,6106,134,56,99,2021-04-23
317106,JAKARTA PUSAT,MENTENG,3196,34,3072,65,25,59,2021-04-23
310102,KAB.ADM.KEP.SERIBU,KEP. SERIBU SELATAN,241,0,238,3,0,0,2021-04-23
111111,Luar DKI & Proses Update,Luar DKI & Proses Update,143008,137,141294,1273,304,441,2021-04-24
317201,JAKARTA UTARA,PENJARINGAN,7937,142,7609,107,79,221,2021-04-24
317203,JAKARTA UTARA,KOJA,8450,68,8191,147,44,112,2021-04-24
317508,JAKARTA TIMUR,MAKASAR,8683,70,8385,141,87,157,2021-04-24
317403,JAKARTA SELATAN,MAMPANG PRAPATAN,5736,18,5583,100,35,53,2021-04-24
317501,JAKARTA TIMUR,MATRAMAN,6348,45,6109,134,60,105,2021-04-24
317106,JAKARTA PUSAT,MENTENG,3200,33,3083,66,18,51,2021-04-24
317205,JAKARTA UTARA,PADEMANGAN,4960,50,4764,82,64,114,2021-04-24
317307,JAKARTA BARAT,PALMERAH,7659,62,7372,164,61,123,2021-04-24
317408,JAKARTA SELATAN,PANCORAN,6360,71,6125,101,63,134,2021-04-24
317404,JAKARTA SELATAN,PASAR MINGGU,11348,84,10899,202,163,247,2021-04-24
317504,JAKARTA TIMUR,KRAMAT JATI,10031,99,9671,184,77,176,2021-04-24
317410,JAKARTA SELATAN,PESANGGRAHAN,7351,41,7139,115,56,97,2021-04-24
317102,JAKARTA PUSAT,SAWAH BESAR,4034,48,3877,74,35,83,2021-04-24
317104,JAKARTA PUSAT,SENEN,4454,41,4293,89,31,72,2021-04-24
317402,JAKARTA SELATAN,SETIA BUDI,5420,68,5195,89,68,136,2021-04-24
317303,JAKARTA BARAT,TAMAN SARI,3861,64,3715,58,24,88,2021-04-24
317304,JAKARTA BARAT,TAMBORA,5785,82,5536,122,45,127,2021-04-24
317107,JAKARTA PUSAT,TANAH ABANG,5783,65,5577,114,27,92,2021-04-24
317202,JAKARTA UTARA,TANJUNG PRIOK,12403,126,11981,212,84,210,2021-04-24
317401,JAKARTA SELATAN,TEBET,7834,61,7532,145,96,157,2021-04-24
317502,JAKARTA TIMUR,PULO GADUNG,9784,125,9402,172,85,210,2021-04-24
310101,KAB.ADM.KEP.SERIBU,KEP. SERIBU UTARA,312,1,303,4,4,5,2021-04-24
317505,JAKARTA TIMUR,PASAR REBO,8109,50,7834,144,81,131,2021-04-24
317308,JAKARTA BARAT,KEMBANGAN,9007,91,8719,118,79,170,2021-04-24
310102,KAB.ADM.KEP.SERIBU,KEP. SERIBU SELATAN,241,0,238,3,0,0,2021-04-24
317506,JAKARTA TIMUR,CAKUNG,11641,83,11269,200,89,172,2021-04-24
317105,JAKARTA PUSAT,CEMPAKA PUTIH,4959,37,4804,77,41,78,2021-04-24
317301,JAKARTA BARAT,CENGKARENG,12903,98,12455,252,98,196,2021-04-24
317406,JAKARTA SELATAN,CILANDAK,8102,70,7798,121,113,183,2021-04-24
317204,JAKARTA UTARA,CILINCING,7827,69,7548,149,61,130,2021-04-24
317509,JAKARTA TIMUR,CIRACAS,9439,78,9084,166,111,189,2021-04-24
317507,JAKARTA TIMUR,DUREN SAWIT,14190,143,13603,285,159,302,2021-04-24
317101,JAKARTA PUSAT,GAMBIR,3753,26,3640,61,26,52,2021-04-24
317302,JAKARTA BARAT,GROGOL PETAMBURAN,8239,85,7952,156,46,131,2021-04-24
317510,JAKARTA TIMUR,CIPAYUNG,10336,86,9989,116,145,231,2021-04-24
317409,JAKARTA SELATAN,JAGAKARSA,11658,106,11164,186,202,308,2021-04-24
317206,JAKARTA UTARA,KELAPA GADING,5850,64,5639,91,56,120,2021-04-24
317305,JAKARTA BARAT,KEBON JERUK,10405,120,10043,182,60,180,2021-04-24
317405,JAKARTA SELATAN,KEBAYORAN LAMA,9283,94,8933,166,90,184,2021-04-24
317407,JAKARTA SELATAN,KEBAYORAN BARU,6283,57,6044,92,90,147,2021-04-24
317103,JAKARTA PUSAT,KEMAYORAN,9828,100,9506,167,55,155,2021-04-24
317108,JAKARTA PUSAT,JOHAR BARU,4154,25,4008,99,22,47,2021-04-24
317503,JAKARTA TIMUR,JATINEGARA,8882,52,8566,169,95,147,2021-04-24
317306,JAKARTA BARAT,KALI DERES,7997,84,7724,140,49,133,2021-04-24
317201,JAKARTA UTARA,PENJARINGAN,7964,130,7638,107,89,219,2021-04-25
317403,JAKARTA SELATAN,MAMPANG PRAPATAN,5739,15,5592,100,32,47,2021-04-25
317501,JAKARTA TIMUR,MATRAMAN,6361,41,6125,134,61,102,2021-04-25
317106,JAKARTA PUSAT,MENTENG,3205,31,3094,66,14,45,2021-04-25
317205,JAKARTA UTARA,PADEMANGAN,4964,46,4775,82,61,107,2021-04-25
317307,JAKARTA BARAT,PALMERAH,7671,60,7391,164,56,116,2021-04-25
317408,JAKARTA SELATAN,PANCORAN,6368,71,6142,101,54,125,2021-04-25
317404,JAKARTA SELATAN,PASAR MINGGU,11375,82,10942,202,149,231,2021-04-25
317505,JAKARTA TIMUR,PASAR REBO,8129,49,7845,146,89,138,2021-04-25
317410,JAKARTA SELATAN,PESANGGRAHAN,7367,41,7173,115,38,79,2021-04-25
111111,Luar DKI & Proses Update,Luar DKI & Proses Update,143008,137,141294,1273,304,441,2021-04-25
317102,JAKARTA PUSAT,SAWAH BESAR,4046,43,3896,74,33,76,2021-04-25
317104,JAKARTA PUSAT,SENEN,4453,34,4303,89,27,61,2021-04-25
317402,JAKARTA SELATAN,SETIA BUDI,5424,49,5228,89,58,107,2021-04-25
317303,JAKARTA BARAT,TAMAN SARI,3874,61,3737,58,18,79,2021-04-25
317304,JAKARTA BARAT,TAMBORA,5796,79,5561,123,33,112,2021-04-25
317107,JAKARTA PUSAT,TANAH ABANG,5789,58,5592,114,25,83,2021-04-25
317202,JAKARTA UTARA,TANJUNG PRIOK,12433,127,12004,212,90,217,2021-04-25
317401,JAKARTA SELATAN,TEBET,7843,52,7568,145,78,130,2021-04-25
317508,JAKARTA TIMUR,MAKASAR,8708,61,8410,141,96,157,2021-04-25
317502,JAKARTA TIMUR,PULO GADUNG,9813,91,9464,172,86,177,2021-04-25
317504,JAKARTA TIMUR,KRAMAT JATI,10045,98,9681,184,82,180,2021-04-25
317407,JAKARTA SELATAN,KEBAYORAN BARU,6300,57,6069,92,82,139,2021-04-25
310101,KAB.ADM.KEP.SERIBU,KEP. SERIBU UTARA,315,2,305,4,4,6,2021-04-25
317203,JAKARTA UTARA,KOJA,8458,59,8216,147,36,95,2021-04-25
317105,JAKARTA PUSAT,CEMPAKA PUTIH,4964,36,4824,79,25,61,2021-04-25
317301,JAKARTA BARAT,CENGKARENG,12921,93,12480,257,91,184,2021-04-25
317406,JAKARTA SELATAN,CILANDAK,8115,63,7827,121,104,167,2021-04-25
317204,JAKARTA UTARA,CILINCING,7849,70,7566,149,64,134,2021-04-25
317509,JAKARTA TIMUR,CIRACAS,9450,63,9113,168,106,169,2021-04-25
317507,JAKARTA TIMUR,DUREN SAWIT,14221,134,13653,285,149,283,2021-04-25
317101,JAKARTA PUSAT,GAMBIR,3760,24,3647,62,27,51,2021-04-25
317302,JAKARTA BARAT,GROGOL PETAMBURAN,8250,75,7981,156,38,113,2021-04-25
317409,JAKARTA SELATAN,JAGAKARSA,11668,96,11227,186,159,255,2021-04-25
317510,JAKARTA TIMUR,CIPAYUNG,10375,74,10055,117,129,203,2021-04-25
317108,JAKARTA PUSAT,JOHAR BARU,4155,22,4020,99,14,36,2021-04-25
317306,JAKARTA BARAT,KALI DERES,8008,72,7746,140,50,122,2021-04-25
317506,JAKARTA TIMUR,CAKUNG,11648,75,11297,200,76,151,2021-04-25
317405,JAKARTA SELATAN,KEBAYORAN LAMA,9311,83,8985,166,77,160,2021-04-25
317305,JAKARTA BARAT,KEBON JERUK,10421,118,10065,182,56,174,2021-04-25
317206,JAKARTA UTARA,KELAPA GADING,5878,54,5677,91,56,110,2021-04-25
317103,JAKARTA PUSAT,KEMAYORAN,9837,96,9530,168,43,139,2021-04-25
317308,JAKARTA BARAT,KEMBANGAN,9025,86,8757,118,64,150,2021-04-25
317503,JAKARTA TIMUR,JATINEGARA,8899,48,8589,169,93,141,2021-04-25
310102,KAB.ADM.KEP.SERIBU,KEP. SERIBU SELATAN,242,0,239,3,0,0,2021-04-25
317405,JAKARTA SELATAN,KEBAYORAN LAMA,9321,84,8994,167,76,160,2021-04-26
317305,JAKARTA BARAT,KEBON JERUK,10427,111,10086,184,46,157,2021-04-26
317206,JAKARTA UTARA,KELAPA GADING,5890,51,5695,91,53,104,2021-04-26
317103,JAKARTA PUSAT,KEMAYORAN,9849,92,9543,169,45,137,2021-04-26
317308,JAKARTA BARAT,KEMBANGAN,9033,85,8783,118,47,132,2021-04-26
317504,JAKARTA TIMUR,KRAMAT JATI,10052,92,9697,185,78,170,2021-04-26
310101,KAB.ADM.KEP.SERIBU,KEP. SERIBU UTARA,315,2,305,4,4,6,2021-04-26
317203,JAKARTA UTARA,KOJA,8466,56,8232,147,31,87,2021-04-26
317508,JAKARTA TIMUR,MAKASAR,8709,57,8423,142,87,144,2021-04-26
317407,JAKARTA SELATAN,KEBAYORAN BARU,6311,58,6074,92,87,145,2021-04-26
310102,KAB.ADM.KEP.SERIBU,KEP. SERIBU SELATAN,242,0,239,3,0,0,2021-04-26
317306,JAKARTA BARAT,KALI DERES,8011,68,7754,141,48,116,2021-04-26
317406,JAKARTA SELATAN,CILANDAK,8126,69,7828,122,107,176,2021-04-26
317503,JAKARTA TIMUR,JATINEGARA,8908,43,8615,169,81,124,2021-04-26
317409,JAKARTA SELATAN,JAGAKARSA,11681,95,11234,186,166,261,2021-04-26
317302,JAKARTA BARAT,GROGOL PETAMBURAN,8255,67,7998,157,33,100,2021-04-26
317101,JAKARTA PUSAT,GAMBIR,3763,25,3649,62,27,52,2021-04-26
317507,JAKARTA TIMUR,DUREN SAWIT,14230,131,13665,286,148,279,2021-04-26
317509,JAKARTA TIMUR,CIRACAS,9461,68,9118,168,107,175,2021-04-26
317510,JAKARTA TIMUR,CIPAYUNG,10381,74,10060,118,129,203,2021-04-26
317204,JAKARTA UTARA,CILINCING,7858,72,7580,150,56,128,2021-04-26
317301,JAKARTA BARAT,CENGKARENG,12927,90,12497,257,83,173,2021-04-26
317105,JAKARTA PUSAT,CEMPAKA PUTIH,4967,38,4829,80,20,58,2021-04-26
317506,JAKARTA TIMUR,CAKUNG,11654,64,11314,200,76,140,2021-04-26
111111,Luar DKI & Proses Update,Luar DKI & Proses Update,143008,137,141294,1273,304,441,2021-04-26
317108,JAKARTA PUSAT,JOHAR BARU,4158,22,4022,99,15,37,2021-04-26
317403,JAKARTA SELATAN,MAMPANG PRAPATAN,5748,22,5593,100,33,55,2021-04-26
317501,JAKARTA TIMUR,MATRAMAN,6364,40,6145,134,45,85,2021-04-26
317106,JAKARTA PUSAT,MENTENG,3207,30,3097,66,14,44,2021-04-26
317401,JAKARTA SELATAN,TEBET,7848,51,7576,145,76,127,2021-04-26
317202,JAKARTA UTARA,TANJUNG PRIOK,12440,126,12017,212,85,211,2021-04-26
317107,JAKARTA PUSAT,TANAH ABANG,5791,52,5599,114,26,78,2021-04-26
317304,JAKARTA BARAT,TAMBORA,5808,73,5575,124,36,109,2021-04-26
317303,JAKARTA BARAT,TAMAN SARI,3880,61,3740,58,21,82,2021-04-26
317402,JAKARTA SELATAN,SETIA BUDI,5429,44,5242,89,54,98,2021-04-26
317104,JAKARTA PUSAT,SENEN,4459,34,4304,89,32,66,2021-04-26
317205,JAKARTA UTARA,PADEMANGAN,4985,50,4796,82,57,107,2021-04-26
317502,JAKARTA TIMUR,PULO GADUNG,9820,91,9485,173,71,162,2021-04-26
317307,JAKARTA BARAT,PALMERAH,7672,53,7404,164,51,104,2021-04-26
317408,JAKARTA SELATAN,PANCORAN,6383,67,6153,101,62,129,2021-04-26
317404,JAKARTA SELATAN,PASAR MINGGU,11395,82,10967,202,144,226,2021-04-26
317102,JAKARTA PUSAT,SAWAH BESAR,4051,43,3901,74,33,76,2021-04-26
317201,JAKARTA UTARA,PENJARINGAN,7972,124,7659,107,82,206,2021-04-26
317410,JAKARTA SELATAN,PESANGGRAHAN,7374,41,7174,116,43,84,2021-04-26
317505,JAKARTA TIMUR,PASAR REBO,8129,47,7852,148,82,129,2021-04-26
317508,JAKARTA TIMUR,MAKASAR,8713,57,8431,143,82,139,2021-04-27
317505,JAKARTA TIMUR,PASAR REBO,8135,48,7858,148,81,129,2021-04-27
317403,JAKARTA SELATAN,MAMPANG PRAPATAN,5752,21,5595,100,36,57,2021-04-27
317501,JAKARTA TIMUR,MATRAMAN,6374,38,6155,134,47,85,2021-04-27
317106,JAKARTA PUSAT,MENTENG,3215,28,3116,66,5,33,2021-04-27
317205,JAKARTA UTARA,PADEMANGAN,4997,54,4803,82,58,112,2021-04-27
317307,JAKARTA BARAT,PALMERAH,7688,57,7437,165,29,86,2021-04-27
317408,JAKARTA SELATAN,PANCORAN,6394,72,6163,101,58,130,2021-04-27
317404,JAKARTA SELATAN,PASAR MINGGU,11414,83,10977,202,152,235,2021-04-27
317201,JAKARTA UTARA,PENJARINGAN,7985,119,7678,108,80,199,2021-04-27
317104,JAKARTA PUSAT,SENEN,4468,34,4309,89,36,70,2021-04-27
317502,JAKARTA TIMUR,PULO GADUNG,9837,96,9498,174,69,165,2021-04-27
317102,JAKARTA PUSAT,SAWAH BESAR,4062,46,3922,74,20,66,2021-04-27
317504,JAKARTA TIMUR,KRAMAT JATI,10071,101,9709,185,76,177,2021-04-27
317402,JAKARTA SELATAN,SETIA BUDI,5449,55,5247,89,58,113,2021-04-27
317303,JAKARTA BARAT,TAMAN SARI,3893,64,3752,58,19,83,2021-04-27
317304,JAKARTA BARAT,TAMBORA,5820,69,5600,124,27,96,2021-04-27
317202,JAKARTA UTARA,TANJUNG PRIOK,12452,129,12023,213,87,216,2021-04-27
317401,JAKARTA SELATAN,TEBET,7862,58,7585,146,73,131,2021-04-27
111111,Luar DKI & Proses Update,Luar DKI & Proses Update,143008,137,141294,1273,304,441,2021-04-27
317410,JAKARTA SELATAN,PESANGGRAHAN,7383,45,7177,116,45,90,2021-04-27
317203,JAKARTA UTARA,KOJA,8472,59,8236,147,30,89,2021-04-27
317107,JAKARTA PUSAT,TANAH ABANG,5800,57,5609,114,20,77,2021-04-27
310102,KAB.ADM.KEP.SERIBU,KEP. SERIBU SELATAN,242,0,239,3,0,0,2021-04-27
310101,KAB.ADM.KEP.SERIBU,KEP. SERIBU UTARA,315,2,306,4,3,5,2021-04-27
317105,JAKARTA PUSAT,CEMPAKA PUTIH,4980,43,4846,80,11,54,2021-04-27
317301,JAKARTA BARAT,CENGKARENG,12944,90,12516,258,80,170,2021-04-27
317406,JAKARTA SELATAN,CILANDAK,8139,66,7842,122,109,175,2021-04-27
317506,JAKARTA TIMUR,CAKUNG,11689,73,11332,200,84,157,2021-04-27
317204,JAKARTA UTARA,CILINCING,7865,67,7588,150,60,127,2021-04-27
317510,JAKARTA TIMUR,CIPAYUNG,10389,72,10074,118,125,197,2021-04-27
317507,JAKARTA TIMUR,DUREN SAWIT,14266,142,13676,286,162,304,2021-04-27
317101,JAKARTA PUSAT,GAMBIR,3767,22,3662,62,21,43,2021-04-27
317302,JAKARTA BARAT,GROGOL PETAMBURAN,8268,70,8016,157,25,95,2021-04-27
317509,JAKARTA TIMUR,CIRACAS,9473,75,9125,168,105,180,2021-04-27
317503,JAKARTA TIMUR,JATINEGARA,8918,49,8619,170,80,129,2021-04-27
317108,JAKARTA PUSAT,JOHAR BARU,4164,23,4032,99,10,33,2021-04-27
317306,JAKARTA BARAT,KALI DERES,8015,64,7771,141,39,103,2021-04-27
317407,JAKARTA SELATAN,KEBAYORAN BARU,6316,56,6082,92,86,142,2021-04-27
317405,JAKARTA SELATAN,KEBAYORAN LAMA,9335,83,9008,168,76,159,2021-04-27
317305,JAKARTA BARAT,KEBON JERUK,10441,104,10104,185,48,152,2021-04-27
317206,JAKARTA UTARA,KELAPA GADING,5887,51,5696,91,49,100,2021-04-27
317409,JAKARTA SELATAN,JAGAKARSA,11697,84,11257,186,170,254,2021-04-27
317103,JAKARTA PUSAT,KEMAYORAN,9864,89,9570,169,36,125,2021-04-27
317308,JAKARTA BARAT,KEMBANGAN,9056,81,8799,119,57,138,2021-04-27
317404,JAKARTA SELATAN,PASAR MINGGU,11445,89,11037,202,117,206,2021-04-28
317408,JAKARTA SELATAN,PANCORAN,6414,76,6181,101,56,132,2021-04-28
317307,JAKARTA BARAT,PALMERAH,7697,58,7439,165,35,93,2021-04-28
317501,JAKARTA TIMUR,MATRAMAN,6396,44,6158,134,60,104,2021-04-28
317106,JAKARTA PUSAT,MENTENG,3233,33,3117,67,16,49,2021-04-28
317403,JAKARTA SELATAN,MAMPANG PRAPATAN,5760,22,5602,100,36,58,2021-04-28
317505,JAKARTA TIMUR,PASAR REBO,8153,46,7863,148,96,142,2021-04-28
317205,JAKARTA UTARA,PADEMANGAN,5025,42,4821,82,80,122,2021-04-28
317201,JAKARTA UTARA,PENJARINGAN,8017,120,7692,108,97,217,2021-04-28
317401,JAKARTA SELATAN,TEBET,7883,58,7614,146,65,123,2021-04-28
317502,JAKARTA TIMUR,PULO GADUNG,9870,95,9514,174,87,182,2021-04-28
317102,JAKARTA PUSAT,SAWAH BESAR,4068,45,3924,74,25,70,2021-04-28
317104,JAKARTA PUSAT,SENEN,4474,37,4310,90,37,74,2021-04-28
317402,JAKARTA SELATAN,SETIA BUDI,5467,58,5266,89,54,112,2021-04-28
317303,JAKARTA BARAT,TAMAN SARI,3901,57,3759,58,27,84,2021-04-28
317304,JAKARTA BARAT,TAMBORA,5836,64,5608,124,40,104,2021-04-28
317107,JAKARTA PUSAT,TANAH ABANG,5818,66,5613,114,25,91,2021-04-28
317202,JAKARTA UTARA,TANJUNG PRIOK,12479,141,12026,213,99,240,2021-04-28
317508,JAKARTA TIMUR,MAKASAR,8732,58,8434,143,97,155,2021-04-28
111111,Luar DKI & Proses Update,Luar DKI & Proses Update,143008,137,141294,1273,304,441,2021-04-28
317410,JAKARTA SELATAN,PESANGGRAHAN,7392,41,7194,117,40,81,2021-04-28
317504,JAKARTA TIMUR,KRAMAT JATI,10087,90,9724,185,88,178,2021-04-28
317206,JAKARTA UTARA,KELAPA GADING,5915,60,5698,92,65,125,2021-04-28
310101,KAB.ADM.KEP.SERIBU,KEP. SERIBU UTARA,316,3,306,4,3,6,2021-04-28
317506,JAKARTA TIMUR,CAKUNG,11709,78,11351,201,79,157,2021-04-28
317105,JAKARTA PUSAT,CEMPAKA PUTIH,4991,45,4849,80,17,62,2021-04-28
317406,JAKARTA SELATAN,CILANDAK,8175,59,7894,123,99,158,2021-04-28
317204,JAKARTA UTARA,CILINCING,7892,76,7589,150,77,153,2021-04-28
317203,JAKARTA UTARA,KOJA,8500,66,8236,150,48,114,2021-04-28
317509,JAKARTA TIMUR,CIRACAS,9495,71,9132,169,123,194,2021-04-28
317507,JAKARTA TIMUR,DUREN SAWIT,14299,132,13693,287,187,319,2021-04-28
317101,JAKARTA PUSAT,GAMBIR,3778,22,3664,62,30,52,2021-04-28
317302,JAKARTA BARAT,GROGOL PETAMBURAN,8285,64,8026,158,37,101,2021-04-28
317409,JAKARTA SELATAN,JAGAKARSA,11743,81,11335,186,141,222,2021-04-28
317510,JAKARTA TIMUR,CIPAYUNG,10412,70,10093,118,131,201,2021-04-28
317108,JAKARTA PUSAT,JOHAR BARU,4174,26,4031,101,16,42,2021-04-28
317503,JAKARTA TIMUR,JATINEGARA,8935,51,8621,171,92,143,2021-04-28
310102,KAB.ADM.KEP.SERIBU,KEP. SERIBU SELATAN,242,0,239,3,0,0,2021-04-28
317308,JAKARTA BARAT,KEMBANGAN,9068,81,8801,120,66,147,2021-04-28
317103,JAKARTA PUSAT,KEMAYORAN,9892,86,9584,171,51,137,2021-04-28
317301,JAKARTA BARAT,CENGKARENG,13014,102,12520,258,134,236,2021-04-28
317405,JAKARTA SELATAN,KEBAYORAN LAMA,9360,76,9044,168,72,148,2021-04-28
317407,JAKARTA SELATAN,KEBAYORAN BARU,6341,54,6112,92,83,137,2021-04-28
317306,JAKARTA BARAT,KALI DERES,8033,74,7770,141,48,122,2021-04-28
317305,JAKARTA BARAT,KEBON JERUK,10470,109,10116,185,60,169,2021-04-28
317302,JAKARTA BARAT,GROGOL PETAMBURAN,8298,67,8030,158,43,110,2021-04-29
317506,JAKARTA TIMUR,CAKUNG,11740,82,11355,201,102,184,2021-04-29
317301,JAKARTA BARAT,CENGKARENG,13036,109,12523,258,146,255,2021-04-29
317406,JAKARTA SELATAN,CILANDAK,8201,62,7902,123,114,176,2021-04-29
317204,JAKARTA UTARA,CILINCING,7899,73,7611,152,63,136,2021-04-29
317510,JAKARTA TIMUR,CIPAYUNG,10437,63,10132,118,124,187,2021-04-29
317509,JAKARTA TIMUR,CIRACAS,9529,73,9178,170,108,181,2021-04-29
317507,JAKARTA TIMUR,DUREN SAWIT,14329,139,13757,288,145,284,2021-04-29
111111,Luar DKI & Proses Update,Luar DKI & Proses Update,143008,137,141294,1273,304,441,2021-04-29
317101,JAKARTA PUSAT,GAMBIR,3796,25,3667,62,42,67,2021-04-29
317105,JAKARTA PUSAT,CEMPAKA PUTIH,4998,50,4851,80,17,67,2021-04-29
317409,JAKARTA SELATAN,JAGAKARSA,11785,80,11343,187,175,255,2021-04-29
317503,JAKARTA TIMUR,JATINEGARA,8948,55,8635,171,87,142,2021-04-29
317401,JAKARTA SELATAN,TEBET,7884,54,7618,146,66,120,2021-04-29
317202,JAKARTA UTARA,TANJUNG PRIOK,12492,142,12044,216,90,232,2021-04-29
317107,JAKARTA PUSAT,TANAH ABANG,5823,64,5616,114,29,93,2021-04-29
317304,JAKARTA BARAT,TAMBORA,5846,69,5611,124,42,111,2021-04-29
317303,JAKARTA BARAT,TAMAN SARI,3907,61,3759,59,28,89,2021-04-29
317402,JAKARTA SELATAN,SETIA BUDI,5478,62,5265,92,59,121,2021-04-29
317104,JAKARTA PUSAT,SENEN,4477,36,4314,90,37,73,2021-04-29
317102,JAKARTA PUSAT,SAWAH BESAR,4072,48,3925,74,25,73,2021-04-29
317502,JAKARTA TIMUR,PULO GADUNG,9901,107,9534,175,85,192,2021-04-29
317410,JAKARTA SELATAN,PESANGGRAHAN,7396,42,7195,118,41,83,2021-04-29
317201,JAKARTA UTARA,PENJARINGAN,8034,131,7707,108,88,219,2021-04-29
317505,JAKARTA TIMUR,PASAR REBO,8176,51,7894,149,82,133,2021-04-29
317404,JAKARTA SELATAN,PASAR MINGGU,11474,91,11047,204,132,223,2021-04-29
317408,JAKARTA SELATAN,PANCORAN,6421,71,6187,101,62,133,2021-04-29
317307,JAKARTA BARAT,PALMERAH,7709,54,7447,165,43,97,2021-04-29
317108,JAKARTA PUSAT,JOHAR BARU,4179,25,4034,101,19,44,2021-04-29
317106,JAKARTA PUSAT,MENTENG,3242,33,3125,67,17,50,2021-04-29
317306,JAKARTA BARAT,KALI DERES,8039,73,7775,141,50,123,2021-04-29
317407,JAKARTA SELATAN,KEBAYORAN BARU,6364,55,6119,92,98,153,2021-04-29
317305,JAKARTA BARAT,KEBON JERUK,10489,102,10128,186,73,175,2021-04-29
317206,JAKARTA UTARA,KELAPA GADING,5919,61,5705,93,60,121,2021-04-29
317103,JAKARTA PUSAT,KEMAYORAN,9919,86,9599,171,63,149,2021-04-29
317308,JAKARTA BARAT,KEMBANGAN,9081,67,8818,120,76,143,2021-04-29
317405,JAKARTA SELATAN,KEBAYORAN LAMA,9375,76,9048,168,83,159,2021-04-29
310101,KAB.ADM.KEP.SERIBU,KEP. SERIBU UTARA,317,3,306,4,4,7,2021-04-29
310102,KAB.ADM.KEP.SERIBU,KEP. SERIBU SELATAN,242,0,239,3,0,0,2021-04-29
317501,JAKARTA TIMUR,MATRAMAN,6402,47,6183,135,37,84,2021-04-29
317403,JAKARTA SELATAN,MAMPANG PRAPATAN,5771,24,5603,100,44,68,2021-04-29
317205,JAKARTA UTARA,PADEMANGAN,5034,49,4851,82,52,101,2021-04-29
317508,JAKARTA TIMUR,MAKASAR,8752,59,8446,143,104,163,2021-04-29
317504,JAKARTA TIMUR,KRAMAT JATI,10117,98,9747,185,87,185,2021-04-29
317203,JAKARTA UTARA,KOJA,8505,68,8238,152,47,115,2021-04-29
317508,JAKARTA TIMUR,MAKASAR,8762,61,8457,143,101,162,2021-05-01
317106,JAKARTA PUSAT,MENTENG,3245,33,3129,67,16,49,2021-05-01
317205,JAKARTA UTARA,PADEMANGAN,5051,53,4859,82,57,110,2021-05-01
317307,JAKARTA BARAT,PALMERAH,7723,52,7465,166,40,92,2021-05-01
317408,JAKARTA SELATAN,PANCORAN,6435,70,6209,101,55,125,2021-05-01
317404,JAKARTA SELATAN,PASAR MINGGU,11496,99,11063,204,130,229,2021-05-01
317505,JAKARTA TIMUR,PASAR REBO,8189,49,7904,150,86,135,2021-05-01
317201,JAKARTA UTARA,PENJARINGAN,8046,132,7715,108,91,223,2021-05-01
317403,JAKARTA SELATAN,MAMPANG PRAPATAN,5778,26,5610,100,42,68,2021-05-01
317107,JAKARTA PUSAT,TANAH ABANG,5829,60,5627,114,28,88,2021-05-01
317102,JAKARTA PUSAT,SAWAH BESAR,4077,46,3936,75,20,66,2021-05-01
317104,JAKARTA PUSAT,SENEN,4481,37,4319,91,34,71,2021-05-01
317402,JAKARTA SELATAN,SETIA BUDI,5483,61,5275,92,55,116,2021-05-01
317303,JAKARTA BARAT,TAMAN SARI,3917,59,3773,59,26,85,2021-05-01
317304,JAKARTA BARAT,TAMBORA,5875,78,5622,124,51,129,2021-05-01
317504,JAKARTA TIMUR,KRAMAT JATI,10130,85,9768,185,92,177,2021-05-01
317202,JAKARTA UTARA,TANJUNG PRIOK,12516,144,12064,217,91,235,2021-05-01
317401,JAKARTA SELATAN,TEBET,7897,58,7627,146,66,124,2021-05-01
111111,Luar DKI & Proses Update,Luar DKI & Proses Update,143008,137,141294,1273,304,441,2021-05-01
317410,JAKARTA SELATAN,PESANGGRAHAN,7422,38,7207,118,59,97,2021-05-01
317203,JAKARTA UTARA,KOJA,8540,72,8258,152,58,130,2021-05-01
317502,JAKARTA TIMUR,PULO GADUNG,9913,109,9547,175,82,191,2021-05-01
310102,KAB.ADM.KEP.SERIBU,KEP. SERIBU SELATAN,242,0,239,3,0,0,2021-05-01
310101,KAB.ADM.KEP.SERIBU,KEP. SERIBU UTARA,318,3,307,4,4,7,2021-05-01
317506,JAKARTA TIMUR,CAKUNG,11754,85,11381,201,87,172,2021-05-01
317105,JAKARTA PUSAT,CEMPAKA PUTIH,5023,71,4853,80,19,90,2021-05-01
317301,JAKARTA BARAT,CENGKARENG,13183,111,12558,260,254,365,2021-05-01
317406,JAKARTA SELATAN,CILANDAK,8217,59,7915,123,120,179,2021-05-01
317204,JAKARTA UTARA,CILINCING,7912,68,7627,152,65,133,2021-05-01
317510,JAKARTA TIMUR,CIPAYUNG,10456,71,10134,120,131,202,2021-05-01
317509,JAKARTA TIMUR,CIRACAS,9541,85,9188,171,97,182,2021-05-01
317507,JAKARTA TIMUR,DUREN SAWIT,14342,143,13773,288,138,281,2021-05-01
317101,JAKARTA PUSAT,GAMBIR,3803,28,3679,62,34,62,2021-05-01
317302,JAKARTA BARAT,GROGOL PETAMBURAN,8306,67,8038,160,41,108,2021-05-01
317501,JAKARTA TIMUR,MATRAMAN,6428,60,6194,135,39,99,2021-05-01
317503,JAKARTA TIMUR,JATINEGARA,8977,58,8664,171,84,142,2021-05-01
317409,JAKARTA SELATAN,JAGAKARSA,11810,77,11359,187,187,264,2021-05-01
317308,JAKARTA BARAT,KEMBANGAN,9099,67,8845,120,67,134,2021-05-01
317206,JAKARTA UTARA,KELAPA GADING,5940,60,5720,94,66,126,2021-05-01
317305,JAKARTA BARAT,KEBON JERUK,10505,104,10150,186,65,169,2021-05-01
317103,JAKARTA PUSAT,KEMAYORAN,9946,94,9613,172,67,161,2021-05-01
317407,JAKARTA SELATAN,KEBAYORAN BARU,6404,61,6137,92,114,175,2021-05-01
317306,JAKARTA BARAT,KALI DERES,8051,70,7802,141,38,108,2021-05-01
317108,JAKARTA PUSAT,JOHAR BARU,4181,30,4036,101,14,44,2021-05-01
317405,JAKARTA SELATAN,KEBAYORAN LAMA,9405,74,9069,168,94,168,2021-05-01
317203,JAKARTA UTARA,KOJA,8570,87,8279,152,52,139,2021-05-02
317504,JAKARTA TIMUR,KRAMAT JATI,10150,90,9783,185,92,182,2021-05-02
317508,JAKARTA TIMUR,MAKASAR,8775,74,8472,143,86,160,2021-05-02
317403,JAKARTA SELATAN,MAMPANG PRAPATAN,5785,28,5618,100,39,67,2021-05-02
317501,JAKARTA TIMUR,MATRAMAN,6441,58,6205,136,42,100,2021-05-02
317106,JAKARTA PUSAT,MENTENG,3253,36,3132,67,18,54,2021-05-02
317205,JAKARTA UTARA,PADEMANGAN,5070,57,4868,83,62,119,2021-05-02
317307,JAKARTA BARAT,PALMERAH,7732,53,7479,166,34,87,2021-05-02
317201,JAKARTA UTARA,PENJARINGAN,8085,116,7772,108,89,205,2021-05-02
317404,JAKARTA SELATAN,PASAR MINGGU,11514,91,11097,204,122,213,2021-05-02
317505,JAKARTA TIMUR,PASAR REBO,8209,52,7917,150,90,142,2021-05-02
310101,KAB.ADM.KEP.SERIBU,KEP. SERIBU UTARA,320,2,309,4,5,7,2021-05-02
317410,JAKARTA SELATAN,PESANGGRAHAN,7435,32,7228,119,56,88,2021-05-02
317502,JAKARTA TIMUR,PULO GADUNG,9946,109,9566,176,95,204,2021-05-02
317102,JAKARTA PUSAT,SAWAH BESAR,4090,34,3955,75,26,60,2021-05-02
317104,JAKARTA PUSAT,SENEN,4491,34,4335,91,31,65,2021-05-02
317402,JAKARTA SELATAN,SETIA BUDI,5494,63,5286,93,52,115,2021-05-02
317303,JAKARTA BARAT,TAMAN SARI,3929,54,3787,60,28,82,2021-05-02
317408,JAKARTA SELATAN,PANCORAN,6450,68,6226,102,54,122,2021-05-02
310102,KAB.ADM.KEP.SERIBU,KEP. SERIBU SELATAN,242,0,239,3,0,0,2021-05-02
317405,JAKARTA SELATAN,KEBAYORAN LAMA,9426,68,9095,169,94,162,2021-05-02
317103,JAKARTA PUSAT,KEMAYORAN,9973,82,9649,173,69,151,2021-05-02
111111,Luar DKI & Proses Update,Luar DKI & Proses Update,143008,137,141294,1273,304,441,2021-05-02
317506,JAKARTA TIMUR,CAKUNG,11773,94,11398,202,79,173,2021-05-02
317105,JAKARTA PUSAT,CEMPAKA PUTIH,5033,73,4859,80,21,94,2021-05-02
317301,JAKARTA BARAT,CENGKARENG,13219,110,12606,260,243,353,2021-05-02
317406,JAKARTA SELATAN,CILANDAK,8229,58,7952,123,96,154,2021-05-02
317204,JAKARTA UTARA,CILINCING,7928,73,7641,152,62,135,2021-05-02
317510,JAKARTA TIMUR,CIPAYUNG,10472,79,10153,120,120,199,2021-05-02
317509,JAKARTA TIMUR,CIRACAS,9556,90,9197,172,97,187,2021-05-02
317308,JAKARTA BARAT,KEMBANGAN,9118,62,8868,120,68,130,2021-05-02
317507,JAKARTA TIMUR,DUREN SAWIT,14380,141,13818,289,132,273,2021-05-02
317302,JAKARTA BARAT,GROGOL PETAMBURAN,8322,64,8053,160,45,109,2021-05-02
317503,JAKARTA TIMUR,JATINEGARA,9007,66,8676,171,94,160,2021-05-02
317108,JAKARTA PUSAT,JOHAR BARU,4190,29,4043,101,17,46,2021-05-02
317306,JAKARTA BARAT,KALI DERES,8072,76,7816,141,39,115,2021-05-02
317407,JAKARTA SELATAN,KEBAYORAN BARU,6433,58,6170,93,112,170,2021-05-02
317304,JAKARTA BARAT,TAMBORA,5894,75,5645,126,48,123,2021-05-02
317305,JAKARTA BARAT,KEBON JERUK,10522,103,10173,186,60,163,2021-05-02
317206,JAKARTA UTARA,KELAPA GADING,5954,64,5741,95,54,118,2021-05-02
317101,JAKARTA PUSAT,GAMBIR,3812,28,3684,63,37,65,2021-05-02
317409,JAKARTA SELATAN,JAGAKARSA,11832,67,11386,187,192,259,2021-05-02
317107,JAKARTA PUSAT,TANAH ABANG,5837,58,5640,114,25,83,2021-05-02
317202,JAKARTA UTARA,TANJUNG PRIOK,12549,142,12100,219,88,230,2021-05-02
317401,JAKARTA SELATAN,TEBET,7912,65,7647,146,54,119,2021-05-02
317301,JAKARTA BARAT,CENGKARENG,13246,107,12626,260,253,360,2021-05-03
317308,JAKARTA BARAT,KEMBANGAN,9131,60,8881,120,70,130,2021-05-03
317103,JAKARTA PUSAT,KEMAYORAN,9994,88,9652,174,80,168,2021-05-03
317206,JAKARTA UTARA,KELAPA GADING,5973,65,5756,95,57,122,2021-05-03
317305,JAKARTA BARAT,KEBON JERUK,10526,96,10185,186,59,155,2021-05-03
317405,JAKARTA SELATAN,KEBAYORAN LAMA,9456,75,9116,169,96,171,2021-05-03
317407,JAKARTA SELATAN,KEBAYORAN BARU,6477,61,6199,93,124,185,2021-05-03
317306,JAKARTA BARAT,KALI DERES,8092,73,7831,143,45,118,2021-05-03
317108,JAKARTA PUSAT,JOHAR BARU,4193,31,4044,101,17,48,2021-05-03
317503,JAKARTA TIMUR,JATINEGARA,9024,65,8710,171,78,143,2021-05-03
310102,KAB.ADM.KEP.SERIBU,KEP. SERIBU SELATAN,242,0,239,3,0,0,2021-05-03
317302,JAKARTA BARAT,GROGOL PETAMBURAN,8330,66,8057,160,47,113,2021-05-03
317101,JAKARTA PUSAT,GAMBIR,3823,31,3688,63,41,72,2021-05-03
317507,JAKARTA TIMUR,DUREN SAWIT,14396,128,13843,289,136,264,2021-05-03
317509,JAKARTA TIMUR,CIRACAS,9574,92,9227,172,83,175,2021-05-03
317510,JAKARTA TIMUR,CIPAYUNG,10495,73,10178,120,124,197,2021-05-03
317204,JAKARTA UTARA,CILINCING,7952,68,7661,154,69,137,2021-05-03
317406,JAKARTA SELATAN,CILANDAK,8249,63,7963,126,97,160,2021-05-03
317105,JAKARTA PUSAT,CEMPAKA PUTIH,5034,69,4866,80,19,88,2021-05-03
317409,JAKARTA SELATAN,JAGAKARSA,11843,67,11412,187,177,244,2021-05-03
317404,JAKARTA SELATAN,PASAR MINGGU,11534,93,11116,205,120,213,2021-05-03
317504,JAKARTA TIMUR,KRAMAT JATI,10165,85,9805,185,90,175,2021-05-03
317401,JAKARTA SELATAN,TEBET,7939,63,7667,147,62,125,2021-05-03
317202,JAKARTA UTARA,TANJUNG PRIOK,12555,133,12124,219,79,212,2021-05-03
317107,JAKARTA PUSAT,TANAH ABANG,5840,58,5643,114,25,83,2021-05-03
317304,JAKARTA BARAT,TAMBORA,5907,72,5651,126,58,130,2021-05-03
317303,JAKARTA BARAT,TAMAN SARI,3936,51,3795,60,30,81,2021-05-03
317402,JAKARTA SELATAN,SETIA BUDI,5502,53,5302,93,54,107,2021-05-03
317104,JAKARTA PUSAT,SENEN,4494,36,4339,91,28,64,2021-05-03
317102,JAKARTA PUSAT,SAWAH BESAR,4105,38,3962,75,30,68,2021-05-03
317502,JAKARTA TIMUR,PULO GADUNG,9971,106,9592,179,94,200,2021-05-03
317410,JAKARTA SELATAN,PESANGGRAHAN,7450,29,7243,119,59,88,2021-05-03
317201,JAKARTA UTARA,PENJARINGAN,8095,103,7801,108,83,186,2021-05-03
317505,JAKARTA TIMUR,PASAR REBO,8223,50,7934,151,88,138,2021-05-03
317408,JAKARTA SELATAN,PANCORAN,6464,70,6228,102,64,134,2021-05-03
317307,JAKARTA BARAT,PALMERAH,7743,59,7481,167,36,95,2021-05-03
317205,JAKARTA UTARA,PADEMANGAN,5077,56,4878,83,60,116,2021-05-03
317106,JAKARTA PUSAT,MENTENG,3255,37,3133,67,18,55,2021-05-03
317501,JAKARTA TIMUR,MATRAMAN,6455,55,6221,136,43,98,2021-05-03
317403,JAKARTA SELATAN,MAMPANG PRAPATAN,5801,34,5627,100,40,74,2021-05-03
317508,JAKARTA TIMUR,MAKASAR,8792,74,8498,143,77,151,2021-05-03
317203,JAKARTA UTARA,KOJA,8596,85,8302,152,57,142,2021-05-03
310101,KAB.ADM.KEP.SERIBU,KEP. SERIBU UTARA,321,2,309,4,6,8,2021-05-03
317506,JAKARTA TIMUR,CAKUNG,11789,93,11412,204,80,173,2021-05-03
111111,Luar DKI & Proses Update,Luar DKI & Proses Update,143008,137,141294,1273,304,441,2021-05-03
317408,JAKARTA SELATAN,PANCORAN,6468,65,6240,103,60,125,2021-05-04
317404,JAKARTA SELATAN,PASAR MINGGU,11549,94,11127,207,121,215,2021-05-04
317103,JAKARTA PUSAT,KEMAYORAN,10006,95,9659,174,78,173,2021-05-04
317206,JAKARTA UTARA,KELAPA GADING,5975,56,5775,96,48,104,2021-05-04
111111,Luar DKI & Proses Update,Luar DKI & Proses Update,143008,137,141294,1273,304,441,2021-05-04
317506,JAKARTA TIMUR,CAKUNG,11797,93,11431,204,69,162,2021-05-04
317105,JAKARTA PUSAT,CEMPAKA PUTIH,5037,68,4876,80,13,81,2021-05-04
317301,JAKARTA BARAT,CENGKARENG,13263,113,12649,260,241,354,2021-05-04
317406,JAKARTA SELATAN,CILANDAK,8252,63,7969,126,94,157,2021-05-04
317401,JAKARTA SELATAN,TEBET,7953,60,7699,148,46,106,2021-05-04
317204,JAKARTA UTARA,CILINCING,7954,68,7672,154,60,128,2021-05-04
317509,JAKARTA TIMUR,CIRACAS,9577,93,9229,174,81,174,2021-05-04
317507,JAKARTA TIMUR,DUREN SAWIT,14411,125,13876,291,119,244,2021-05-04
317101,JAKARTA PUSAT,GAMBIR,3828,32,3696,64,36,68,2021-05-04
317302,JAKARTA BARAT,GROGOL PETAMBURAN,8334,66,8069,160,39,105,2021-05-04
317409,JAKARTA SELATAN,JAGAKARSA,11859,77,11413,190,179,256,2021-05-04
317503,JAKARTA TIMUR,JATINEGARA,9032,65,8718,172,77,142,2021-05-04
317108,JAKARTA PUSAT,JOHAR BARU,4196,32,4045,101,18,50,2021-05-04
317306,JAKARTA BARAT,KALI DERES,8098,67,7846,143,42,109,2021-05-04
317407,JAKARTA SELATAN,KEBAYORAN BARU,6500,72,6227,93,108,180,2021-05-04
317510,JAKARTA TIMUR,CIPAYUNG,10498,73,10186,120,119,192,2021-05-04
317202,JAKARTA UTARA,TANJUNG PRIOK,12589,144,12151,220,74,218,2021-05-04
317305,JAKARTA BARAT,KEBON JERUK,10538,93,10204,186,55,148,2021-05-04
317304,JAKARTA BARAT,TAMBORA,5914,73,5657,126,58,131,2021-05-04
317104,JAKARTA PUSAT,SENEN,4496,39,4346,91,20,59,2021-05-04
317402,JAKARTA SELATAN,SETIA BUDI,5510,56,5318,94,42,98,2021-05-04
317102,JAKARTA PUSAT,SAWAH BESAR,4111,44,3964,75,28,72,2021-05-04
317502,JAKARTA TIMUR,PULO GADUNG,9976,102,9614,179,81,183,2021-05-04
317410,JAKARTA SELATAN,PESANGGRAHAN,7456,31,7248,119,58,89,2021-05-04
317405,JAKARTA SELATAN,KEBAYORAN LAMA,9463,75,9128,169,91,166,2021-05-04
317201,JAKARTA UTARA,PENJARINGAN,8118,102,7821,108,87,189,2021-05-04
317107,JAKARTA PUSAT,TANAH ABANG,5843,52,5652,114,25,77,2021-05-04
317505,JAKARTA TIMUR,PASAR REBO,8227,47,7939,151,90,137,2021-05-04
317308,JAKARTA BARAT,KEMBANGAN,9134,57,8897,120,60,117,2021-05-04
317303,JAKARTA BARAT,TAMAN SARI,3941,50,3805,60,26,76,2021-05-04
310101,KAB.ADM.KEP.SERIBU,KEP. SERIBU UTARA,321,2,311,4,4,6,2021-05-04
317203,JAKARTA UTARA,KOJA,8594,82,8309,152,51,133,2021-05-04
317504,JAKARTA TIMUR,KRAMAT JATI,10177,85,9815,187,90,175,2021-05-04
317508,JAKARTA TIMUR,MAKASAR,8794,74,8508,143,69,143,2021-05-04
317403,JAKARTA SELATAN,MAMPANG PRAPATAN,5804,33,5636,101,34,67,2021-05-04
317501,JAKARTA TIMUR,MATRAMAN,6462,55,6231,136,40,95,2021-05-04
317106,JAKARTA PUSAT,MENTENG,3261,40,3136,67,18,58,2021-05-04
317205,JAKARTA UTARA,PADEMANGAN,5077,57,4886,83,51,108,2021-05-04
317307,JAKARTA BARAT,PALMERAH,7748,60,7489,167,32,92,2021-05-04
310102,KAB.ADM.KEP.SERIBU,KEP. SERIBU SELATAN,242,0,239,3,0,0,2021-05-04
111111,Luar DKI & Proses Update,Luar DKI & Proses Update,143008,137,141294,1273,304,441,2021-05-05
317106,JAKARTA PUSAT,MENTENG,3265,44,3136,67,18,62,2021-05-05
317501,JAKARTA TIMUR,MATRAMAN,6474,59,6239,136,40,99,2021-05-05
317403,JAKARTA SELATAN,MAMPANG PRAPATAN,5814,37,5644,101,32,69,2021-05-05
317508,JAKARTA TIMUR,MAKASAR,8804,78,8532,143,51,129,2021-05-05
317203,JAKARTA UTARA,KOJA,8620,94,8325,153,48,142,2021-05-05
310101,KAB.ADM.KEP.SERIBU,KEP. SERIBU UTARA,321,2,311,4,4,6,2021-05-05
317506,JAKARTA TIMUR,CAKUNG,11814,99,11433,206,76,175,2021-05-05
317105,JAKARTA PUSAT,CEMPAKA PUTIH,5049,69,4880,81,19,88,2021-05-05
317301,JAKARTA BARAT,CENGKARENG,13286,116,12672,260,238,354,2021-05-05
317406,JAKARTA SELATAN,CILANDAK,8265,66,7981,126,92,158,2021-05-05
317204,JAKARTA UTARA,CILINCING,7970,79,7682,154,55,134,2021-05-05
317510,JAKARTA TIMUR,CIPAYUNG,10508,74,10200,122,112,186,2021-05-05
317509,JAKARTA TIMUR,CIRACAS,9584,92,9247,175,70,162,2021-05-05
317507,JAKARTA TIMUR,DUREN SAWIT,14432,118,13904,292,118,236,2021-05-05
317101,JAKARTA PUSAT,GAMBIR,3837,32,3699,64,42,74,2021-05-05
317307,JAKARTA BARAT,PALMERAH,7782,67,7492,167,56,123,2021-05-05
317302,JAKARTA BARAT,GROGOL PETAMBURAN,8358,77,8074,160,47,124,2021-05-05
317409,JAKARTA SELATAN,JAGAKARSA,11878,78,11467,191,142,220,2021-05-05
317108,JAKARTA PUSAT,JOHAR BARU,4205,33,4050,101,21,54,2021-05-05
317306,JAKARTA BARAT,KALI DERES,8114,66,7861,145,42,108,2021-05-05
317407,JAKARTA SELATAN,KEBAYORAN BARU,6521,81,6242,93,105,186,2021-05-05
317405,JAKARTA SELATAN,KEBAYORAN LAMA,9496,89,9149,171,87,176,2021-05-05
317305,JAKARTA BARAT,KEBON JERUK,10569,98,10221,186,64,162,2021-05-05
317206,JAKARTA UTARA,KELAPA GADING,6000,64,5782,96,58,122,2021-05-05
317103,JAKARTA PUSAT,KEMAYORAN,10027,102,9673,174,78,180,2021-05-05
317308,JAKARTA BARAT,KEMBANGAN,9162,61,8907,120,74,135,2021-05-05
310102,KAB.ADM.KEP.SERIBU,KEP. SERIBU SELATAN,243,0,240,3,0,0,2021-05-05
317504,JAKARTA TIMUR,KRAMAT JATI,10196,90,9829,188,89,179,2021-05-05
317503,JAKARTA TIMUR,JATINEGARA,9043,65,8737,172,69,134,2021-05-05
317408,JAKARTA SELATAN,PANCORAN,6479,67,6249,103,60,127,2021-05-05
317205,JAKARTA UTARA,PADEMANGAN,5133,60,4902,83,88,148,2021-05-05
317401,JAKARTA SELATAN,TEBET,7965,61,7711,148,45,106,2021-05-05
317202,JAKARTA UTARA,TANJUNG PRIOK,12613,147,12181,221,64,211,2021-05-05
317107,JAKARTA PUSAT,TANAH ABANG,5850,53,5658,114,25,78,2021-05-05
317303,JAKARTA BARAT,TAMAN SARI,3947,51,3805,63,28,79,2021-05-05
317402,JAKARTA SELATAN,SETIA BUDI,5516,56,5322,94,44,100,2021-05-05
317104,JAKARTA PUSAT,SENEN,4507,42,4350,91,24,66,2021-05-05
317304,JAKARTA BARAT,TAMBORA,5929,77,5667,127,58,135,2021-05-05
317502,JAKARTA TIMUR,PULO GADUNG,10032,118,9634,181,99,217,2021-05-05
317410,JAKARTA SELATAN,PESANGGRAHAN,7460,34,7250,119,57,91,2021-05-05
317201,JAKARTA UTARA,PENJARINGAN,8154,109,7855,108,82,191,2021-05-05
317505,JAKARTA TIMUR,PASAR REBO,8241,50,7953,152,86,136,2021-05-05
317404,JAKARTA SELATAN,PASAR MINGGU,11560,100,11151,208,101,201,2021-05-05
317102,JAKARTA PUSAT,SAWAH BESAR,4117,41,3972,75,29,70,2021-05-05
317101,JAKARTA PUSAT,GAMBIR,3849,30,3709,65,45,75,2021-05-06
317306,JAKARTA BARAT,KALI DERES,8132,74,7865,146,47,121,2021-05-06
317108,JAKARTA PUSAT,JOHAR BARU,4204,31,4053,101,19,50,2021-05-06
317503,JAKARTA TIMUR,JATINEGARA,9057,66,8747,172,72,138,2021-05-06
317409,JAKARTA SELATAN,JAGAKARSA,11899,78,11481,194,146,224,2021-05-06
317302,JAKARTA BARAT,GROGOL PETAMBURAN,8382,83,8082,160,57,140,2021-05-06
317507,JAKARTA TIMUR,DUREN SAWIT,14466,114,13927,293,132,246,2021-05-06
111111,Luar DKI & Proses Update,Luar DKI & Proses Update,143008,137,141294,1273,304,441,2021-05-06
317510,JAKARTA TIMUR,CIPAYUNG,10532,74,10236,122,100,174,2021-05-06
317204,JAKARTA UTARA,CILINCING,7984,80,7696,156,52,132,2021-05-06
317406,JAKARTA SELATAN,CILANDAK,8295,71,7991,127,106,177,2021-05-06
317301,JAKARTA BARAT,CENGKARENG,13306,125,12682,260,239,364,2021-05-06
317105,JAKARTA PUSAT,CEMPAKA PUTIH,5056,65,4888,81,22,87,2021-05-06
317407,JAKARTA SELATAN,KEBAYORAN BARU,6553,85,6258,94,116,201,2021-05-06
317509,JAKARTA TIMUR,CIRACAS,9610,87,9268,176,79,166,2021-05-06
317506,JAKARTA TIMUR,CAKUNG,11836,100,11439,207,90,190,2021-05-06
317405,JAKARTA SELATAN,KEBAYORAN LAMA,9519,97,9159,171,92,189,2021-05-06
317206,JAKARTA UTARA,KELAPA GADING,6015,67,5789,98,61,128,2021-05-06
317401,JAKARTA SELATAN,TEBET,7989,67,7718,148,56,123,2021-05-06
317202,JAKARTA UTARA,TANJUNG PRIOK,12651,150,12211,222,68,218,2021-05-06
317107,JAKARTA PUSAT,TANAH ABANG,5860,46,5675,114,25,71,2021-05-06
317304,JAKARTA BARAT,TAMBORA,5963,96,5680,127,60,156,2021-05-06
317303,JAKARTA BARAT,TAMAN SARI,3962,56,3813,63,30,86,2021-05-06
317402,JAKARTA SELATAN,SETIA BUDI,5526,56,5325,94,51,107,2021-05-06
317104,JAKARTA PUSAT,SENEN,4517,44,4360,91,22,66,2021-05-06
317102,JAKARTA PUSAT,SAWAH BESAR,4126,45,3979,75,27,72,2021-05-06
317502,JAKARTA TIMUR,PULO GADUNG,10048,125,9649,181,93,218,2021-05-06
317410,JAKARTA SELATAN,PESANGGRAHAN,7475,40,7253,119,63,103,2021-05-06
317201,JAKARTA UTARA,PENJARINGAN,8176,116,7872,109,79,195,2021-05-06
317505,JAKARTA TIMUR,PASAR REBO,8261,51,7971,153,86,137,2021-05-06
317305,JAKARTA BARAT,KEBON JERUK,10608,114,10233,186,75,189,2021-05-06
317404,JAKARTA SELATAN,PASAR MINGGU,11588,107,11176,208,97,204,2021-05-06
317307,JAKARTA BARAT,PALMERAH,7803,82,7493,167,61,143,2021-05-06
317205,JAKARTA UTARA,PADEMANGAN,5150,63,4908,83,96,159,2021-05-06
317106,JAKARTA PUSAT,MENTENG,3267,44,3138,67,18,62,2021-05-06
317501,JAKARTA TIMUR,MATRAMAN,6485,53,6250,136,46,99,2021-05-06
317403,JAKARTA SELATAN,MAMPANG PRAPATAN,5826,38,5643,102,43,81,2021-05-06
317508,JAKARTA TIMUR,MAKASAR,8822,72,8556,143,51,123,2021-05-06
317504,JAKARTA TIMUR,KRAMAT JATI,10227,83,9848,190,106,189,2021-05-06
317203,JAKARTA UTARA,KOJA,8630,96,8329,153,52,148,2021-05-06
310101,KAB.ADM.KEP.SERIBU,KEP. SERIBU UTARA,322,2,311,4,5,7,2021-05-06
310102,KAB.ADM.KEP.SERIBU,KEP. SERIBU SELATAN,243,0,240,3,0,0,2021-05-06
317308,JAKARTA BARAT,KEMBANGAN,9174,61,8920,120,73,134,2021-05-06
317103,JAKARTA PUSAT,KEMAYORAN,10055,95,9686,174,100,195,2021-05-06
317408,JAKARTA SELATAN,PANCORAN,6501,72,6258,103,68,140,2021-05-06
111111,Luar DKI & Proses Update,Luar DKI & Proses Update,143008,137,141294,1273,304,441,2021-05-07
317304,JAKARTA BARAT,TAMBORA,5974,102,5689,127,56,158,2021-05-07
317202,JAKARTA UTARA,TANJUNG PRIOK,12671,146,12233,222,70,216,2021-05-07
317203,JAKARTA UTARA,KOJA,8637,91,8337,154,55,146,2021-05-07
317504,JAKARTA TIMUR,KRAMAT JATI,10245,81,9856,190,118,199,2021-05-07
317508,JAKARTA TIMUR,MAKASAR,8834,72,8564,144,54,126,2021-05-07
317403,JAKARTA SELATAN,MAMPANG PRAPATAN,5834,41,5649,102,42,83,2021-05-07
317501,JAKARTA TIMUR,MATRAMAN,6491,58,6251,136,46,104,2021-05-07
317106,JAKARTA PUSAT,MENTENG,3270,43,3142,67,18,61,2021-05-07
317205,JAKARTA UTARA,PADEMANGAN,5174,68,4914,83,109,177,2021-05-07
317408,JAKARTA SELATAN,PANCORAN,6520,73,6273,104,70,143,2021-05-07
317404,JAKARTA SELATAN,PASAR MINGGU,11605,108,11202,208,87,195,2021-05-07
317505,JAKARTA TIMUR,PASAR REBO,8277,51,7978,153,95,146,2021-05-07
317201,JAKARTA UTARA,PENJARINGAN,8196,113,7895,109,79,192,2021-05-07
317410,JAKARTA SELATAN,PESANGGRAHAN,7489,43,7267,120,59,102,2021-05-07
317502,JAKARTA TIMUR,PULO GADUNG,10071,117,9673,181,100,217,2021-05-07
317102,JAKARTA PUSAT,SAWAH BESAR,4130,46,3986,77,21,67,2021-05-07
317104,JAKARTA PUSAT,SENEN,4521,44,4369,92,16,60,2021-05-07
317402,JAKARTA SELATAN,SETIA BUDI,5532,54,5337,94,47,101,2021-05-07
317303,JAKARTA BARAT,TAMAN SARI,3970,56,3817,63,34,90,2021-05-07
317107,JAKARTA PUSAT,TANAH ABANG,5870,48,5678,115,29,77,2021-05-07
317401,JAKARTA SELATAN,TEBET,8010,72,7726,148,64,136,2021-05-07
310101,KAB.ADM.KEP.SERIBU,KEP. SERIBU UTARA,322,2,311,4,5,7,2021-05-07
310102,KAB.ADM.KEP.SERIBU,KEP. SERIBU SELATAN,243,0,240,3,0,0,2021-05-07
317307,JAKARTA BARAT,PALMERAH,7822,82,7517,167,56,138,2021-05-07
317103,JAKARTA PUSAT,KEMAYORAN,10072,102,9692,176,102,204,2021-05-07
317506,JAKARTA TIMUR,CAKUNG,11852,108,11447,207,90,198,2021-05-07
317308,JAKARTA BARAT,KEMBANGAN,9194,67,8940,120,67,134,2021-05-07
317105,JAKARTA PUSAT,CEMPAKA PUTIH,5063,67,4893,81,22,89,2021-05-07
317301,JAKARTA BARAT,CENGKARENG,13330,126,12699,262,243,369,2021-05-07
317406,JAKARTA SELATAN,CILANDAK,8316,72,8003,128,113,185,2021-05-07
317204,JAKARTA UTARA,CILINCING,8010,83,7706,157,64,147,2021-05-07
317510,JAKARTA TIMUR,CIPAYUNG,10543,78,10244,122,99,177,2021-05-07
317507,JAKARTA TIMUR,DUREN SAWIT,14501,118,13941,294,148,266,2021-05-07
317101,JAKARTA PUSAT,GAMBIR,3855,35,3710,66,44,79,2021-05-07
317509,JAKARTA TIMUR,CIRACAS,9625,91,9271,178,85,176,2021-05-07
317409,JAKARTA SELATAN,JAGAKARSA,11921,75,11501,194,151,226,2021-05-07
317206,JAKARTA UTARA,KELAPA GADING,6029,66,5802,100,61,127,2021-05-07
317305,JAKARTA BARAT,KEBON JERUK,10630,112,10258,186,74,186,2021-05-07
317302,JAKARTA BARAT,GROGOL PETAMBURAN,8395,84,8093,160,58,142,2021-05-07
317407,JAKARTA SELATAN,KEBAYORAN BARU,6578,94,6272,94,118,212,2021-05-07
317306,JAKARTA BARAT,KALI DERES,8159,74,7879,146,60,134,2021-05-07
317405,JAKARTA SELATAN,KEBAYORAN LAMA,9534,100,9175,171,88,188,2021-05-07
317503,JAKARTA TIMUR,JATINEGARA,9073,71,8753,173,76,147,2021-05-07
317108,JAKARTA PUSAT,JOHAR BARU,4213,34,4056,101,22,56,2021-05-07
317407,JAKARTA SELATAN,KEBAYORAN BARU,6592,92,6298,96,106,198,2021-05-08
310102,KAB.ADM.KEP.SERIBU,KEP. SERIBU SELATAN,243,0,240,3,0,0,2021-05-08
310101,KAB.ADM.KEP.SERIBU,KEP. SERIBU UTARA,322,1,312,4,5,6,2021-05-08
317308,JAKARTA BARAT,KEMBANGAN,9210,65,8956,120,69,134,2021-05-08
317103,JAKARTA PUSAT,KEMAYORAN,10089,103,9713,177,96,199,2021-05-08
317206,JAKARTA UTARA,KELAPA GADING,6051,68,5814,100,69,137,2021-05-08
317305,JAKARTA BARAT,KEBON JERUK,10648,115,10275,186,72,187,2021-05-08
317405,JAKARTA SELATAN,KEBAYORAN LAMA,9544,98,9183,172,91,189,2021-05-08
317306,JAKARTA BARAT,KALI DERES,8174,73,7889,146,66,139,2021-05-08
317204,JAKARTA UTARA,CILINCING,8019,83,7712,158,66,149,2021-05-08
317503,JAKARTA TIMUR,JATINEGARA,9093,73,8764,173,83,156,2021-05-08
317409,JAKARTA SELATAN,JAGAKARSA,11938,79,11506,194,159,238,2021-05-08
317302,JAKARTA BARAT,GROGOL PETAMBURAN,8401,83,8102,160,56,139,2021-05-08
317101,JAKARTA PUSAT,GAMBIR,3871,35,3722,66,48,83,2021-05-08
317507,JAKARTA TIMUR,DUREN SAWIT,14529,116,13986,296,131,247,2021-05-08
317509,JAKARTA TIMUR,CIRACAS,9647,92,9279,178,98,190,2021-05-08
317510,JAKARTA TIMUR,CIPAYUNG,10567,77,10259,122,109,186,2021-05-08
317406,JAKARTA SELATAN,CILANDAK,8337,76,8009,129,123,199,2021-05-08
317506,JAKARTA TIMUR,CAKUNG,11867,107,11475,207,78,185,2021-05-08
317108,JAKARTA PUSAT,JOHAR BARU,4217,34,4062,102,19,53,2021-05-08
317504,JAKARTA TIMUR,KRAMAT JATI,10263,81,9865,190,127,208,2021-05-08
317203,JAKARTA UTARA,KOJA,8652,91,8342,156,63,154,2021-05-08
317403,JAKARTA SELATAN,MAMPANG PRAPATAN,5846,41,5652,103,50,91,2021-05-08
111111,Luar DKI & Proses Update,Luar DKI & Proses Update,143008,137,141294,1273,304,441,2021-05-08
317301,JAKARTA BARAT,CENGKARENG,13355,128,12754,262,211,339,2021-05-08
317401,JAKARTA SELATAN,TEBET,8024,75,7738,149,62,137,2021-05-08
317202,JAKARTA UTARA,TANJUNG PRIOK,12689,139,12252,223,75,214,2021-05-08
317107,JAKARTA PUSAT,TANAH ABANG,5880,47,5683,116,34,81,2021-05-08
317304,JAKARTA BARAT,TAMBORA,5992,111,5703,127,51,162,2021-05-08
317303,JAKARTA BARAT,TAMAN SARI,3976,57,3827,64,28,85,2021-05-08
317402,JAKARTA SELATAN,SETIA BUDI,5541,56,5348,94,43,99,2021-05-08
317104,JAKARTA PUSAT,SENEN,4533,53,4372,92,16,69,2021-05-08
317508,JAKARTA TIMUR,MAKASAR,8845,71,8570,146,58,129,2021-05-08
317102,JAKARTA PUSAT,SAWAH BESAR,4139,49,3992,77,21,70,2021-05-08
317410,JAKARTA SELATAN,PESANGGRAHAN,7510,42,7275,120,73,115,2021-05-08
317201,JAKARTA UTARA,PENJARINGAN,8224,114,7907,109,94,208,2021-05-08
317505,JAKARTA TIMUR,PASAR REBO,8287,52,7981,153,101,153,2021-05-08
317404,JAKARTA SELATAN,PASAR MINGGU,11633,109,11210,210,104,213,2021-05-08
317408,JAKARTA SELATAN,PANCORAN,6531,72,6285,105,69,141,2021-05-08
317307,JAKARTA BARAT,PALMERAH,7848,83,7529,167,69,152,2021-05-08
317205,JAKARTA UTARA,PADEMANGAN,5177,68,4929,83,97,165,2021-05-08
317106,JAKARTA PUSAT,MENTENG,3275,42,3152,67,14,56,2021-05-08
317501,JAKARTA TIMUR,MATRAMAN,6514,64,6258,136,56,120,2021-05-08
317502,JAKARTA TIMUR,PULO GADUNG,10096,122,9693,181,100,222,2021-05-08
317105,JAKARTA PUSAT,CEMPAKA PUTIH,5070,66,4900,81,23,89,2021-05-08
317402,JAKARTA SELATAN,SETIA BUDI,5552,50,5361,94,47,97,2021-05-09
317506,JAKARTA TIMUR,CAKUNG,11896,104,11499,208,85,189,2021-05-09
317403,JAKARTA SELATAN,MAMPANG PRAPATAN,5869,40,5667,103,59,99,2021-05-09
317501,JAKARTA TIMUR,MATRAMAN,6523,66,6269,136,52,118,2021-05-09
317106,JAKARTA PUSAT,MENTENG,3286,43,3157,67,19,62,2021-05-09
317205,JAKARTA UTARA,PADEMANGAN,5197,57,4951,83,106,163,2021-05-09
317307,JAKARTA BARAT,PALMERAH,7859,84,7534,169,72,156,2021-05-09
317408,JAKARTA SELATAN,PANCORAN,6541,72,6293,106,70,142,2021-05-09
317404,JAKARTA SELATAN,PASAR MINGGU,11652,115,11222,210,105,220,2021-05-09
317505,JAKARTA TIMUR,PASAR REBO,8313,58,8001,154,100,158,2021-05-09
317508,JAKARTA TIMUR,MAKASAR,8854,72,8581,146,55,127,2021-05-09
317201,JAKARTA UTARA,PENJARINGAN,8243,116,7927,109,91,207,2021-05-09
317502,JAKARTA TIMUR,PULO GADUNG,10127,123,9730,181,93,216,2021-05-09
317102,JAKARTA PUSAT,SAWAH BESAR,4146,48,3998,77,23,71,2021-05-09
111111,Luar DKI & Proses Update,Luar DKI & Proses Update,143008,137,141294,1273,304,441,2021-05-09
317401,JAKARTA SELATAN,TEBET,8038,75,7743,150,70,145,2021-05-09
317202,JAKARTA UTARA,TANJUNG PRIOK,12713,143,12268,223,79,222,2021-05-09
317107,JAKARTA PUSAT,TANAH ABANG,5885,44,5691,116,34,78,2021-05-09
317304,JAKARTA BARAT,TAMBORA,6001,110,5713,128,50,160,2021-05-09
317303,JAKARTA BARAT,TAMAN SARI,3991,61,3834,64,32,93,2021-05-09
317410,JAKARTA SELATAN,PESANGGRAHAN,7520,43,7287,120,70,113,2021-05-09
317104,JAKARTA PUSAT,SENEN,4542,55,4378,92,17,72,2021-05-09
317504,JAKARTA TIMUR,KRAMAT JATI,10282,78,9884,190,130,208,2021-05-09
310101,KAB.ADM.KEP.SERIBU,KEP. SERIBU UTARA,326,1,312,4,9,10,2021-05-09
317105,JAKARTA PUSAT,CEMPAKA PUTIH,5090,63,4909,81,37,100,2021-05-09
317301,JAKARTA BARAT,CENGKARENG,13389,140,12766,263,220,360,2021-05-09
317406,JAKARTA SELATAN,CILANDAK,8351,70,8042,129,110,180,2021-05-09
317204,JAKARTA UTARA,CILINCING,8034,81,7734,159,60,141,2021-05-09
317510,JAKARTA TIMUR,CIPAYUNG,10579,79,10279,122,99,178,2021-05-09
317509,JAKARTA TIMUR,CIRACAS,9657,94,9295,178,90,184,2021-05-09
317507,JAKARTA TIMUR,DUREN SAWIT,14572,121,14003,297,151,272,2021-05-09
317101,JAKARTA PUSAT,GAMBIR,3879,37,3726,66,50,87,2021-05-09
317203,JAKARTA UTARA,KOJA,8664,100,8358,157,49,149,2021-05-09
317302,JAKARTA BARAT,GROGOL PETAMBURAN,8419,88,8109,162,60,148,2021-05-09
317503,JAKARTA TIMUR,JATINEGARA,9108,68,8784,173,83,151,2021-05-09
317306,JAKARTA BARAT,KALI DERES,8195,79,7900,146,70,149,2021-05-09
317407,JAKARTA SELATAN,KEBAYORAN BARU,6611,95,6310,96,110,205,2021-05-09
317405,JAKARTA SELATAN,KEBAYORAN LAMA,9573,94,9213,173,93,187,2021-05-09
317305,JAKARTA BARAT,KEBON JERUK,10676,120,10285,186,85,205,2021-05-09
317206,JAKARTA UTARA,KELAPA GADING,6073,58,5845,100,70,128,2021-05-09
317103,JAKARTA PUSAT,KEMAYORAN,10114,106,9716,177,115,221,2021-05-09
317308,JAKARTA BARAT,KEMBANGAN,9228,60,8968,120,80,140,2021-05-09
310102,KAB.ADM.KEP.SERIBU,KEP. SERIBU SELATAN,243,0,240,3,0,0,2021-05-09
317409,JAKARTA SELATAN,JAGAKARSA,11955,74,11551,194,136,210,2021-05-09
317108,JAKARTA PUSAT,JOHAR BARU,4220,33,4065,102,20,53,2021-05-09
111111,Luar DKI & Proses Update,Luar DKI & Proses Update,143008,137,141294,1273,304,441,2021-05-10
310102,KAB.ADM.KEP.SERIBU,KEP. SERIBU SELATAN,243,0,240,3,0,0,2021-05-10
317404,JAKARTA SELATAN,PASAR MINGGU,11684,116,11255,210,103,219,2021-05-10
317504,JAKARTA TIMUR,KRAMAT JATI,10297,69,9908,190,130,199,2021-05-10
317403,JAKARTA SELATAN,MAMPANG PRAPATAN,5873,41,5674,103,55,96,2021-05-10
317501,JAKARTA TIMUR,MATRAMAN,6530,64,6274,137,55,119,2021-05-10
317106,JAKARTA PUSAT,MENTENG,3291,44,3162,67,18,62,2021-05-10
317205,JAKARTA UTARA,PADEMANGAN,5203,60,4951,85,107,167,2021-05-10
317307,JAKARTA BARAT,PALMERAH,7872,89,7540,170,73,162,2021-05-10
317408,JAKARTA SELATAN,PANCORAN,6551,69,6304,108,70,139,2021-05-10
317505,JAKARTA TIMUR,PASAR REBO,8315,55,8014,154,92,147,2021-05-10
317201,JAKARTA UTARA,PENJARINGAN,8270,117,7955,109,89,206,2021-05-10
317410,JAKARTA SELATAN,PESANGGRAHAN,7549,43,7297,121,88,131,2021-05-10
317502,JAKARTA TIMUR,PULO GADUNG,10143,123,9743,182,95,218,2021-05-10
317102,JAKARTA PUSAT,SAWAH BESAR,4150,48,4001,77,24,72,2021-05-10
317104,JAKARTA PUSAT,SENEN,4547,55,4382,92,18,73,2021-05-10
317402,JAKARTA SELATAN,SETIA BUDI,5568,48,5371,94,55,103,2021-05-10
317303,JAKARTA BARAT,TAMAN SARI,3998,54,3845,64,35,89,2021-05-10
317304,JAKARTA BARAT,TAMBORA,6013,109,5722,128,54,163,2021-05-10
317107,JAKARTA PUSAT,TANAH ABANG,5889,45,5694,117,33,78,2021-05-10
317202,JAKARTA UTARA,TANJUNG PRIOK,12722,148,12271,224,79,227,2021-05-10
317401,JAKARTA SELATAN,TEBET,8060,66,7764,150,80,146,2021-05-10
317203,JAKARTA UTARA,KOJA,8669,96,8368,158,47,143,2021-05-10
310101,KAB.ADM.KEP.SERIBU,KEP. SERIBU UTARA,326,0,313,4,9,9,2021-05-10
317508,JAKARTA TIMUR,MAKASAR,8859,72,8593,146,48,120,2021-05-10
317103,JAKARTA PUSAT,KEMAYORAN,10132,113,9719,178,122,235,2021-05-10
317506,JAKARTA TIMUR,CAKUNG,11909,96,11519,208,86,182,2021-05-10
317105,JAKARTA PUSAT,CEMPAKA PUTIH,5096,59,4916,81,40,99,2021-05-10
317301,JAKARTA BARAT,CENGKARENG,13414,135,12795,264,220,355,2021-05-10
317406,JAKARTA SELATAN,CILANDAK,8356,68,8063,129,96,164,2021-05-10
317204,JAKARTA UTARA,CILINCING,8043,81,7743,160,59,140,2021-05-10
317308,JAKARTA BARAT,KEMBANGAN,9251,65,8977,121,88,153,2021-05-10
317509,JAKARTA TIMUR,CIRACAS,9675,93,9327,179,76,169,2021-05-10
317507,JAKARTA TIMUR,DUREN SAWIT,14591,110,14031,299,151,261,2021-05-10
317101,JAKARTA PUSAT,GAMBIR,3886,40,3730,66,50,90,2021-05-10
317302,JAKARTA BARAT,GROGOL PETAMBURAN,8440,86,8124,162,68,154,2021-05-10
317510,JAKARTA TIMUR,CIPAYUNG,10603,84,10302,122,95,179,2021-05-10
317409,JAKARTA SELATAN,JAGAKARSA,11978,76,11591,194,117,193,2021-05-10
317503,JAKARTA TIMUR,JATINEGARA,9124,66,8799,174,85,151,2021-05-10
317108,JAKARTA PUSAT,JOHAR BARU,4224,31,4069,103,21,52,2021-05-10
317306,JAKARTA BARAT,KALI DERES,8221,87,7911,146,77,164,2021-05-10
317407,JAKARTA SELATAN,KEBAYORAN BARU,6634,95,6327,96,116,211,2021-05-10
317405,JAKARTA SELATAN,KEBAYORAN LAMA,9594,98,9231,174,91,189,2021-05-10
317305,JAKARTA BARAT,KEBON JERUK,10694,125,10295,186,88,213,2021-05-10
317206,JAKARTA UTARA,KELAPA GADING,6072,55,5846,101,70,125,2021-05-10
317404,JAKARTA SELATAN,PASAR MINGGU,11690,112,11269,211,98,210,2021-05-11
317408,JAKARTA SELATAN,PANCORAN,6556,64,6317,108,67,131,2021-05-11
317307,JAKARTA BARAT,PALMERAH,7875,88,7551,170,66,154,2021-05-11
317205,JAKARTA UTARA,PADEMANGAN,5209,60,4959,85,105,165,2021-05-11
317508,JAKARTA TIMUR,MAKASAR,8865,66,8603,146,50,116,2021-05-11
317501,JAKARTA TIMUR,MATRAMAN,6541,57,6293,137,54,111,2021-05-11
317504,JAKARTA TIMUR,KRAMAT JATI,10305,70,9926,190,119,189,2021-05-11
317403,JAKARTA SELATAN,MAMPANG PRAPATAN,5879,43,5678,103,55,98,2021-05-11
317505,JAKARTA TIMUR,PASAR REBO,8323,53,8029,154,87,140,2021-05-11
317106,JAKARTA PUSAT,MENTENG,3291,39,3169,67,16,55,2021-05-11
317201,JAKARTA UTARA,PENJARINGAN,8274,114,7966,110,84,198,2021-05-11
317101,JAKARTA PUSAT,GAMBIR,3888,40,3744,66,38,78,2021-05-11
317502,JAKARTA TIMUR,PULO GADUNG,10146,114,9764,183,85,199,2021-05-11
317102,JAKARTA PUSAT,SAWAH BESAR,4152,48,4004,77,23,71,2021-05-11
317104,JAKARTA PUSAT,SENEN,4549,52,4386,93,18,70,2021-05-11
317402,JAKARTA SELATAN,SETIA BUDI,5576,49,5381,94,52,101,2021-05-11
317303,JAKARTA BARAT,TAMAN SARI,4004,60,3846,65,33,93,2021-05-11
317304,JAKARTA BARAT,TAMBORA,6025,118,5723,128,56,174,2021-05-11
317107,JAKARTA PUSAT,TANAH ABANG,5890,35,5707,117,31,66,2021-05-11
317203,JAKARTA UTARA,KOJA,8673,89,8381,158,45,134,2021-05-11
317202,JAKARTA UTARA,TANJUNG PRIOK,12732,143,12284,224,81,224,2021-05-11
317401,JAKARTA SELATAN,TEBET,8072,62,7775,151,84,146,2021-05-11
317410,JAKARTA SELATAN,PESANGGRAHAN,7551,44,7299,121,87,131,2021-05-11
310101,KAB.ADM.KEP.SERIBU,KEP. SERIBU UTARA,325,0,313,4,8,8,2021-05-11
317301,JAKARTA BARAT,CENGKARENG,13443,144,12821,265,213,357,2021-05-11
317308,JAKARTA BARAT,KEMBANGAN,9258,68,8990,122,78,146,2021-05-11
111111,Luar DKI & Proses Update,Luar DKI & Proses Update,143008,137,141294,1273,304,441,2021-05-11
317506,JAKARTA TIMUR,CAKUNG,11919,97,11547,208,67,164,2021-05-11
317105,JAKARTA PUSAT,CEMPAKA PUTIH,5090,59,4917,81,33,92,2021-05-11
317406,JAKARTA SELATAN,CILANDAK,8365,73,8072,129,91,164,2021-05-11
317204,JAKARTA UTARA,CILINCING,8044,77,7759,160,48,125,2021-05-11
310102,KAB.ADM.KEP.SERIBU,KEP. SERIBU SELATAN,243,0,240,3,0,0,2021-05-11
317509,JAKARTA TIMUR,CIRACAS,9680,88,9338,179,75,163,2021-05-11
317507,JAKARTA TIMUR,DUREN SAWIT,14607,107,14059,305,136,243,2021-05-11
317302,JAKARTA BARAT,GROGOL PETAMBURAN,8452,92,8134,163,63,155,2021-05-11
317510,JAKARTA TIMUR,CIPAYUNG,10610,81,10316,123,90,171,2021-05-11
317103,JAKARTA PUSAT,KEMAYORAN,10140,125,9726,179,110,235,2021-05-11
317503,JAKARTA TIMUR,JATINEGARA,9142,71,8823,174,74,145,2021-05-11
317108,JAKARTA PUSAT,JOHAR BARU,4231,30,4073,104,24,54,2021-05-11
317306,JAKARTA BARAT,KALI DERES,8240,89,7930,146,75,164,2021-05-11
317407,JAKARTA SELATAN,KEBAYORAN BARU,6655,93,6364,96,102,195,2021-05-11
317405,JAKARTA SELATAN,KEBAYORAN LAMA,9602,97,9244,174,87,184,2021-05-11
317305,JAKARTA BARAT,KEBON JERUK,10707,116,10328,186,77,193,2021-05-11
317206,JAKARTA UTARA,KELAPA GADING,6074,51,5856,101,66,117,2021-05-11
317409,JAKARTA SELATAN,JAGAKARSA,11990,80,11602,195,113,193,2021-05-11
317409,JAKARTA SELATAN,JAGAKARSA,12000,84,11617,195,104,188,2021-05-12
317503,JAKARTA TIMUR,JATINEGARA,9166,76,8843,176,71,147,2021-05-12
317108,JAKARTA PUSAT,JOHAR BARU,4233,31,4073,105,24,55,2021-05-12
317306,JAKARTA BARAT,KALI DERES,8265,96,7946,146,77,173,2021-05-12
317305,JAKARTA BARAT,KEBON JERUK,10733,124,10336,186,87,211,2021-05-12
317405,JAKARTA SELATAN,KEBAYORAN LAMA,9626,100,9266,175,85,185,2021-05-12
317206,JAKARTA UTARA,KELAPA GADING,6084,54,5860,101,69,123,2021-05-12
317302,JAKARTA BARAT,GROGOL PETAMBURAN,8462,94,8141,163,64,158,2021-05-12
317407,JAKARTA SELATAN,KEBAYORAN BARU,6679,92,6391,97,99,191,2021-05-12
317101,JAKARTA PUSAT,GAMBIR,3890,40,3746,66,38,78,2021-05-12
317107,JAKARTA PUSAT,TANAH ABANG,5899,40,5709,117,33,73,2021-05-12
317509,JAKARTA TIMUR,CIRACAS,9690,87,9348,179,76,163,2021-05-12
317510,JAKARTA TIMUR,CIPAYUNG,10620,86,10326,123,85,171,2021-05-12
317204,JAKARTA UTARA,CILINCING,8049,76,7766,160,47,123,2021-05-12
317406,JAKARTA SELATAN,CILANDAK,8378,75,8084,129,90,165,2021-05-12
317301,JAKARTA BARAT,CENGKARENG,13473,154,12962,267,90,244,2021-05-12
317105,JAKARTA PUSAT,CEMPAKA PUTIH,5097,49,4928,82,38,87,2021-05-12
317506,JAKARTA TIMUR,CAKUNG,11943,101,11560,209,73,174,2021-05-12
317103,JAKARTA PUSAT,KEMAYORAN,10156,134,9733,179,110,244,2021-05-12
111111,Luar DKI & Proses Update,Luar DKI & Proses Update,143008,137,141294,1273,304,441,2021-05-12
317507,JAKARTA TIMUR,DUREN SAWIT,14632,113,14068,306,145,258,2021-05-12
317304,JAKARTA BARAT,TAMBORA,6034,117,5731,129,57,174,2021-05-12
317308,JAKARTA BARAT,KEMBANGAN,9277,69,8998,122,88,157,2021-05-12
310101,KAB.ADM.KEP.SERIBU,KEP. SERIBU UTARA,325,0,313,4,8,8,2021-05-12
310102,KAB.ADM.KEP.SERIBU,KEP. SERIBU SELATAN,243,0,240,3,0,0,2021-05-12
317202,JAKARTA UTARA,TANJUNG PRIOK,12748,146,12303,225,74,220,2021-05-12
317303,JAKARTA BARAT,TAMAN SARI,4009,58,3851,65,35,93,2021-05-12
317402,JAKARTA SELATAN,SETIA BUDI,5586,51,5388,94,53,104,2021-05-12
317104,JAKARTA PUSAT,SENEN,4559,58,4387,94,20,78,2021-05-12
317102,JAKARTA PUSAT,SAWAH BESAR,4155,47,4007,78,23,70,2021-05-12
317502,JAKARTA TIMUR,PULO GADUNG,10185,121,9779,183,102,223,2021-05-12
317410,JAKARTA SELATAN,PESANGGRAHAN,7562,48,7320,122,72,120,2021-05-12
317201,JAKARTA UTARA,PENJARINGAN,8286,105,7984,110,87,192,2021-05-12
317505,JAKARTA TIMUR,PASAR REBO,8329,54,8034,155,86,140,2021-05-12
317401,JAKARTA SELATAN,TEBET,8085,68,7781,152,84,152,2021-05-12
317408,JAKARTA SELATAN,PANCORAN,6569,65,6327,108,69,134,2021-05-12
317404,JAKARTA SELATAN,PASAR MINGGU,11699,107,11283,211,98,205,2021-05-12
317504,JAKARTA TIMUR,KRAMAT JATI,10315,66,9939,190,120,186,2021-05-12
317508,JAKARTA TIMUR,MAKASAR,8871,53,8623,146,49,102,2021-05-12
317403,JAKARTA SELATAN,MAMPANG PRAPATAN,5885,44,5683,103,55,99,2021-05-12
317203,JAKARTA UTARA,KOJA,8689,87,8391,160,51,138,2021-05-12
317106,JAKARTA PUSAT,MENTENG,3296,37,3177,67,15,52,2021-05-12
317205,JAKARTA UTARA,PADEMANGAN,5226,55,4976,85,110,165,2021-05-12
317307,JAKARTA BARAT,PALMERAH,7889,90,7554,170,75,165,2021-05-12
317501,JAKARTA TIMUR,MATRAMAN,6565,57,6302,137,69,126,2021-05-12
317504,JAKARTA TIMUR,KRAMAT JATI,10332,63,9951,190,128,191,2021-05-13
317404,JAKARTA SELATAN,PASAR MINGGU,11715,107,11296,211,101,208,2021-05-13
317403,JAKARTA SELATAN,MAMPANG PRAPATAN,5892,41,5687,103,61,102,2021-05-13
317501,JAKARTA TIMUR,MATRAMAN,6570,55,6324,137,54,109,2021-05-13
317106,JAKARTA PUSAT,MENTENG,3300,38,3180,67,15,53,2021-05-13
317205,JAKARTA UTARA,PADEMANGAN,5239,55,4984,85,115,170,2021-05-13
317307,JAKARTA BARAT,PALMERAH,7895,85,7566,170,74,159,2021-05-13
317408,JAKARTA SELATAN,PANCORAN,6585,69,6336,108,72,141,2021-05-13
317508,JAKARTA TIMUR,MAKASAR,8891,57,8627,146,61,118,2021-05-13
317502,JAKARTA TIMUR,PULO GADUNG,10189,119,9789,183,98,217,2021-05-13
317201,JAKARTA UTARA,PENJARINGAN,8309,106,8003,110,90,196,2021-05-13
317410,JAKARTA SELATAN,PESANGGRAHAN,7576,49,7326,122,79,128,2021-05-13
317102,JAKARTA PUSAT,SAWAH BESAR,4161,46,4011,78,26,72,2021-05-13
317104,JAKARTA PUSAT,SENEN,4568,64,4388,94,22,86,2021-05-13
317402,JAKARTA SELATAN,SETIA BUDI,5603,54,5396,94,59,113,2021-05-13
317401,JAKARTA SELATAN,TEBET,8099,71,7789,152,87,158,2021-05-13
317202,JAKARTA UTARA,TANJUNG PRIOK,12786,146,12320,225,95,241,2021-05-13
317203,JAKARTA UTARA,KOJA,8695,79,8414,160,42,121,2021-05-13
317107,JAKARTA PUSAT,TANAH ABANG,5916,48,5714,117,37,85,2021-05-13
317505,JAKARTA TIMUR,PASAR REBO,8336,53,8041,155,87,140,2021-05-13
310101,KAB.ADM.KEP.SERIBU,KEP. SERIBU UTARA,326,0,315,4,7,7,2021-05-13
317503,JAKARTA TIMUR,JATINEGARA,9185,79,8863,176,67,146,2021-05-13
317302,JAKARTA BARAT,GROGOL PETAMBURAN,8479,91,8151,163,74,165,2021-05-13
111111,Luar DKI & Proses Update,Luar DKI & Proses Update,143008,137,141294,1273,304,441,2021-05-13
317506,JAKARTA TIMUR,CAKUNG,11959,98,11575,209,77,175,2021-05-13
317105,JAKARTA PUSAT,CEMPAKA PUTIH,5110,50,4940,82,38,88,2021-05-13
317301,JAKARTA BARAT,CENGKARENG,13514,152,12998,267,97,249,2021-05-13
317406,JAKARTA SELATAN,CILANDAK,8395,67,8097,129,102,169,2021-05-13
317204,JAKARTA UTARA,CILINCING,8067,72,7774,160,61,133,2021-05-13
317510,JAKARTA TIMUR,CIPAYUNG,10648,90,10336,123,99,189,2021-05-13
317509,JAKARTA TIMUR,CIRACAS,9718,83,9366,179,90,173,2021-05-13
317507,JAKARTA TIMUR,DUREN SAWIT,14653,110,14080,306,157,267,2021-05-13
317101,JAKARTA PUSAT,GAMBIR,3899,43,3749,66,41,84,2021-05-13
317303,JAKARTA BARAT,TAMAN SARI,4010,55,3859,65,31,86,2021-05-13
317409,JAKARTA SELATAN,JAGAKARSA,12039,90,11628,195,126,216,2021-05-13
317304,JAKARTA BARAT,TAMBORA,6052,106,5754,129,63,169,2021-05-13
317108,JAKARTA PUSAT,JOHAR BARU,4243,33,4075,105,30,63,2021-05-13
317306,JAKARTA BARAT,KALI DERES,8286,95,7960,146,85,180,2021-05-13
317407,JAKARTA SELATAN,KEBAYORAN BARU,6692,83,6420,97,92,175,2021-05-13
317405,JAKARTA SELATAN,KEBAYORAN LAMA,9647,103,9281,175,88,191,2021-05-13
317305,JAKARTA BARAT,KEBON JERUK,10754,121,10347,186,100,221,2021-05-13
317206,JAKARTA UTARA,KELAPA GADING,6095,51,5870,101,73,124,2021-05-13
317103,JAKARTA PUSAT,KEMAYORAN,10172,118,9765,179,110,228,2021-05-13
317308,JAKARTA BARAT,KEMBANGAN,9306,76,9009,122,99,175,2021-05-13
310102,KAB.ADM.KEP.SERIBU,KEP. SERIBU SELATAN,243,0,240,3,0,0,2021-05-13
111111,Luar DKI & Proses Update,Luar DKI & Proses Update,143008,137,141294,1273,304,441,2021-05-14
317509,JAKARTA TIMUR,CIRACAS,9735,95,9380,180,80,175,2021-05-14
317105,JAKARTA PUSAT,CEMPAKA PUTIH,5121,47,4952,83,39,86,2021-05-14
317501,JAKARTA TIMUR,MATRAMAN,6580,62,6327,137,54,116,2021-05-14
317106,JAKARTA PUSAT,MENTENG,3305,39,3186,67,13,52,2021-05-14
317205,JAKARTA UTARA,PADEMANGAN,5278,66,4995,85,132,198,2021-05-14
317307,JAKARTA BARAT,PALMERAH,7909,98,7568,170,73,171,2021-05-14
317408,JAKARTA SELATAN,PANCORAN,6609,70,6354,108,77,147,2021-05-14
317404,JAKARTA SELATAN,PASAR MINGGU,11728,109,11312,212,95,204,2021-05-14
317505,JAKARTA TIMUR,PASAR REBO,8347,57,8059,155,76,133,2021-05-14
317201,JAKARTA UTARA,PENJARINGAN,8335,121,8011,110,93,214,2021-05-14
317403,JAKARTA SELATAN,MAMPANG PRAPATAN,5901,46,5691,103,61,107,2021-05-14
317410,JAKARTA SELATAN,PESANGGRAHAN,7594,54,7331,124,85,139,2021-05-14
317102,JAKARTA PUSAT,SAWAH BESAR,4162,45,4019,78,20,65,2021-05-14
317104,JAKARTA PUSAT,SENEN,4570,61,4394,94,21,82,2021-05-14
317402,JAKARTA SELATAN,SETIA BUDI,5610,53,5402,94,61,114,2021-05-14
317303,JAKARTA BARAT,TAMAN SARI,4015,54,3867,65,29,83,2021-05-14
317304,JAKARTA BARAT,TAMBORA,6063,105,5761,129,68,173,2021-05-14
317107,JAKARTA PUSAT,TANAH ABANG,5918,49,5716,118,35,84,2021-05-14
317202,JAKARTA UTARA,TANJUNG PRIOK,12800,161,12326,226,87,248,2021-05-14
317401,JAKARTA SELATAN,TEBET,8110,69,7797,152,92,161,2021-05-14
317502,JAKARTA TIMUR,PULO GADUNG,10215,139,9813,183,80,219,2021-05-14
317508,JAKARTA TIMUR,MAKASAR,8904,68,8634,147,55,123,2021-05-14
317504,JAKARTA TIMUR,KRAMAT JATI,10349,65,9972,192,120,185,2021-05-14
317203,JAKARTA UTARA,KOJA,8713,92,8416,161,44,136,2021-05-14
317301,JAKARTA BARAT,CENGKARENG,13531,152,13012,269,98,250,2021-05-14
317406,JAKARTA SELATAN,CILANDAK,8411,70,8103,130,108,178,2021-05-14
317204,JAKARTA UTARA,CILINCING,8083,89,7777,160,57,146,2021-05-14
317510,JAKARTA TIMUR,CIPAYUNG,10657,89,10356,123,89,178,2021-05-14
317507,JAKARTA TIMUR,DUREN SAWIT,14663,115,14108,306,134,249,2021-05-14
317101,JAKARTA PUSAT,GAMBIR,3900,42,3756,66,36,78,2021-05-14
317302,JAKARTA BARAT,GROGOL PETAMBURAN,8491,97,8159,164,71,168,2021-05-14
317409,JAKARTA SELATAN,JAGAKARSA,12072,94,11650,196,132,226,2021-05-14
317503,JAKARTA TIMUR,JATINEGARA,9193,83,8878,177,55,138,2021-05-14
317108,JAKARTA PUSAT,JOHAR BARU,4243,30,4082,105,26,56,2021-05-14
317306,JAKARTA BARAT,KALI DERES,8294,97,7967,147,83,180,2021-05-14
317407,JAKARTA SELATAN,KEBAYORAN BARU,6713,86,6446,98,83,169,2021-05-14
317405,JAKARTA SELATAN,KEBAYORAN LAMA,9667,105,9302,178,82,187,2021-05-14
317305,JAKARTA BARAT,KEBON JERUK,10763,127,10356,188,92,219,2021-05-14
317206,JAKARTA UTARA,KELAPA GADING,6113,54,5872,101,86,140,2021-05-14
317103,JAKARTA PUSAT,KEMAYORAN,10184,120,9793,180,91,211,2021-05-14
317308,JAKARTA BARAT,KEMBANGAN,9322,77,9026,124,95,172,2021-05-14
310102,KAB.ADM.KEP.SERIBU,KEP. SERIBU SELATAN,244,0,241,3,0,0,2021-05-14
310101,KAB.ADM.KEP.SERIBU,KEP. SERIBU UTARA,326,0,315,4,7,7,2021-05-14
317506,JAKARTA TIMUR,CAKUNG,11973,103,11584,210,76,179,2021-05-14
111111,Luar DKI & Proses Update,Luar DKI & Proses Update,143008,137,141294,1273,304,441,2021-05-15
317201,JAKARTA UTARA,PENJARINGAN,8340,116,8021,112,91,207,2021-05-15
317404,JAKARTA SELATAN,PASAR MINGGU,11734,106,11329,215,84,190,2021-05-15
317504,JAKARTA TIMUR,KRAMAT JATI,10350,56,9984,193,117,173,2021-05-15
317508,JAKARTA TIMUR,MAKASAR,8905,65,8639,148,53,118,2021-05-15
317501,JAKARTA TIMUR,MATRAMAN,6582,56,6336,139,51,107,2021-05-15
317106,JAKARTA PUSAT,MENTENG,3305,35,3191,68,11,46,2021-05-15
317205,JAKARTA UTARA,PADEMANGAN,5279,62,4999,85,133,195,2021-05-15
317307,JAKARTA BARAT,PALMERAH,7910,92,7578,170,70,162,2021-05-15
317408,JAKARTA SELATAN,PANCORAN,6616,69,6364,109,74,143,2021-05-15
317505,JAKARTA TIMUR,PASAR REBO,8347,49,8073,156,69,118,2021-05-15
317203,JAKARTA UTARA,KOJA,8713,80,8438,162,33,113,2021-05-15
317410,JAKARTA SELATAN,PESANGGRAHAN,7603,55,7340,126,82,137,2021-05-15
317102,JAKARTA PUSAT,SAWAH BESAR,4166,49,4019,80,18,67,2021-05-15
317104,JAKARTA PUSAT,SENEN,4575,61,4401,94,19,80,2021-05-15
317402,JAKARTA SELATAN,SETIA BUDI,5617,55,5410,94,58,113,2021-05-15
317303,JAKARTA BARAT,TAMAN SARI,4026,61,3871,65,29,90,2021-05-15
317304,JAKARTA BARAT,TAMBORA,6070,101,5781,131,57,158,2021-05-15
317107,JAKARTA PUSAT,TANAH ABANG,5930,54,5721,118,37,91,2021-05-15
317202,JAKARTA UTARA,TANJUNG PRIOK,12823,153,12346,228,96,249,2021-05-15
317401,JAKARTA SELATAN,TEBET,8111,67,7810,153,81,148,2021-05-15
317502,JAKARTA TIMUR,PULO GADUNG,10216,135,9827,185,69,204,2021-05-15
310101,KAB.ADM.KEP.SERIBU,KEP. SERIBU UTARA,326,0,316,4,6,6,2021-05-15
317403,JAKARTA SELATAN,MAMPANG PRAPATAN,5905,47,5696,105,57,104,2021-05-15
317308,JAKARTA BARAT,KEMBANGAN,9327,78,9025,128,96,174,2021-05-15
317506,JAKARTA TIMUR,CAKUNG,11975,97,11599,210,69,166,2021-05-15
317105,JAKARTA PUSAT,CEMPAKA PUTIH,5124,46,4953,86,39,85,2021-05-15
317301,JAKARTA BARAT,CENGKARENG,13541,147,13028,274,92,239,2021-05-15
317406,JAKARTA SELATAN,CILANDAK,8416,68,8117,131,100,168,2021-05-15
317204,JAKARTA UTARA,CILINCING,8083,80,7798,161,44,124,2021-05-15
317510,JAKARTA TIMUR,CIPAYUNG,10663,84,10369,124,86,170,2021-05-15
310102,KAB.ADM.KEP.SERIBU,KEP. SERIBU SELATAN,244,0,241,3,0,0,2021-05-15
317507,JAKARTA TIMUR,DUREN SAWIT,14664,109,14124,308,123,232,2021-05-15
317101,JAKARTA PUSAT,GAMBIR,3905,39,3763,67,36,75,2021-05-15
317302,JAKARTA BARAT,GROGOL PETAMBURAN,8506,93,8166,165,82,175,2021-05-15
317509,JAKARTA TIMUR,CIRACAS,9738,92,9383,184,79,171,2021-05-15
317103,JAKARTA PUSAT,KEMAYORAN,10188,115,9814,184,75,190,2021-05-15
317503,JAKARTA TIMUR,JATINEGARA,9193,70,8897,177,49,119,2021-05-15
317108,JAKARTA PUSAT,JOHAR BARU,4244,29,4085,105,25,54,2021-05-15
317306,JAKARTA BARAT,KALI DERES,8295,84,7989,147,75,159,2021-05-15
317407,JAKARTA SELATAN,KEBAYORAN BARU,6713,83,6465,100,65,148,2021-05-15
317405,JAKARTA SELATAN,KEBAYORAN LAMA,9678,104,9314,179,81,185,2021-05-15
317305,JAKARTA BARAT,KEBON JERUK,10770,126,10362,190,92,218,2021-05-15
317206,JAKARTA UTARA,KELAPA GADING,6113,49,5888,102,74,123,2021-05-15
317409,JAKARTA SELATAN,JAGAKARSA,12085,96,11657,196,136,232,2021-05-15
317505,JAKARTA TIMUR,PASAR REBO,8351,48,8076,156,71,119,2021-05-16
317404,JAKARTA SELATAN,PASAR MINGGU,11738,106,11331,217,84,190,2021-05-16
317408,JAKARTA SELATAN,PANCORAN,6619,70,6366,109,74,144,2021-05-16
317307,JAKARTA BARAT,PALMERAH,7912,88,7600,171,53,141,2021-05-16
317403,JAKARTA SELATAN,MAMPANG PRAPATAN,5905,44,5700,105,56,100,2021-05-16
317106,JAKARTA PUSAT,MENTENG,3306,34,3193,68,11,45,2021-05-16
317501,JAKARTA TIMUR,MATRAMAN,6584,55,6337,139,53,108,2021-05-16
317201,JAKARTA UTARA,PENJARINGAN,8348,116,8026,112,94,210,2021-05-16
317205,JAKARTA UTARA,PADEMANGAN,5283,63,5022,85,113,176,2021-05-16
317410,JAKARTA SELATAN,PESANGGRAHAN,7605,56,7341,126,82,138,2021-05-16
317504,JAKARTA TIMUR,KRAMAT JATI,10359,65,9983,194,117,182,2021-05-16
317102,JAKARTA PUSAT,SAWAH BESAR,4166,42,4029,80,15,57,2021-05-16
317104,JAKARTA PUSAT,SENEN,4575,58,4408,94,15,73,2021-05-16
317402,JAKARTA SELATAN,SETIA BUDI,5617,57,5414,95,51,108,2021-05-16
317303,JAKARTA BARAT,TAMAN SARI,4026,59,3875,65,27,86,2021-05-16
317304,JAKARTA BARAT,TAMBORA,6071,99,5787,131,54,153,2021-05-16
317107,JAKARTA PUSAT,TANAH ABANG,5931,54,5726,118,33,87,2021-05-16
317202,JAKARTA UTARA,TANJUNG PRIOK,12827,156,12352,228,91,247,2021-05-16
317401,JAKARTA SELATAN,TEBET,8114,70,7810,153,81,151,2021-05-16
111111,Luar DKI & Proses Update,Luar DKI & Proses Update,143008,137,141294,1273,304,441,2021-05-16
317508,JAKARTA TIMUR,MAKASAR,8912,71,8642,148,51,122,2021-05-16
317502,JAKARTA TIMUR,PULO GADUNG,10221,134,9833,186,68,202,2021-05-16
317203,JAKARTA UTARA,KOJA,8720,80,8443,163,34,114,2021-05-16
317409,JAKARTA SELATAN,JAGAKARSA,12088,98,11658,197,135,233,2021-05-16
317506,JAKARTA TIMUR,CAKUNG,11977,94,11602,210,71,165,2021-05-16
310101,KAB.ADM.KEP.SERIBU,KEP. SERIBU UTARA,326,0,316,4,6,6,2021-05-16
317105,JAKARTA PUSAT,CEMPAKA PUTIH,5126,48,4954,87,37,85,2021-05-16
317301,JAKARTA BARAT,CENGKARENG,13548,151,13034,274,89,240,2021-05-16
317406,JAKARTA SELATAN,CILANDAK,8427,65,8127,131,104,169,2021-05-16
317204,JAKARTA UTARA,CILINCING,8087,83,7801,161,42,125,2021-05-16
317510,JAKARTA TIMUR,CIPAYUNG,10671,88,10371,125,87,175,2021-05-16
317507,JAKARTA TIMUR,DUREN SAWIT,14668,108,14127,309,124,232,2021-05-16
317101,JAKARTA PUSAT,GAMBIR,3905,38,3771,67,29,67,2021-05-16
317302,JAKARTA BARAT,GROGOL PETAMBURAN,8510,91,8179,166,74,165,2021-05-16
317509,JAKARTA TIMUR,CIRACAS,9744,93,9384,186,81,174,2021-05-16
317308,JAKARTA BARAT,KEMBANGAN,9331,81,9038,128,84,165,2021-05-16
317108,JAKARTA PUSAT,JOHAR BARU,4244,27,4090,105,22,49,2021-05-16
317306,JAKARTA BARAT,KALI DERES,8298,88,7997,147,66,154,2021-05-16
317407,JAKARTA SELATAN,KEBAYORAN BARU,6713,82,6466,100,65,147,2021-05-16
317405,JAKARTA SELATAN,KEBAYORAN LAMA,9683,105,9316,180,82,187,2021-05-16
317305,JAKARTA BARAT,KEBON JERUK,10772,125,10376,190,81,206,2021-05-16
317206,JAKARTA UTARA,KELAPA GADING,6121,49,5893,102,77,126,2021-05-16
317103,JAKARTA PUSAT,KEMAYORAN,10190,112,9821,184,73,185,2021-05-16
317503,JAKARTA TIMUR,JATINEGARA,9201,70,8899,177,55,125,2021-05-16
310102,KAB.ADM.KEP.SERIBU,KEP. SERIBU SELATAN,244,0,241,3,0,0,2021-05-16
317505,JAKARTA TIMUR,PASAR REBO,8352,49,8079,156,68,117,2021-05-17
317404,JAKARTA SELATAN,PASAR MINGGU,11743,106,11334,219,84,190,2021-05-17
317408,JAKARTA SELATAN,PANCORAN,6628,78,6373,111,66,144,2021-05-17
317307,JAKARTA BARAT,PALMERAH,7928,92,7604,172,60,152,2021-05-17
317403,JAKARTA SELATAN,MAMPANG PRAPATAN,5907,45,5706,105,51,96,2021-05-17
317106,JAKARTA PUSAT,MENTENG,3310,36,3194,68,12,48,2021-05-17
317501,JAKARTA TIMUR,MATRAMAN,6589,58,6341,139,51,109,2021-05-17
317201,JAKARTA UTARA,PENJARINGAN,8367,130,8029,112,96,226,2021-05-17
317205,JAKARTA UTARA,PADEMANGAN,5291,71,5031,85,104,175,2021-05-17
317410,JAKARTA SELATAN,PESANGGRAHAN,7615,62,7344,127,82,144,2021-05-17
111111,Luar DKI & Proses Update,Luar DKI & Proses Update,143008,137,141294,1273,304,441,2021-05-17
317102,JAKARTA PUSAT,SAWAH BESAR,4170,41,4031,80,18,59,2021-05-17
317104,JAKARTA PUSAT,SENEN,4579,59,4411,94,15,74,2021-05-17
317402,JAKARTA SELATAN,SETIA BUDI,5622,58,5415,96,53,111,2021-05-17
317303,JAKARTA BARAT,TAMAN SARI,4031,57,3879,65,30,87,2021-05-17
317304,JAKARTA BARAT,TAMBORA,6087,107,5788,132,60,167,2021-05-17
317107,JAKARTA PUSAT,TANAH ABANG,5941,58,5729,118,36,94,2021-05-17
317202,JAKARTA UTARA,TANJUNG PRIOK,12842,166,12354,231,91,257,2021-05-17
317401,JAKARTA SELATAN,TEBET,8117,74,7814,153,76,150,2021-05-17
317508,JAKARTA TIMUR,MAKASAR,8920,72,8648,149,51,123,2021-05-17
317502,JAKARTA TIMUR,PULO GADUNG,10248,145,9862,186,55,200,2021-05-17
317504,JAKARTA TIMUR,KRAMAT JATI,10363,72,9996,194,101,173,2021-05-17
317510,JAKARTA TIMUR,CIPAYUNG,10677,90,10373,125,89,179,2021-05-17
310101,KAB.ADM.KEP.SERIBU,KEP. SERIBU UTARA,326,0,316,4,6,6,2021-05-17
317506,JAKARTA TIMUR,CAKUNG,11988,98,11612,210,68,166,2021-05-17
317105,JAKARTA PUSAT,CEMPAKA PUTIH,5132,45,4958,87,42,87,2021-05-17
317301,JAKARTA BARAT,CENGKARENG,13568,159,13036,276,97,256,2021-05-17
317406,JAKARTA SELATAN,CILANDAK,8440,65,8131,132,112,177,2021-05-17
317204,JAKARTA UTARA,CILINCING,8090,86,7803,161,40,126,2021-05-17
317509,JAKARTA TIMUR,CIRACAS,9752,101,9391,187,73,174,2021-05-17
317507,JAKARTA TIMUR,DUREN SAWIT,14672,111,14138,309,114,225,2021-05-17
317101,JAKARTA PUSAT,GAMBIR,3909,38,3773,67,31,69,2021-05-17
317203,JAKARTA UTARA,KOJA,8723,77,8454,163,29,106,2021-05-17
317409,JAKARTA SELATAN,JAGAKARSA,12099,107,11662,197,133,240,2021-05-17
317302,JAKARTA BARAT,GROGOL PETAMBURAN,8516,93,8181,168,74,167,2021-05-17
317108,JAKARTA PUSAT,JOHAR BARU,4246,26,4093,105,22,48,2021-05-17
317306,JAKARTA BARAT,KALI DERES,8304,93,7996,149,66,159,2021-05-17
317407,JAKARTA SELATAN,KEBAYORAN BARU,6728,89,6478,100,61,150,2021-05-17
317405,JAKARTA SELATAN,KEBAYORAN LAMA,9700,109,9334,181,76,185,2021-05-17
317305,JAKARTA BARAT,KEBON JERUK,10788,134,10378,191,85,219,2021-05-17
317206,JAKARTA UTARA,KELAPA GADING,6129,56,5898,102,73,129,2021-05-17
317103,JAKARTA PUSAT,KEMAYORAN,10203,112,9833,184,74,186,2021-05-17
317308,JAKARTA BARAT,KEMBANGAN,9342,83,9039,128,92,175,2021-05-17
310102,KAB.ADM.KEP.SERIBU,KEP. SERIBU SELATAN,244,0,241,3,0,0,2021-05-17
317503,JAKARTA TIMUR,JATINEGARA,9206,74,8901,177,54,128,2021-05-17
317506,JAKARTA TIMUR,CAKUNG,11991,95,11615,211,70,165,2021-05-18
111111,Luar DKI & Proses Update,Luar DKI & Proses Update,143008,137,141294,1273,304,441,2021-05-18
317105,JAKARTA PUSAT,CEMPAKA PUTIH,5130,44,4957,87,42,86,2021-05-18
317301,JAKARTA BARAT,CENGKARENG,13578,167,13042,276,93,260,2021-05-18
317503,JAKARTA TIMUR,JATINEGARA,9211,74,8899,180,58,132,2021-05-18
317106,JAKARTA PUSAT,MENTENG,3313,36,3195,68,14,50,2021-05-18
317205,JAKARTA UTARA,PADEMANGAN,5302,73,5045,86,98,171,2021-05-18
317307,JAKARTA BARAT,PALMERAH,7931,95,7604,172,60,155,2021-05-18
317408,JAKARTA SELATAN,PANCORAN,6631,76,6376,111,68,144,2021-05-18
317404,JAKARTA SELATAN,PASAR MINGGU,11767,103,11340,219,105,208,2021-05-18
317505,JAKARTA TIMUR,PASAR REBO,8357,51,8080,156,70,121,2021-05-18
317201,JAKARTA UTARA,PENJARINGAN,8371,130,8038,113,90,220,2021-05-18
317501,JAKARTA TIMUR,MATRAMAN,6557,55,6313,141,48,103,2021-05-18
317410,JAKARTA SELATAN,PESANGGRAHAN,7633,61,7346,128,98,159,2021-05-18
317102,JAKARTA PUSAT,SAWAH BESAR,4171,41,4030,82,18,59,2021-05-18
317104,JAKARTA PUSAT,SENEN,4581,60,4411,94,16,76,2021-05-18
317402,JAKARTA SELATAN,SETIA BUDI,5622,55,5417,97,53,108,2021-05-18
317303,JAKARTA BARAT,TAMAN SARI,4032,57,3879,65,31,88,2021-05-18
317304,JAKARTA BARAT,TAMBORA,6089,109,5788,132,60,169,2021-05-18
317107,JAKARTA PUSAT,TANAH ABANG,5945,60,5729,118,38,98,2021-05-18
317202,JAKARTA UTARA,TANJUNG PRIOK,12847,168,12358,232,89,257,2021-05-18
317502,JAKARTA TIMUR,PULO GADUNG,10259,146,9863,187,63,209,2021-05-18
317403,JAKARTA SELATAN,MAMPANG PRAPATAN,5910,42,5710,105,53,95,2021-05-18
317508,JAKARTA TIMUR,MAKASAR,8933,76,8648,149,60,136,2021-05-18
317504,JAKARTA TIMUR,KRAMAT JATI,10373,74,9997,194,108,182,2021-05-18
317407,JAKARTA SELATAN,KEBAYORAN BARU,6740,88,6487,100,65,153,2021-05-18
317306,JAKARTA BARAT,KALI DERES,8313,101,7997,149,66,167,2021-05-18
317108,JAKARTA PUSAT,JOHAR BARU,4249,29,4093,105,22,51,2021-05-18
317206,JAKARTA UTARA,KELAPA GADING,6132,57,5899,102,74,131,2021-05-18
317409,JAKARTA SELATAN,JAGAKARSA,12114,112,11664,198,140,252,2021-05-18
317302,JAKARTA BARAT,GROGOL PETAMBURAN,8518,95,8182,168,73,168,2021-05-18
317101,JAKARTA PUSAT,GAMBIR,3912,40,3774,67,31,71,2021-05-18
317507,JAKARTA TIMUR,DUREN SAWIT,14684,119,14139,310,116,235,2021-05-18
317509,JAKARTA TIMUR,CIRACAS,9766,99,9396,189,82,181,2021-05-18
317510,JAKARTA TIMUR,CIPAYUNG,10680,87,10376,126,91,178,2021-05-18
317204,JAKARTA UTARA,CILINCING,8092,88,7803,161,40,128,2021-05-18
317406,JAKARTA SELATAN,CILANDAK,8449,70,8132,132,115,185,2021-05-18
317103,JAKARTA PUSAT,KEMAYORAN,10206,112,9834,184,76,188,2021-05-18
317308,JAKARTA BARAT,KEMBANGAN,9346,84,9040,129,93,177,2021-05-18
310102,KAB.ADM.KEP.SERIBU,KEP. SERIBU SELATAN,244,0,241,3,0,0,2021-05-18
310101,KAB.ADM.KEP.SERIBU,KEP. SERIBU UTARA,326,0,317,4,5,5,2021-05-18
317203,JAKARTA UTARA,KOJA,8728,80,8456,163,29,109,2021-05-18
317401,JAKARTA SELATAN,TEBET,8122,70,7819,154,79,149,2021-05-18
317405,JAKARTA SELATAN,KEBAYORAN LAMA,9716,110,9337,183,86,196,2021-05-18
317305,JAKARTA BARAT,KEBON JERUK,10791,135,10379,191,86,221,2021-05-18
317101,JAKARTA PUSAT,GAMBIR,3929,49,3776,67,37,86,2021-05-19
317403,JAKARTA SELATAN,MAMPANG PRAPATAN,5919,44,5714,105,56,100,2021-05-19
317508,JAKARTA TIMUR,MAKASAR,8940,75,8654,149,62,137,2021-05-19
317504,JAKARTA TIMUR,KRAMAT JATI,10383,81,9998,194,110,191,2021-05-19
317203,JAKARTA UTARA,KOJA,8732,77,8459,165,31,108,2021-05-19
310101,KAB.ADM.KEP.SERIBU,KEP. SERIBU UTARA,326,0,317,4,5,5,2021-05-19
310102,KAB.ADM.KEP.SERIBU,KEP. SERIBU SELATAN,245,0,242,3,0,0,2021-05-19
317308,JAKARTA BARAT,KEMBANGAN,9358,86,9043,131,98,184,2021-05-19
317103,JAKARTA PUSAT,KEMAYORAN,10208,116,9835,184,73,189,2021-05-19
317206,JAKARTA UTARA,KELAPA GADING,6139,56,5903,102,78,134,2021-05-19
317305,JAKARTA BARAT,KEBON JERUK,10823,150,10396,191,86,236,2021-05-19
317405,JAKARTA SELATAN,KEBAYORAN LAMA,9734,121,9342,183,88,209,2021-05-19
317407,JAKARTA SELATAN,KEBAYORAN BARU,6761,93,6494,101,73,166,2021-05-19
317501,JAKARTA TIMUR,MATRAMAN,6559,52,6315,142,50,102,2021-05-19
317306,JAKARTA BARAT,KALI DERES,8319,107,8004,149,59,166,2021-05-19
317503,JAKARTA TIMUR,JATINEGARA,9222,77,8903,181,61,138,2021-05-19
317409,JAKARTA SELATAN,JAGAKARSA,12123,118,11664,199,142,260,2021-05-19
317302,JAKARTA BARAT,GROGOL PETAMBURAN,8536,105,8196,168,67,172,2021-05-19
317507,JAKARTA TIMUR,DUREN SAWIT,14696,123,14147,310,116,239,2021-05-19
317509,JAKARTA TIMUR,CIRACAS,9774,105,9400,191,78,183,2021-05-19
317510,JAKARTA TIMUR,CIPAYUNG,10712,97,10375,127,113,210,2021-05-19
317204,JAKARTA UTARA,CILINCING,8096,90,7804,162,40,130,2021-05-19
317406,JAKARTA SELATAN,CILANDAK,8487,86,8135,132,134,220,2021-05-19
317301,JAKARTA BARAT,CENGKARENG,13594,177,13043,277,97,274,2021-05-19
317105,JAKARTA PUSAT,CEMPAKA PUTIH,5136,52,4957,87,40,92,2021-05-19
317506,JAKARTA TIMUR,CAKUNG,12006,101,11616,211,78,179,2021-05-19
111111,Luar DKI & Proses Update,Luar DKI & Proses Update,143008,137,141294,1273,304,441,2021-05-19
317108,JAKARTA PUSAT,JOHAR BARU,4249,27,4095,105,22,49,2021-05-19
317106,JAKARTA PUSAT,MENTENG,3315,38,3195,68,14,52,2021-05-19
317205,JAKARTA UTARA,PADEMANGAN,5324,81,5055,86,102,183,2021-05-19
317307,JAKARTA BARAT,PALMERAH,7938,101,7616,174,47,148,2021-05-19
317401,JAKARTA SELATAN,TEBET,8141,80,7825,154,82,162,2021-05-19
317202,JAKARTA UTARA,TANJUNG PRIOK,12856,167,12368,232,89,256,2021-05-19
317304,JAKARTA BARAT,TAMBORA,6097,112,5788,132,65,177,2021-05-19
317303,JAKARTA BARAT,TAMAN SARI,4035,57,3881,65,32,89,2021-05-19
317402,JAKARTA SELATAN,SETIA BUDI,5644,76,5417,97,54,130,2021-05-19
317104,JAKARTA PUSAT,SENEN,4590,63,4411,94,22,85,2021-05-19
317107,JAKARTA PUSAT,TANAH ABANG,5952,62,5731,118,41,103,2021-05-19
317502,JAKARTA TIMUR,PULO GADUNG,10280,154,9870,187,69,223,2021-05-19
317410,JAKARTA SELATAN,PESANGGRAHAN,7639,65,7346,129,99,164,2021-05-19
317201,JAKARTA UTARA,PENJARINGAN,8386,136,8041,114,95,231,2021-05-19
317505,JAKARTA TIMUR,PASAR REBO,8371,56,8081,156,78,134,2021-05-19
317404,JAKARTA SELATAN,PASAR MINGGU,11780,111,11342,220,107,218,2021-05-19
317408,JAKARTA SELATAN,PANCORAN,6636,79,6376,112,69,148,2021-05-19
317102,JAKARTA PUSAT,SAWAH BESAR,4171,41,4030,82,18,59,2021-05-19
317201,JAKARTA UTARA,PENJARINGAN,8405,135,8053,114,103,238,2021-05-20
317505,JAKARTA TIMUR,PASAR REBO,8398,59,8083,157,99,158,2021-05-20
317404,JAKARTA SELATAN,PASAR MINGGU,11795,117,11344,222,112,229,2021-05-20
317408,JAKARTA SELATAN,PANCORAN,6661,88,6377,112,84,172,2021-05-20
317106,JAKARTA PUSAT,MENTENG,3321,37,3199,68,17,54,2021-05-20
317205,JAKARTA UTARA,PADEMANGAN,5335,84,5055,86,110,194,2021-05-20
317501,JAKARTA TIMUR,MATRAMAN,6569,55,6316,143,55,110,2021-05-20
317410,JAKARTA SELATAN,PESANGGRAHAN,7654,72,7348,130,104,176,2021-05-20
317307,JAKARTA BARAT,PALMERAH,7955,112,7617,175,51,163,2021-05-20
317502,JAKARTA TIMUR,PULO GADUNG,10304,168,9877,188,71,239,2021-05-20
317202,JAKARTA UTARA,TANJUNG PRIOK,12874,170,12371,232,101,271,2021-05-20
317104,JAKARTA PUSAT,SENEN,4597,65,4413,95,24,89,2021-05-20
317402,JAKARTA SELATAN,SETIA BUDI,5656,77,5422,97,60,137,2021-05-20
317303,JAKARTA BARAT,TAMAN SARI,4046,62,3889,65,30,92,2021-05-20
317304,JAKARTA BARAT,TAMBORA,6116,114,5801,134,67,181,2021-05-20
317107,JAKARTA PUSAT,TANAH ABANG,5963,66,5733,118,46,112,2021-05-20
317403,JAKARTA SELATAN,MAMPANG PRAPATAN,5928,48,5715,105,60,108,2021-05-20
317401,JAKARTA SELATAN,TEBET,8160,85,7831,154,90,175,2021-05-20
317503,JAKARTA TIMUR,JATINEGARA,9246,85,8906,182,73,158,2021-05-20
111111,Luar DKI & Proses Update,Luar DKI & Proses Update,143008,137,141294,1273,304,441,2021-05-20
317102,JAKARTA PUSAT,SAWAH BESAR,4179,40,4030,83,26,66,2021-05-20
317508,JAKARTA TIMUR,MAKASAR,8948,84,8656,149,59,143,2021-05-20
310102,KAB.ADM.KEP.SERIBU,KEP. SERIBU SELATAN,245,0,242,3,0,0,2021-05-20
317203,JAKARTA UTARA,KOJA,8739,79,8460,165,35,114,2021-05-20
317506,JAKARTA TIMUR,CAKUNG,12020,108,11620,211,81,189,2021-05-20
317105,JAKARTA PUSAT,CEMPAKA PUTIH,5151,52,4966,87,46,98,2021-05-20
317301,JAKARTA BARAT,CENGKARENG,13638,187,13058,277,116,303,2021-05-20
317108,JAKARTA PUSAT,JOHAR BARU,4252,28,4096,105,23,51,2021-05-20
317406,JAKARTA SELATAN,CILANDAK,8523,102,8136,132,153,255,2021-05-20
317204,JAKARTA UTARA,CILINCING,8117,92,7805,163,57,149,2021-05-20
317510,JAKARTA TIMUR,CIPAYUNG,10744,104,10376,127,137,241,2021-05-20
317504,JAKARTA TIMUR,KRAMAT JATI,10403,76,10005,194,128,204,2021-05-20
317507,JAKARTA TIMUR,DUREN SAWIT,14739,130,14154,310,145,275,2021-05-20
317101,JAKARTA PUSAT,GAMBIR,3938,53,3780,67,38,91,2021-05-20
317509,JAKARTA TIMUR,CIRACAS,9788,109,9403,191,85,194,2021-05-20
317409,JAKARTA SELATAN,JAGAKARSA,12174,119,11674,199,182,301,2021-05-20
317407,JAKARTA SELATAN,KEBAYORAN BARU,6783,93,6506,102,82,175,2021-05-20
317405,JAKARTA SELATAN,KEBAYORAN LAMA,9758,125,9346,185,102,227,2021-05-20
317305,JAKARTA BARAT,KEBON JERUK,10849,157,10401,192,99,256,2021-05-20
317206,JAKARTA UTARA,KELAPA GADING,6154,60,5905,102,87,147,2021-05-20
317103,JAKARTA PUSAT,KEMAYORAN,10227,125,9840,186,76,201,2021-05-20
317308,JAKARTA BARAT,KEMBANGAN,9394,97,9044,131,122,219,2021-05-20
317306,JAKARTA BARAT,KALI DERES,8336,115,8005,149,67,182,2021-05-20
317302,JAKARTA BARAT,GROGOL PETAMBURAN,8568,117,8207,168,76,193,2021-05-20
310101,KAB.ADM.KEP.SERIBU,KEP. SERIBU UTARA,327,1,317,4,5,6,2021-05-20
111111,Luar DKI & Proses Update,Luar DKI & Proses Update,143008,137,141294,1273,304,441,2021-05-21
317510,JAKARTA TIMUR,CIPAYUNG,10765,113,10376,127,149,262,2021-05-21
317506,JAKARTA TIMUR,CAKUNG,12038,114,11621,212,91,205,2021-05-21
317406,JAKARTA SELATAN,CILANDAK,8539,105,8157,132,145,250,2021-05-21
317301,JAKARTA BARAT,CENGKARENG,13666,193,13065,279,129,322,2021-05-21
317105,JAKARTA PUSAT,CEMPAKA PUTIH,5157,53,4966,87,51,104,2021-05-21
317204,JAKARTA UTARA,CILINCING,8133,100,7806,164,63,163,2021-05-21
317509,JAKARTA TIMUR,CIRACAS,9806,116,9404,191,95,211,2021-05-21
317507,JAKARTA TIMUR,DUREN SAWIT,14766,137,14157,311,161,298,2021-05-21
317410,JAKARTA SELATAN,PESANGGRAHAN,7660,75,7350,131,104,179,2021-05-21
317106,JAKARTA PUSAT,MENTENG,3323,38,3200,68,17,55,2021-05-21
317307,JAKARTA BARAT,PALMERAH,7967,115,7620,175,57,172,2021-05-21
317408,JAKARTA SELATAN,PANCORAN,6669,88,6378,112,91,179,2021-05-21
317404,JAKARTA SELATAN,PASAR MINGGU,11826,131,11345,223,127,258,2021-05-21
317505,JAKARTA TIMUR,PASAR REBO,8402,60,8083,157,102,162,2021-05-21
317201,JAKARTA UTARA,PENJARINGAN,8453,151,8065,114,123,274,2021-05-21
317502,JAKARTA TIMUR,PULO GADUNG,10335,173,9881,188,93,266,2021-05-21
317102,JAKARTA PUSAT,SAWAH BESAR,4189,43,4035,83,28,71,2021-05-21
317104,JAKARTA PUSAT,SENEN,4603,68,4417,95,23,91,2021-05-21
317402,JAKARTA SELATAN,SETIA BUDI,5672,82,5421,98,71,153,2021-05-21
317303,JAKARTA BARAT,TAMAN SARI,4057,67,3892,66,32,99,2021-05-21
317304,JAKARTA BARAT,TAMBORA,6135,121,5806,134,74,195,2021-05-21
317107,JAKARTA PUSAT,TANAH ABANG,5988,70,5737,118,63,133,2021-05-21
317202,JAKARTA UTARA,TANJUNG PRIOK,12901,184,12373,232,112,296,2021-05-21
317401,JAKARTA SELATAN,TEBET,8186,97,7833,154,102,199,2021-05-21
317501,JAKARTA TIMUR,MATRAMAN,6581,57,6317,143,64,121,2021-05-21
317403,JAKARTA SELATAN,MAMPANG PRAPATAN,5938,52,5716,105,65,117,2021-05-21
317205,JAKARTA UTARA,PADEMANGAN,5354,89,5059,86,120,209,2021-05-21
317504,JAKARTA TIMUR,KRAMAT JATI,10420,82,10007,194,137,219,2021-05-21
317101,JAKARTA PUSAT,GAMBIR,3949,53,3781,68,47,100,2021-05-21
317302,JAKARTA BARAT,GROGOL PETAMBURAN,8590,127,8208,168,87,214,2021-05-21
317409,JAKARTA SELATAN,JAGAKARSA,12186,118,11683,199,186,304,2021-05-21
317503,JAKARTA TIMUR,JATINEGARA,9259,89,8907,183,80,169,2021-05-21
317508,JAKARTA TIMUR,MAKASAR,8954,87,8655,151,61,148,2021-05-21
317306,JAKARTA BARAT,KALI DERES,8355,128,8006,149,72,200,2021-05-21
317407,JAKARTA SELATAN,KEBAYORAN BARU,6806,106,6513,102,85,191,2021-05-21
317405,JAKARTA SELATAN,KEBAYORAN LAMA,9785,134,9350,186,115,249,2021-05-21
317108,JAKARTA PUSAT,JOHAR BARU,4257,28,4099,105,25,53,2021-05-21
317305,JAKARTA BARAT,KEBON JERUK,10868,160,10405,192,111,271,2021-05-21
317206,JAKARTA UTARA,KELAPA GADING,6184,78,5907,102,97,175,2021-05-21
317103,JAKARTA PUSAT,KEMAYORAN,10260,136,9869,186,69,205,2021-05-21
317308,JAKARTA BARAT,KEMBANGAN,9410,111,9046,132,121,232,2021-05-21
310102,KAB.ADM.KEP.SERIBU,KEP. SERIBU SELATAN,245,0,242,3,0,0,2021-05-21
310101,KAB.ADM.KEP.SERIBU,KEP. SERIBU UTARA,328,1,322,4,1,2,2021-05-21
317203,JAKARTA UTARA,KOJA,8752,85,8462,165,40,125,2021-05-21
310102,KAB.ADM.KEP.SERIBU,KEP. SERIBU SELATAN,245,0,242,3,0,0,2021-05-22
310101,KAB.ADM.KEP.SERIBU,KEP. SERIBU UTARA,329,1,322,4,2,3,2021-05-22
317203,JAKARTA UTARA,KOJA,8764,92,8465,165,42,134,2021-05-22
317504,JAKARTA TIMUR,KRAMAT JATI,10451,91,10011,194,155,246,2021-05-22
317106,JAKARTA PUSAT,MENTENG,3334,43,3204,68,19,62,2021-05-22
317403,JAKARTA SELATAN,MAMPANG PRAPATAN,5950,56,5729,105,60,116,2021-05-22
317501,JAKARTA TIMUR,MATRAMAN,6598,66,6320,144,68,134,2021-05-22
317308,JAKARTA BARAT,KEMBANGAN,9429,109,9057,132,131,240,2021-05-22
317509,JAKARTA TIMUR,CIRACAS,9820,121,9422,191,86,207,2021-05-22
317103,JAKARTA PUSAT,KEMAYORAN,10270,133,9884,186,67,200,2021-05-22
317508,JAKARTA TIMUR,MAKASAR,8970,92,8656,151,71,163,2021-05-22
317305,JAKARTA BARAT,KEBON JERUK,10901,162,10419,192,128,290,2021-05-22
317405,JAKARTA SELATAN,KEBAYORAN LAMA,9809,147,9365,186,111,258,2021-05-22
317407,JAKARTA SELATAN,KEBAYORAN BARU,6838,112,6545,102,79,191,2021-05-22
317306,JAKARTA BARAT,KALI DERES,8366,127,8011,149,79,206,2021-05-22
317108,JAKARTA PUSAT,JOHAR BARU,4267,34,4101,106,26,60,2021-05-22
317503,JAKARTA TIMUR,JATINEGARA,9289,104,8910,183,92,196,2021-05-22
317409,JAKARTA SELATAN,JAGAKARSA,12217,115,11708,199,195,310,2021-05-22
317205,JAKARTA UTARA,PADEMANGAN,5370,94,5063,86,127,221,2021-05-22
317302,JAKARTA BARAT,GROGOL PETAMBURAN,8612,120,8225,168,99,219,2021-05-22
317206,JAKARTA UTARA,KELAPA GADING,6201,92,5908,102,99,191,2021-05-22
317307,JAKARTA BARAT,PALMERAH,7988,109,7637,175,67,176,2021-05-22
317301,JAKARTA BARAT,CENGKARENG,13700,202,13077,280,141,343,2021-05-22
317404,JAKARTA SELATAN,PASAR MINGGU,11844,142,11360,223,119,261,2021-05-22
111111,Luar DKI & Proses Update,Luar DKI & Proses Update,143008,137,141294,1273,304,441,2021-05-22
317506,JAKARTA TIMUR,CAKUNG,12051,120,11639,212,80,200,2021-05-22
317105,JAKARTA PUSAT,CEMPAKA PUTIH,5159,47,4974,87,51,98,2021-05-22
317101,JAKARTA PUSAT,GAMBIR,3958,60,3783,68,47,107,2021-05-22
317406,JAKARTA SELATAN,CILANDAK,8559,107,8165,134,153,260,2021-05-22
317204,JAKARTA UTARA,CILINCING,8147,106,7812,165,64,170,2021-05-22
317510,JAKARTA TIMUR,CIPAYUNG,10813,127,10392,128,166,293,2021-05-22
317401,JAKARTA SELATAN,TEBET,8199,102,7845,155,97,199,2021-05-22
317202,JAKARTA UTARA,TANJUNG PRIOK,12915,197,12375,232,111,308,2021-05-22
317107,JAKARTA PUSAT,TANAH ABANG,5996,74,5740,118,64,138,2021-05-22
317304,JAKARTA BARAT,TAMBORA,6150,122,5814,134,80,202,2021-05-22
317303,JAKARTA BARAT,TAMAN SARI,4065,70,3896,66,33,103,2021-05-22
317402,JAKARTA SELATAN,SETIA BUDI,5688,90,5430,98,70,160,2021-05-22
317104,JAKARTA PUSAT,SENEN,4610,64,4426,95,25,89,2021-05-22
317102,JAKARTA PUSAT,SAWAH BESAR,4202,52,4039,83,28,80,2021-05-22
317502,JAKARTA TIMUR,PULO GADUNG,10369,192,9880,190,107,299,2021-05-22
317410,JAKARTA SELATAN,PESANGGRAHAN,7690,80,7359,131,120,200,2021-05-22
317201,JAKARTA UTARA,PENJARINGAN,8474,160,8071,114,129,289,2021-05-22
317505,JAKARTA TIMUR,PASAR REBO,8425,64,8083,157,121,185,2021-05-22
317408,JAKARTA SELATAN,PANCORAN,6693,99,6391,113,90,189,2021-05-22
317507,JAKARTA TIMUR,DUREN SAWIT,14798,150,14163,311,174,324,2021-05-22
317401,JAKARTA SELATAN,TEBET,8215,96,7857,155,107,203,2021-05-23
317506,JAKARTA TIMUR,CAKUNG,12092,116,11650,212,114,230,2021-05-23
317508,JAKARTA TIMUR,MAKASAR,8983,92,8672,151,68,160,2021-05-23
317403,JAKARTA SELATAN,MAMPANG PRAPATAN,5964,57,5739,105,63,120,2021-05-23
317501,JAKARTA TIMUR,MATRAMAN,6602,62,6333,145,62,124,2021-05-23
317106,JAKARTA PUSAT,MENTENG,3339,48,3204,68,19,67,2021-05-23
317205,JAKARTA UTARA,PADEMANGAN,5389,90,5086,86,127,217,2021-05-23
317307,JAKARTA BARAT,PALMERAH,8014,120,7637,175,82,202,2021-05-23
317408,JAKARTA SELATAN,PANCORAN,6702,100,6395,113,94,194,2021-05-23
317404,JAKARTA SELATAN,PASAR MINGGU,11870,140,11370,223,137,277,2021-05-23
317505,JAKARTA TIMUR,PASAR REBO,8447,61,8103,157,126,187,2021-05-23
317201,JAKARTA UTARA,PENJARINGAN,8481,165,8083,114,119,284,2021-05-23
317410,JAKARTA SELATAN,PESANGGRAHAN,7699,79,7364,131,125,204,2021-05-23
317502,JAKARTA TIMUR,PULO GADUNG,10396,174,9913,192,117,291,2021-05-23
317102,JAKARTA PUSAT,SAWAH BESAR,4224,56,4043,83,42,98,2021-05-23
317104,JAKARTA PUSAT,SENEN,4619,70,4425,96,28,98,2021-05-23
317402,JAKARTA SELATAN,SETIA BUDI,5702,89,5437,98,78,167,2021-05-23
317303,JAKARTA BARAT,TAMAN SARI,4067,70,3896,66,35,105,2021-05-23
317304,JAKARTA BARAT,TAMBORA,6167,127,5815,134,91,218,2021-05-23
317107,JAKARTA PUSAT,TANAH ABANG,6017,82,5745,118,72,154,2021-05-23
317202,JAKARTA UTARA,TANJUNG PRIOK,12923,196,12390,233,104,300,2021-05-23
317504,JAKARTA TIMUR,KRAMAT JATI,10476,92,10044,194,146,238,2021-05-23
111111,Luar DKI & Proses Update,Luar DKI & Proses Update,143008,137,141294,1273,304,441,2021-05-23
317203,JAKARTA UTARA,KOJA,8778,90,8479,165,44,134,2021-05-23
310102,KAB.ADM.KEP.SERIBU,KEP. SERIBU SELATAN,245,0,242,3,0,0,2021-05-23
317105,JAKARTA PUSAT,CEMPAKA PUTIH,5169,48,4976,87,58,106,2021-05-23
317301,JAKARTA BARAT,CENGKARENG,13724,210,13076,281,157,367,2021-05-23
317406,JAKARTA SELATAN,CILANDAK,8583,111,8166,134,172,283,2021-05-23
317204,JAKARTA UTARA,CILINCING,8160,104,7823,166,67,171,2021-05-23
317510,JAKARTA TIMUR,CIPAYUNG,10854,136,10401,128,189,325,2021-05-23
317509,JAKARTA TIMUR,CIRACAS,9841,134,9424,191,92,226,2021-05-23
317507,JAKARTA TIMUR,DUREN SAWIT,14835,149,14188,311,187,336,2021-05-23
317101,JAKARTA PUSAT,GAMBIR,3964,66,3783,68,47,113,2021-05-23
317302,JAKARTA BARAT,GROGOL PETAMBURAN,8631,131,8226,168,106,237,2021-05-23
317409,JAKARTA SELATAN,JAGAKARSA,12232,117,11708,199,208,325,2021-05-23
317503,JAKARTA TIMUR,JATINEGARA,9314,109,8918,183,104,213,2021-05-23
317108,JAKARTA PUSAT,JOHAR BARU,4278,41,4100,107,30,71,2021-05-23
317306,JAKARTA BARAT,KALI DERES,8377,128,8013,149,87,215,2021-05-23
317407,JAKARTA SELATAN,KEBAYORAN BARU,6847,114,6547,102,84,198,2021-05-23
317405,JAKARTA SELATAN,KEBAYORAN LAMA,9839,137,9386,186,130,267,2021-05-23
317305,JAKARTA BARAT,KEBON JERUK,10921,170,10419,192,140,310,2021-05-23
317206,JAKARTA UTARA,KELAPA GADING,6214,90,5922,102,100,190,2021-05-23
317103,JAKARTA PUSAT,KEMAYORAN,10292,144,9884,188,76,220,2021-05-23
317308,JAKARTA BARAT,KEMBANGAN,9441,111,9056,133,141,252,2021-05-23
310101,KAB.ADM.KEP.SERIBU,KEP. SERIBU UTARA,332,1,322,4,5,6,2021-05-23
111111,Luar DKI & Proses Update,Luar DKI & Proses Update,143008,137,141294,1273,304,441,2021-05-24
317307,JAKARTA BARAT,PALMERAH,8042,133,7640,175,94,227,2021-05-24
317401,JAKARTA SELATAN,TEBET,8245,109,7860,155,121,230,2021-05-24
317504,JAKARTA TIMUR,KRAMAT JATI,10484,94,10043,196,151,245,2021-05-24
317508,JAKARTA TIMUR,MAKASAR,8997,99,8671,152,75,174,2021-05-24
317403,JAKARTA SELATAN,MAMPANG PRAPATAN,5973,63,5742,105,63,126,2021-05-24
317501,JAKARTA TIMUR,MATRAMAN,6615,63,6333,145,74,137,2021-05-24
317106,JAKARTA PUSAT,MENTENG,3342,49,3205,68,20,69,2021-05-24
317205,JAKARTA UTARA,PADEMANGAN,5413,91,5098,86,138,229,2021-05-24
317408,JAKARTA SELATAN,PANCORAN,6714,108,6395,113,98,206,2021-05-24
317404,JAKARTA SELATAN,PASAR MINGGU,11894,152,11371,223,148,300,2021-05-24
317203,JAKARTA UTARA,KOJA,8780,91,8479,165,45,136,2021-05-24
317201,JAKARTA UTARA,PENJARINGAN,8509,158,8103,115,133,291,2021-05-24
317502,JAKARTA TIMUR,PULO GADUNG,10415,183,9913,192,127,310,2021-05-24
317102,JAKARTA PUSAT,SAWAH BESAR,4229,50,4051,83,45,95,2021-05-24
317104,JAKARTA PUSAT,SENEN,4622,70,4426,97,29,99,2021-05-24
317402,JAKARTA SELATAN,SETIA BUDI,5714,100,5437,98,79,179,2021-05-24
317303,JAKARTA BARAT,TAMAN SARI,4071,65,3909,66,31,96,2021-05-24
317304,JAKARTA BARAT,TAMBORA,6180,120,5826,134,100,220,2021-05-24
317107,JAKARTA PUSAT,TANAH ABANG,6025,87,5745,118,75,162,2021-05-24
317202,JAKARTA UTARA,TANJUNG PRIOK,12961,186,12409,234,132,318,2021-05-24
317410,JAKARTA SELATAN,PESANGGRAHAN,7731,81,7364,131,155,236,2021-05-24
310101,KAB.ADM.KEP.SERIBU,KEP. SERIBU UTARA,330,2,320,4,4,6,2021-05-24
317505,JAKARTA TIMUR,PASAR REBO,8460,67,8104,157,132,199,2021-05-24
317308,JAKARTA BARAT,KEMBANGAN,9461,115,9068,135,143,258,2021-05-24
310102,KAB.ADM.KEP.SERIBU,KEP. SERIBU SELATAN,244,0,241,3,0,0,2021-05-24
317105,JAKARTA PUSAT,CEMPAKA PUTIH,5173,49,4980,87,57,106,2021-05-24
317301,JAKARTA BARAT,CENGKARENG,13753,207,13099,283,164,371,2021-05-24
317406,JAKARTA SELATAN,CILANDAK,8604,117,8167,135,185,302,2021-05-24
317204,JAKARTA UTARA,CILINCING,8170,113,7823,166,68,181,2021-05-24
317510,JAKARTA TIMUR,CIPAYUNG,10902,156,10401,128,217,373,2021-05-24
317509,JAKARTA TIMUR,CIRACAS,9857,139,9425,191,102,241,2021-05-24
317507,JAKARTA TIMUR,DUREN SAWIT,14868,164,14188,313,203,367,2021-05-24
317101,JAKARTA PUSAT,GAMBIR,3989,68,3786,68,67,135,2021-05-24
317302,JAKARTA BARAT,GROGOL PETAMBURAN,8646,127,8243,168,108,235,2021-05-24
317506,JAKARTA TIMUR,CAKUNG,12108,130,11650,212,116,246,2021-05-24
317409,JAKARTA SELATAN,JAGAKARSA,12260,123,11708,201,228,351,2021-05-24
317206,JAKARTA UTARA,KELAPA GADING,6220,89,5925,102,104,193,2021-05-24
317305,JAKARTA BARAT,KEBON JERUK,10937,165,10437,192,143,308,2021-05-24
317405,JAKARTA SELATAN,KEBAYORAN LAMA,9859,141,9385,187,146,287,2021-05-24
317407,JAKARTA SELATAN,KEBAYORAN BARU,6862,117,6547,102,96,213,2021-05-24
317103,JAKARTA PUSAT,KEMAYORAN,10315,159,9893,188,75,234,2021-05-24
317108,JAKARTA PUSAT,JOHAR BARU,4283,43,4105,107,28,71,2021-05-24
317503,JAKARTA TIMUR,JATINEGARA,9328,120,8917,184,107,227,2021-05-24
317306,JAKARTA BARAT,KALI DERES,8390,122,8040,150,78,200,2021-05-24
317203,JAKARTA UTARA,KOJA,8785,89,8488,165,43,132,2021-05-25
317408,JAKARTA SELATAN,PANCORAN,6726,104,6412,113,97,201,2021-05-25
317504,JAKARTA TIMUR,KRAMAT JATI,10487,89,10064,197,137,226,2021-05-25
317508,JAKARTA TIMUR,MAKASAR,8997,96,8680,154,67,163,2021-05-25
317403,JAKARTA SELATAN,MAMPANG PRAPATAN,5976,62,5747,105,62,124,2021-05-25
317501,JAKARTA TIMUR,MATRAMAN,6611,60,6335,145,71,131,2021-05-25
317106,JAKARTA PUSAT,MENTENG,3344,49,3206,68,21,70,2021-05-25
317205,JAKARTA UTARA,PADEMANGAN,5419,90,5116,86,127,217,2021-05-25
317307,JAKARTA BARAT,PALMERAH,8049,130,7647,176,96,226,2021-05-25
317404,JAKARTA SELATAN,PASAR MINGGU,11928,154,11388,223,163,317,2021-05-25
317502,JAKARTA TIMUR,PULO GADUNG,10420,177,9930,192,121,298,2021-05-25
317201,JAKARTA UTARA,PENJARINGAN,8515,155,8113,115,132,287,2021-05-25
317410,JAKARTA SELATAN,PESANGGRAHAN,7737,77,7375,132,153,230,2021-05-25
310101,KAB.ADM.KEP.SERIBU,KEP. SERIBU UTARA,330,5,320,4,1,6,2021-05-25
317102,JAKARTA PUSAT,SAWAH BESAR,4232,51,4052,83,46,97,2021-05-25
317104,JAKARTA PUSAT,SENEN,4622,66,4432,97,27,93,2021-05-25
317402,JAKARTA SELATAN,SETIA BUDI,5720,102,5443,98,77,179,2021-05-25
317303,JAKARTA BARAT,TAMAN SARI,4072,64,3910,67,31,95,2021-05-25
317304,JAKARTA BARAT,TAMBORA,6189,115,5837,134,103,218,2021-05-25
317107,JAKARTA PUSAT,TANAH ABANG,6029,83,5757,120,69,152,2021-05-25
317505,JAKARTA TIMUR,PASAR REBO,8461,63,8111,157,130,193,2021-05-25
310102,KAB.ADM.KEP.SERIBU,KEP. SERIBU SELATAN,244,0,241,3,0,0,2021-05-25
317401,JAKARTA SELATAN,TEBET,8253,101,7883,155,114,215,2021-05-25
317103,JAKARTA PUSAT,KEMAYORAN,10317,157,9895,189,76,233,2021-05-25
111111,Luar DKI & Proses Update,Luar DKI & Proses Update,143008,137,141294,1273,304,441,2021-05-25
317202,JAKARTA UTARA,TANJUNG PRIOK,12967,183,12419,234,131,314,2021-05-25
317506,JAKARTA TIMUR,CAKUNG,12120,130,11662,212,116,246,2021-05-25
317105,JAKARTA PUSAT,CEMPAKA PUTIH,5173,48,4980,87,58,106,2021-05-25
317301,JAKARTA BARAT,CENGKARENG,13766,216,13116,283,151,367,2021-05-25
317406,JAKARTA SELATAN,CILANDAK,8620,112,8186,138,184,296,2021-05-25
317204,JAKARTA UTARA,CILINCING,8181,108,7848,166,59,167,2021-05-25
317510,JAKARTA TIMUR,CIPAYUNG,10907,151,10413,128,215,366,2021-05-25
317509,JAKARTA TIMUR,CIRACAS,9871,134,9439,191,107,241,2021-05-25
317308,JAKARTA BARAT,KEMBANGAN,9469,112,9073,135,149,261,2021-05-25
317507,JAKARTA TIMUR,DUREN SAWIT,14878,156,14219,313,190,346,2021-05-25
317302,JAKARTA BARAT,GROGOL PETAMBURAN,8660,130,8246,168,116,246,2021-05-25
317409,JAKARTA SELATAN,JAGAKARSA,12268,123,11729,201,215,338,2021-05-25
317503,JAKARTA TIMUR,JATINEGARA,9331,116,8931,184,100,216,2021-05-25
317108,JAKARTA PUSAT,JOHAR BARU,4283,42,4106,107,28,70,2021-05-25
317306,JAKARTA BARAT,KALI DERES,8393,124,8043,151,75,199,2021-05-25
317407,JAKARTA SELATAN,KEBAYORAN BARU,6867,108,6566,102,91,199,2021-05-25
317405,JAKARTA SELATAN,KEBAYORAN LAMA,9865,135,9399,187,144,279,2021-05-25
317305,JAKARTA BARAT,KEBON JERUK,10946,159,10450,193,144,303,2021-05-25
317206,JAKARTA UTARA,KELAPA GADING,6223,84,5937,102,100,184,2021-05-25
317101,JAKARTA PUSAT,GAMBIR,3991,67,3788,68,68,135,2021-05-25
317506,JAKARTA TIMUR,CAKUNG,12135,135,11676,212,112,247,2021-05-26
317409,JAKARTA SELATAN,JAGAKARSA,12308,125,11744,201,238,363,2021-05-26
317105,JAKARTA PUSAT,CEMPAKA PUTIH,5187,59,4989,87,52,111,2021-05-26
317501,JAKARTA TIMUR,MATRAMAN,6614,65,6347,145,57,122,2021-05-26
317106,JAKARTA PUSAT,MENTENG,3350,49,3209,68,24,73,2021-05-26
317205,JAKARTA UTARA,PADEMANGAN,5428,93,5116,86,133,226,2021-05-26
317307,JAKARTA BARAT,PALMERAH,8069,138,7672,176,83,221,2021-05-26
317408,JAKARTA SELATAN,PANCORAN,6734,99,6423,114,98,197,2021-05-26
317404,JAKARTA SELATAN,PASAR MINGGU,11935,153,11412,223,147,300,2021-05-26
317505,JAKARTA TIMUR,PASAR REBO,8471,67,8116,159,129,196,2021-05-26
317201,JAKARTA UTARA,PENJARINGAN,8525,161,8113,115,136,297,2021-05-26
317403,JAKARTA SELATAN,MAMPANG PRAPATAN,5993,62,5759,105,67,129,2021-05-26
317502,JAKARTA TIMUR,PULO GADUNG,10441,190,9946,192,113,303,2021-05-26
317104,JAKARTA PUSAT,SENEN,4630,69,4435,97,29,98,2021-05-26
317402,JAKARTA SELATAN,SETIA BUDI,5726,103,5449,98,76,179,2021-05-26
317303,JAKARTA BARAT,TAMAN SARI,4076,65,3913,67,31,96,2021-05-26
317304,JAKARTA BARAT,TAMBORA,6194,108,5851,134,101,209,2021-05-26
317107,JAKARTA PUSAT,TANAH ABANG,6034,86,5767,120,61,147,2021-05-26
317202,JAKARTA UTARA,TANJUNG PRIOK,12984,184,12422,234,144,328,2021-05-26
317401,JAKARTA SELATAN,TEBET,8265,104,7897,155,109,213,2021-05-26
111111,Luar DKI & Proses Update,Luar DKI & Proses Update,143008,137,141294,1273,304,441,2021-05-26
317102,JAKARTA PUSAT,SAWAH BESAR,4236,49,4059,83,45,94,2021-05-26
317508,JAKARTA TIMUR,MAKASAR,9013,110,8682,156,65,175,2021-05-26
317410,JAKARTA SELATAN,PESANGGRAHAN,7748,78,7398,132,140,218,2021-05-26
317203,JAKARTA UTARA,KOJA,8790,94,8488,165,43,137,2021-05-26
317504,JAKARTA TIMUR,KRAMAT JATI,10508,104,10075,197,132,236,2021-05-26
317406,JAKARTA SELATAN,CILANDAK,8650,119,8199,138,194,313,2021-05-26
317204,JAKARTA UTARA,CILINCING,8184,109,7848,166,61,170,2021-05-26
317510,JAKARTA TIMUR,CIPAYUNG,10916,152,10432,129,203,355,2021-05-26
317509,JAKARTA TIMUR,CIRACAS,9881,140,9460,192,89,229,2021-05-26
317101,JAKARTA PUSAT,GAMBIR,4001,71,3803,68,59,130,2021-05-26
317302,JAKARTA BARAT,GROGOL PETAMBURAN,8675,136,8253,168,118,254,2021-05-26
317503,JAKARTA TIMUR,JATINEGARA,9338,125,8938,184,91,216,2021-05-26
317108,JAKARTA PUSAT,JOHAR BARU,4285,37,4116,107,25,62,2021-05-26
317507,JAKARTA TIMUR,DUREN SAWIT,14896,159,14235,314,188,347,2021-05-26
317306,JAKARTA BARAT,KALI DERES,8402,119,8061,151,71,190,2021-05-26
310101,KAB.ADM.KEP.SERIBU,KEP. SERIBU UTARA,330,5,320,4,1,6,2021-05-26
310102,KAB.ADM.KEP.SERIBU,KEP. SERIBU SELATAN,244,0,241,3,0,0,2021-05-26
317308,JAKARTA BARAT,KEMBANGAN,9494,110,9091,135,158,268,2021-05-26
317103,JAKARTA PUSAT,KEMAYORAN,10333,168,9913,190,62,230,2021-05-26
317301,JAKARTA BARAT,CENGKARENG,13779,222,13124,283,150,372,2021-05-26
317305,JAKARTA BARAT,KEBON JERUK,10977,168,10465,194,150,318,2021-05-26
317405,JAKARTA SELATAN,KEBAYORAN LAMA,9884,132,9413,188,151,283,2021-05-26
317407,JAKARTA SELATAN,KEBAYORAN BARU,6877,98,6584,102,93,191,2021-05-26
317206,JAKARTA UTARA,KELAPA GADING,6227,85,5937,102,103,188,2021-05-26
317203,JAKARTA UTARA,KOJA,8796,96,8496,166,38,134,2021-05-27
317404,JAKARTA SELATAN,PASAR MINGGU,11951,151,11424,224,152,303,2021-05-27
317307,JAKARTA BARAT,PALMERAH,8085,141,7684,176,84,225,2021-05-27
317205,JAKARTA UTARA,PADEMANGAN,5455,89,5128,86,152,241,2021-05-27
317106,JAKARTA PUSAT,MENTENG,3356,47,3219,68,22,69,2021-05-27
317501,JAKARTA TIMUR,MATRAMAN,6630,61,6357,145,67,128,2021-05-27
317403,JAKARTA SELATAN,MAMPANG PRAPATAN,6000,60,5763,105,72,132,2021-05-27
317508,JAKARTA TIMUR,MAKASAR,9053,118,8689,159,87,205,2021-05-27
317504,JAKARTA TIMUR,KRAMAT JATI,10542,108,10081,197,156,264,2021-05-27
317408,JAKARTA SELATAN,PANCORAN,6743,96,6427,115,105,201,2021-05-27
317306,JAKARTA BARAT,KALI DERES,8419,124,8072,151,72,196,2021-05-27
310102,KAB.ADM.KEP.SERIBU,KEP. SERIBU SELATAN,244,0,241,3,0,0,2021-05-27
317308,JAKARTA BARAT,KEMBANGAN,9509,115,9103,135,156,271,2021-05-27
317103,JAKARTA PUSAT,KEMAYORAN,10351,172,9935,192,52,224,2021-05-27
317206,JAKARTA UTARA,KELAPA GADING,6237,81,5959,102,95,176,2021-05-27
317305,JAKARTA BARAT,KEBON JERUK,11012,164,10482,197,169,333,2021-05-27
317405,JAKARTA SELATAN,KEBAYORAN LAMA,9904,135,9421,190,158,293,2021-05-27
317407,JAKARTA SELATAN,KEBAYORAN BARU,6894,98,6600,102,94,192,2021-05-27
317108,JAKARTA PUSAT,JOHAR BARU,4298,36,4120,107,35,71,2021-05-27
317505,JAKARTA TIMUR,PASAR REBO,8501,72,8124,159,146,218,2021-05-27
310101,KAB.ADM.KEP.SERIBU,KEP. SERIBU UTARA,331,5,320,4,2,7,2021-05-27
317201,JAKARTA UTARA,PENJARINGAN,8565,164,8144,116,141,305,2021-05-27
317301,JAKARTA BARAT,CENGKARENG,13825,221,13142,285,177,398,2021-05-27
317502,JAKARTA TIMUR,PULO GADUNG,10470,192,9958,193,127,319,2021-05-27
317506,JAKARTA TIMUR,CAKUNG,12176,142,11679,212,143,285,2021-05-27
317105,JAKARTA PUSAT,CEMPAKA PUTIH,5191,60,5001,87,43,103,2021-05-27
317409,JAKARTA SELATAN,JAGAKARSA,12341,130,11766,201,244,374,2021-05-27
317406,JAKARTA SELATAN,CILANDAK,8669,113,8223,138,195,308,2021-05-27
317204,JAKARTA UTARA,CILINCING,8200,109,7858,167,66,175,2021-05-27
317510,JAKARTA TIMUR,CIPAYUNG,10950,206,10433,129,182,388,2021-05-27
317509,JAKARTA TIMUR,CIRACAS,9910,146,9461,192,111,257,2021-05-27
317507,JAKARTA TIMUR,DUREN SAWIT,14923,164,14238,314,207,371,2021-05-27
317101,JAKARTA PUSAT,GAMBIR,4007,70,3810,68,59,129,2021-05-27
317410,JAKARTA SELATAN,PESANGGRAHAN,7765,79,7400,132,154,233,2021-05-27
317302,JAKARTA BARAT,GROGOL PETAMBURAN,8693,141,8264,169,119,260,2021-05-27
317401,JAKARTA SELATAN,TEBET,8278,111,7898,155,114,225,2021-05-27
317202,JAKARTA UTARA,TANJUNG PRIOK,12998,179,12447,234,138,317,2021-05-27
317107,JAKARTA PUSAT,TANAH ABANG,6058,87,5777,120,74,161,2021-05-27
317304,JAKARTA BARAT,TAMBORA,6210,102,5865,134,109,211,2021-05-27
317303,JAKARTA BARAT,TAMAN SARI,4082,63,3923,67,29,92,2021-05-27
317402,JAKARTA SELATAN,SETIA BUDI,5741,108,5453,98,82,190,2021-05-27
317104,JAKARTA PUSAT,SENEN,4635,60,4446,97,32,92,2021-05-27
317102,JAKARTA PUSAT,SAWAH BESAR,4253,51,4068,83,51,102,2021-05-27
111111,Luar DKI & Proses Update,Luar DKI & Proses Update,143008,137,141294,1273,304,441,2021-05-27
317503,JAKARTA TIMUR,JATINEGARA,9348,122,8944,184,98,220,2021-05-27
111111,Luar DKI & Proses Update,Luar DKI & Proses Update,143008,137,141294,1273,304,441,2021-05-28
317105,JAKARTA PUSAT,CEMPAKA PUTIH,5195,57,5009,87,42,99,2021-05-28
317108,JAKARTA PUSAT,JOHAR BARU,4304,38,4123,107,36,74,2021-05-28
317106,JAKARTA PUSAT,MENTENG,3361,46,3223,69,23,69,2021-05-28
317205,JAKARTA UTARA,PADEMANGAN,5460,87,5150,86,137,224,2021-05-28
317307,JAKARTA BARAT,PALMERAH,8089,140,7690,176,83,223,2021-05-28
317408,JAKARTA SELATAN,PANCORAN,6755,99,6434,115,107,206,2021-05-28
317404,JAKARTA SELATAN,PASAR MINGGU,11971,147,11458,224,142,289,2021-05-28
317505,JAKARTA TIMUR,PASAR REBO,8522,75,8151,160,136,211,2021-05-28
317201,JAKARTA UTARA,PENJARINGAN,8573,154,8174,116,129,283,2021-05-28
317410,JAKARTA SELATAN,PESANGGRAHAN,7782,80,7426,132,144,224,2021-05-28
317501,JAKARTA TIMUR,MATRAMAN,6638,53,6371,145,69,122,2021-05-28
317502,JAKARTA TIMUR,PULO GADUNG,10483,181,9983,193,126,307,2021-05-28
317104,JAKARTA PUSAT,SENEN,4642,60,4452,97,33,93,2021-05-28
317303,JAKARTA BARAT,TAMAN SARI,4094,61,3930,67,36,97,2021-05-28
317304,JAKARTA BARAT,TAMBORA,6223,98,5879,134,112,210,2021-05-28
317107,JAKARTA PUSAT,TANAH ABANG,6066,90,5782,120,74,164,2021-05-28
317202,JAKARTA UTARA,TANJUNG PRIOK,13016,162,12489,234,131,293,2021-05-28
317401,JAKARTA SELATAN,TEBET,8289,112,7927,155,95,207,2021-05-28
317306,JAKARTA BARAT,KALI DERES,8436,119,8091,152,74,193,2021-05-28
317503,JAKARTA TIMUR,JATINEGARA,9368,120,8961,186,101,221,2021-05-28
317102,JAKARTA PUSAT,SAWAH BESAR,4259,51,4071,83,54,105,2021-05-28
317403,JAKARTA SELATAN,MAMPANG PRAPATAN,6004,56,5786,105,57,113,2021-05-28
317402,JAKARTA SELATAN,SETIA BUDI,5753,106,5471,98,78,184,2021-05-28
317504,JAKARTA TIMUR,KRAMAT JATI,10557,105,10107,197,148,253,2021-05-28
317508,JAKARTA TIMUR,MAKASAR,9074,116,8704,159,95,211,2021-05-28
317405,JAKARTA SELATAN,KEBAYORAN LAMA,9929,136,9448,191,154,290,2021-05-28
317506,JAKARTA TIMUR,CAKUNG,12202,162,11705,213,122,284,2021-05-28
317301,JAKARTA BARAT,CENGKARENG,13867,211,13169,285,202,413,2021-05-28
317204,JAKARTA UTARA,CILINCING,8206,94,7875,168,69,163,2021-05-28
317510,JAKARTA TIMUR,CIPAYUNG,10976,203,10462,132,179,382,2021-05-28
317407,JAKARTA SELATAN,KEBAYORAN BARU,6910,96,6615,103,96,192,2021-05-28
317509,JAKARTA TIMUR,CIRACAS,9945,156,9484,194,111,267,2021-05-28
317507,JAKARTA TIMUR,DUREN SAWIT,14952,163,14283,314,192,355,2021-05-28
317406,JAKARTA SELATAN,CILANDAK,8683,119,8228,139,197,316,2021-05-28
317302,JAKARTA BARAT,GROGOL PETAMBURAN,8711,137,8289,169,116,253,2021-05-28
317409,JAKARTA SELATAN,JAGAKARSA,12347,128,11780,203,236,364,2021-05-28
317305,JAKARTA BARAT,KEBON JERUK,11025,161,10498,197,169,330,2021-05-28
317206,JAKARTA UTARA,KELAPA GADING,6238,69,5982,102,85,154,2021-05-28
317103,JAKARTA PUSAT,KEMAYORAN,10371,172,9950,192,57,229,2021-05-28
317308,JAKARTA BARAT,KEMBANGAN,9516,110,9120,135,151,261,2021-05-28
310102,KAB.ADM.KEP.SERIBU,KEP. SERIBU SELATAN,244,0,241,3,0,0,2021-05-28
310101,KAB.ADM.KEP.SERIBU,KEP. SERIBU UTARA,332,5,320,4,3,8,2021-05-28
317101,JAKARTA PUSAT,GAMBIR,4014,69,3812,68,65,134,2021-05-28
317203,JAKARTA UTARA,KOJA,8800,81,8514,166,39,120,2021-05-28
317305,JAKARTA BARAT,KEBON JERUK,11058,161,10530,197,170,331,2021-05-29
317206,JAKARTA UTARA,KELAPA GADING,6255,73,5998,102,82,155,2021-05-29
317103,JAKARTA PUSAT,KEMAYORAN,10381,159,9975,193,54,213,2021-05-29
317308,JAKARTA BARAT,KEMBANGAN,9551,109,9151,135,156,265,2021-05-29
310102,KAB.ADM.KEP.SERIBU,KEP. SERIBU SELATAN,244,0,241,3,0,0,2021-05-29
317508,JAKARTA TIMUR,MAKASAR,9091,120,8727,160,84,204,2021-05-29
317203,JAKARTA UTARA,KOJA,8810,82,8531,166,31,113,2021-05-29
317504,JAKARTA TIMUR,KRAMAT JATI,10569,103,10128,197,141,244,2021-05-29
317403,JAKARTA SELATAN,MAMPANG PRAPATAN,6007,53,5796,105,53,106,2021-05-29
317405,JAKARTA SELATAN,KEBAYORAN LAMA,9955,134,9479,192,150,284,2021-05-29
310101,KAB.ADM.KEP.SERIBU,KEP. SERIBU UTARA,332,5,320,4,3,8,2021-05-29
317407,JAKARTA SELATAN,KEBAYORAN BARU,6932,98,6635,103,96,194,2021-05-29
317510,JAKARTA TIMUR,CIPAYUNG,10984,200,10491,132,161,361,2021-05-29
317108,JAKARTA PUSAT,JOHAR BARU,4312,42,4130,107,33,75,2021-05-29
317503,JAKARTA TIMUR,JATINEGARA,9379,111,8982,186,100,211,2021-05-29
317409,JAKARTA SELATAN,JAGAKARSA,12353,114,11814,203,222,336,2021-05-29
317302,JAKARTA BARAT,GROGOL PETAMBURAN,8726,131,8311,169,115,246,2021-05-29
317101,JAKARTA PUSAT,GAMBIR,4018,63,3823,68,64,127,2021-05-29
317507,JAKARTA TIMUR,DUREN SAWIT,14973,162,14324,314,173,335,2021-05-29
317509,JAKARTA TIMUR,CIRACAS,9960,158,9502,194,106,264,2021-05-29
317204,JAKARTA UTARA,CILINCING,8225,97,7892,168,68,165,2021-05-29
317406,JAKARTA SELATAN,CILANDAK,8710,129,8251,139,191,320,2021-05-29
317301,JAKARTA BARAT,CENGKARENG,13893,211,13204,286,192,403,2021-05-29
317105,JAKARTA PUSAT,CEMPAKA PUTIH,5205,62,5014,87,42,104,2021-05-29
317506,JAKARTA TIMUR,CAKUNG,12227,160,11730,213,124,284,2021-05-29
317106,JAKARTA PUSAT,MENTENG,3369,46,3227,69,27,73,2021-05-29
317306,JAKARTA BARAT,KALI DERES,8451,115,8111,152,73,188,2021-05-29
317205,JAKARTA UTARA,PADEMANGAN,5489,90,5182,86,131,221,2021-05-29
317501,JAKARTA TIMUR,MATRAMAN,6630,43,6388,145,54,97,2021-05-29
317408,JAKARTA SELATAN,PANCORAN,6767,96,6453,115,103,199,2021-05-29
111111,Luar DKI & Proses Update,Luar DKI & Proses Update,143008,137,141294,1273,304,441,2021-05-29
317307,JAKARTA BARAT,PALMERAH,8116,141,7708,176,91,232,2021-05-29
317401,JAKARTA SELATAN,TEBET,8304,112,7941,155,96,208,2021-05-29
317202,JAKARTA UTARA,TANJUNG PRIOK,13031,159,12516,234,122,281,2021-05-29
317107,JAKARTA PUSAT,TANAH ABANG,6095,97,5802,120,76,173,2021-05-29
317304,JAKARTA BARAT,TAMBORA,6236,98,5894,134,110,208,2021-05-29
317303,JAKARTA BARAT,TAMAN SARI,4106,55,3944,67,40,95,2021-05-29
317410,JAKARTA SELATAN,PESANGGRAHAN,7799,81,7445,132,141,222,2021-05-29
317104,JAKARTA PUSAT,SENEN,4649,61,4456,97,35,96,2021-05-29
317102,JAKARTA PUSAT,SAWAH BESAR,4269,49,4076,83,61,110,2021-05-29
317502,JAKARTA TIMUR,PULO GADUNG,10511,175,10007,197,132,307,2021-05-29
317201,JAKARTA UTARA,PENJARINGAN,8602,160,8203,116,123,283,2021-05-29
317402,JAKARTA SELATAN,SETIA BUDI,5766,98,5494,98,76,174,2021-05-29
317404,JAKARTA SELATAN,PASAR MINGGU,11991,143,11486,224,138,281,2021-05-29
317505,JAKARTA TIMUR,PASAR REBO,8529,74,8168,160,127,201,2021-05-29
317501,JAKARTA TIMUR,MATRAMAN,6642,45,6398,145,54,99,2021-05-30
317106,JAKARTA PUSAT,MENTENG,3378,42,3234,69,33,75,2021-05-30
317205,JAKARTA UTARA,PADEMANGAN,5527,88,5210,87,142,230,2021-05-30
317307,JAKARTA BARAT,PALMERAH,8153,145,7721,176,111,256,2021-05-30
317408,JAKARTA SELATAN,PANCORAN,6784,94,6475,116,99,193,2021-05-30
317404,JAKARTA SELATAN,PASAR MINGGU,12011,153,11502,224,132,285,2021-05-30
317505,JAKARTA TIMUR,PASAR REBO,8561,74,8180,160,147,221,2021-05-30
317201,JAKARTA UTARA,PENJARINGAN,8623,165,8223,116,119,284,2021-05-30
317102,JAKARTA PUSAT,SAWAH BESAR,4274,49,4084,83,58,107,2021-05-30
317502,JAKARTA TIMUR,PULO GADUNG,10531,163,10033,198,137,300,2021-05-30
317403,JAKARTA SELATAN,MAMPANG PRAPATAN,6015,49,5806,105,55,104,2021-05-30
317104,JAKARTA PUSAT,SENEN,4652,53,4469,97,33,86,2021-05-30
317402,JAKARTA SELATAN,SETIA BUDI,5790,100,5509,98,83,183,2021-05-30
317303,JAKARTA BARAT,TAMAN SARI,4111,55,3950,67,39,94,2021-05-30
317304,JAKARTA BARAT,TAMBORA,6247,92,5927,134,94,186,2021-05-30
317107,JAKARTA PUSAT,TANAH ABANG,6108,86,5825,121,76,162,2021-05-30
317202,JAKARTA UTARA,TANJUNG PRIOK,13067,147,12560,235,125,272,2021-05-30
317401,JAKARTA SELATAN,TEBET,8318,108,7968,155,87,195,2021-05-30
111111,Luar DKI & Proses Update,Luar DKI & Proses Update,143008,137,141294,1273,304,441,2021-05-30
317410,JAKARTA SELATAN,PESANGGRAHAN,7831,77,7474,133,147,224,2021-05-30
317508,JAKARTA TIMUR,MAKASAR,9118,128,8740,161,89,217,2021-05-30
310101,KAB.ADM.KEP.SERIBU,KEP. SERIBU UTARA,333,5,320,4,4,9,2021-05-30
317203,JAKARTA UTARA,KOJA,8819,82,8540,166,31,113,2021-05-30
317506,JAKARTA TIMUR,CAKUNG,12244,157,11753,214,120,277,2021-05-30
317105,JAKARTA PUSAT,CEMPAKA PUTIH,5213,56,5029,87,41,97,2021-05-30
317301,JAKARTA BARAT,CENGKARENG,13942,209,13245,286,202,411,2021-05-30
317406,JAKARTA SELATAN,CILANDAK,8742,128,8286,139,189,317,2021-05-30
317204,JAKARTA UTARA,CILINCING,8234,96,7902,169,67,163,2021-05-30
317510,JAKARTA TIMUR,CIPAYUNG,11026,195,10510,134,187,382,2021-05-30
317509,JAKARTA TIMUR,CIRACAS,9983,165,9528,194,96,261,2021-05-30
317507,JAKARTA TIMUR,DUREN SAWIT,15017,174,14342,315,186,360,2021-05-30
317101,JAKARTA PUSAT,GAMBIR,4029,61,3826,68,74,135,2021-05-30
317504,JAKARTA TIMUR,KRAMAT JATI,10589,113,10142,197,137,250,2021-05-30
317302,JAKARTA BARAT,GROGOL PETAMBURAN,8747,134,8327,169,117,251,2021-05-30
317503,JAKARTA TIMUR,JATINEGARA,9403,100,9011,186,106,206,2021-05-30
317108,JAKARTA PUSAT,JOHAR BARU,4320,43,4136,108,33,76,2021-05-30
317306,JAKARTA BARAT,KALI DERES,8475,120,8133,152,70,190,2021-05-30
317407,JAKARTA SELATAN,KEBAYORAN BARU,6961,95,6673,103,90,185,2021-05-30
317405,JAKARTA SELATAN,KEBAYORAN LAMA,9988,127,9510,192,159,286,2021-05-30
317305,JAKARTA BARAT,KEBON JERUK,11080,161,10552,197,170,331,2021-05-30
317103,JAKARTA PUSAT,KEMAYORAN,10401,156,9999,193,53,209,2021-05-30
317308,JAKARTA BARAT,KEMBANGAN,9571,105,9179,135,152,257,2021-05-30
310102,KAB.ADM.KEP.SERIBU,KEP. SERIBU SELATAN,244,0,241,3,0,0,2021-05-30
317409,JAKARTA SELATAN,JAGAKARSA,12394,113,11868,203,210,323,2021-05-30
317206,JAKARTA UTARA,KELAPA GADING,6280,77,6009,102,92,169,2021-05-30
317405,JAKARTA SELATAN,KEBAYORAN LAMA,10015,122,9538,193,162,284,2021-05-31
111111,Luar DKI & Proses Update,Luar DKI & Proses Update,143008,137,141294,1273,304,441,2021-05-31
317506,JAKARTA TIMUR,CAKUNG,12269,155,11767,214,133,288,2021-05-31
317105,JAKARTA PUSAT,CEMPAKA PUTIH,5218,58,5033,87,40,98,2021-05-31
317301,JAKARTA BARAT,CENGKARENG,13962,216,13262,286,198,414,2021-05-31
317406,JAKARTA SELATAN,CILANDAK,8760,125,8309,139,187,312,2021-05-31
317204,JAKARTA UTARA,CILINCING,8237,95,7907,171,64,159,2021-05-31
317510,JAKARTA TIMUR,CIPAYUNG,11054,200,10521,135,198,398,2021-05-31
317509,JAKARTA TIMUR,CIRACAS,10006,159,9544,197,106,265,2021-05-31
317507,JAKARTA TIMUR,DUREN SAWIT,15034,169,14354,315,196,365,2021-05-31
317101,JAKARTA PUSAT,GAMBIR,4039,62,3835,69,73,135,2021-05-31
317302,JAKARTA BARAT,GROGOL PETAMBURAN,8772,140,8351,169,112,252,2021-05-31
317409,JAKARTA SELATAN,JAGAKARSA,12414,107,11894,205,208,315,2021-05-31
317503,JAKARTA TIMUR,JATINEGARA,9428,98,9026,187,117,215,2021-05-31
317407,JAKARTA SELATAN,KEBAYORAN BARU,6975,97,6681,103,94,191,2021-05-31
317108,JAKARTA PUSAT,JOHAR BARU,4344,42,4139,108,55,97,2021-05-31
317306,JAKARTA BARAT,KALI DERES,8499,117,8145,152,85,202,2021-05-31
317203,JAKARTA UTARA,KOJA,8822,81,8545,166,30,111,2021-05-31
317202,JAKARTA UTARA,TANJUNG PRIOK,13092,154,12578,235,125,279,2021-05-31
317107,JAKARTA PUSAT,TANAH ABANG,6115,83,5838,121,73,156,2021-05-31
317304,JAKARTA BARAT,TAMBORA,6257,91,5938,134,94,185,2021-05-31
317303,JAKARTA BARAT,TAMAN SARI,4115,55,3954,67,39,94,2021-05-31
317402,JAKARTA SELATAN,SETIA BUDI,5803,94,5526,98,85,179,2021-05-31
317104,JAKARTA PUSAT,SENEN,4657,53,4471,97,36,89,2021-05-31
317102,JAKARTA PUSAT,SAWAH BESAR,4280,53,4085,83,59,112,2021-05-31
317502,JAKARTA TIMUR,PULO GADUNG,10539,162,10044,198,135,297,2021-05-31
317410,JAKARTA SELATAN,PESANGGRAHAN,7838,77,7483,133,145,222,2021-05-31
317201,JAKARTA UTARA,PENJARINGAN,8635,167,8237,117,114,281,2021-05-31
317505,JAKARTA TIMUR,PASAR REBO,8572,73,8186,160,153,226,2021-05-31
317401,JAKARTA SELATAN,TEBET,8326,104,7975,155,92,196,2021-05-31
317404,JAKARTA SELATAN,PASAR MINGGU,12039,146,11522,225,146,292,2021-05-31
317307,JAKARTA BARAT,PALMERAH,8174,145,7734,176,119,264,2021-05-31
317205,JAKARTA UTARA,PADEMANGAN,5542,87,5226,89,140,227,2021-05-31
317106,JAKARTA PUSAT,MENTENG,3383,40,3238,69,36,76,2021-05-31
317501,JAKARTA TIMUR,MATRAMAN,6643,43,6400,148,52,95,2021-05-31
317305,JAKARTA BARAT,KEBON JERUK,11093,157,10569,197,170,327,2021-05-31
317206,JAKARTA UTARA,KELAPA GADING,6284,77,6027,102,78,155,2021-05-31
317103,JAKARTA PUSAT,KEMAYORAN,10416,154,10013,193,56,210,2021-05-31
317308,JAKARTA BARAT,KEMBANGAN,9580,102,9195,135,148,250,2021-05-31
310102,KAB.ADM.KEP.SERIBU,KEP. SERIBU SELATAN,244,0,241,3,0,0,2021-05-31
310101,KAB.ADM.KEP.SERIBU,KEP. SERIBU UTARA,333,5,320,4,4,9,2021-05-31
317403,JAKARTA SELATAN,MAMPANG PRAPATAN,6027,48,5814,105,60,108,2021-05-31
317408,JAKARTA SELATAN,PANCORAN,6800,88,6494,116,102,190,2021-05-31
317504,JAKARTA TIMUR,KRAMAT JATI,10604,110,10156,197,141,251,2021-05-31
317508,JAKARTA TIMUR,MAKASAR,9125,128,8747,161,89,217,2021-05-31
317410,JAKARTA SELATAN,PESANGGRAHAN,7845,75,7507,133,130,205,2021-06-01
317504,JAKARTA TIMUR,KRAMAT JATI,10612,112,10162,199,139,251,2021-06-01
317508,JAKARTA TIMUR,MAKASAR,9132,128,8757,161,86,214,2021-06-01
317403,JAKARTA SELATAN,MAMPANG PRAPATAN,6035,45,5821,105,64,109,2021-06-01
317501,JAKARTA TIMUR,MATRAMAN,6655,45,6404,148,58,103,2021-06-01
317106,JAKARTA PUSAT,MENTENG,3386,43,3241,69,33,76,2021-06-01
317205,JAKARTA UTARA,PADEMANGAN,5599,84,5257,89,169,253,2021-06-01
317307,JAKARTA BARAT,PALMERAH,8179,144,7744,177,114,258,2021-06-01
317408,JAKARTA SELATAN,PANCORAN,6809,92,6504,117,96,188,2021-06-01
317404,JAKARTA SELATAN,PASAR MINGGU,12051,149,11546,227,129,278,2021-06-01
317203,JAKARTA UTARA,KOJA,8830,79,8551,168,32,111,2021-06-01
317505,JAKARTA TIMUR,PASAR REBO,8582,79,8193,160,150,229,2021-06-01
317502,JAKARTA TIMUR,PULO GADUNG,10556,160,10063,199,134,294,2021-06-01
317102,JAKARTA PUSAT,SAWAH BESAR,4284,52,4091,83,58,110,2021-06-01
317104,JAKARTA PUSAT,SENEN,4663,49,4480,97,37,86,2021-06-01
317402,JAKARTA SELATAN,SETIA BUDI,5807,94,5530,98,85,179,2021-06-01
317303,JAKARTA BARAT,TAMAN SARI,4116,46,3967,67,36,82,2021-06-01
317304,JAKARTA BARAT,TAMBORA,6269,87,5945,134,103,190,2021-06-01
317107,JAKARTA PUSAT,TANAH ABANG,6125,77,5848,123,77,154,2021-06-01
317202,JAKARTA UTARA,TANJUNG PRIOK,13109,150,12594,238,127,277,2021-06-01
317401,JAKARTA SELATAN,TEBET,8337,105,7982,155,95,200,2021-06-01
317201,JAKARTA UTARA,PENJARINGAN,8652,164,8255,117,116,280,2021-06-01
310102,KAB.ADM.KEP.SERIBU,KEP. SERIBU SELATAN,244,0,241,3,0,0,2021-06-01
310101,KAB.ADM.KEP.SERIBU,KEP. SERIBU UTARA,333,5,320,4,4,9,2021-06-01
317507,JAKARTA TIMUR,DUREN SAWIT,15046,180,14361,315,190,370,2021-06-01
317506,JAKARTA TIMUR,CAKUNG,12279,162,11777,214,126,288,2021-06-01
317105,JAKARTA PUSAT,CEMPAKA PUTIH,5221,54,5044,87,36,90,2021-06-01
317301,JAKARTA BARAT,CENGKARENG,13969,212,13275,286,196,408,2021-06-01
317406,JAKARTA SELATAN,CILANDAK,8762,122,8337,140,163,285,2021-06-01
317204,JAKARTA UTARA,CILINCING,8276,100,7913,171,92,192,2021-06-01
317510,JAKARTA TIMUR,CIPAYUNG,11074,206,10535,135,198,404,2021-06-01
317509,JAKARTA TIMUR,CIRACAS,10012,157,9556,198,101,258,2021-06-01
317308,JAKARTA BARAT,KEMBANGAN,9591,102,9211,135,143,245,2021-06-01
317101,JAKARTA PUSAT,GAMBIR,4048,62,3842,69,75,137,2021-06-01
317302,JAKARTA BARAT,GROGOL PETAMBURAN,8790,144,8358,170,118,262,2021-06-01
317409,JAKARTA SELATAN,JAGAKARSA,12422,111,11907,206,198,309,2021-06-01
317503,JAKARTA TIMUR,JATINEGARA,9432,105,9032,187,108,213,2021-06-01
317108,JAKARTA PUSAT,JOHAR BARU,4347,43,4140,108,56,99,2021-06-01
317306,JAKARTA BARAT,KALI DERES,8505,119,8147,153,86,205,2021-06-01
317407,JAKARTA SELATAN,KEBAYORAN BARU,6979,94,6695,104,86,180,2021-06-01
317405,JAKARTA SELATAN,KEBAYORAN LAMA,10022,122,9554,194,152,274,2021-06-01
317305,JAKARTA BARAT,KEBON JERUK,11114,154,10585,197,178,332,2021-06-01
317206,JAKARTA UTARA,KELAPA GADING,6295,83,6030,102,80,163,2021-06-01
317103,JAKARTA PUSAT,KEMAYORAN,10419,154,10019,193,53,207,2021-06-01
111111,Luar DKI & Proses Update,Luar DKI & Proses Update,143008,137,141294,1273,304,441,2021-06-01
317506,JAKARTA TIMUR,CAKUNG,12300,166,11785,214,135,301,2021-06-02
317105,JAKARTA PUSAT,CEMPAKA PUTIH,5232,58,5054,87,33,91,2021-06-02
111111,Luar DKI & Proses Update,Luar DKI & Proses Update,143008,137,141294,1273,304,441,2021-06-02
317301,JAKARTA BARAT,CENGKARENG,13996,214,13299,286,197,411,2021-06-02
317204,JAKARTA UTARA,CILINCING,8278,93,7935,171,79,172,2021-06-02
317402,JAKARTA SELATAN,SETIA BUDI,5832,116,5533,98,85,201,2021-06-02
317501,JAKARTA TIMUR,MATRAMAN,6656,44,6407,148,57,101,2021-06-02
317106,JAKARTA PUSAT,MENTENG,3387,42,3244,69,32,74,2021-06-02
317205,JAKARTA UTARA,PADEMANGAN,5612,82,5273,89,168,250,2021-06-02
317307,JAKARTA BARAT,PALMERAH,8198,140,7752,177,129,269,2021-06-02
317404,JAKARTA SELATAN,PASAR MINGGU,12065,146,11557,227,135,281,2021-06-02
317505,JAKARTA TIMUR,PASAR REBO,8582,77,8214,160,131,208,2021-06-02
317201,JAKARTA UTARA,PENJARINGAN,8667,169,8273,117,108,277,2021-06-02
317410,JAKARTA SELATAN,PESANGGRAHAN,7859,72,7522,133,132,204,2021-06-02
317502,JAKARTA TIMUR,PULO GADUNG,10565,160,10080,199,126,286,2021-06-02
317102,JAKARTA PUSAT,SAWAH BESAR,4291,55,4092,83,61,116,2021-06-02
317104,JAKARTA PUSAT,SENEN,4674,52,4485,97,40,92,2021-06-02
317406,JAKARTA SELATAN,CILANDAK,8780,125,8355,140,160,285,2021-06-02
317303,JAKARTA BARAT,TAMAN SARI,4124,51,3970,67,36,87,2021-06-02
317304,JAKARTA BARAT,TAMBORA,6281,93,5949,134,105,198,2021-06-02
317107,JAKARTA PUSAT,TANAH ABANG,6129,78,5854,123,74,152,2021-06-02
317202,JAKARTA UTARA,TANJUNG PRIOK,13122,147,12607,238,130,277,2021-06-02
317401,JAKARTA SELATAN,TEBET,8341,105,7987,156,93,198,2021-06-02
317403,JAKARTA SELATAN,MAMPANG PRAPATAN,6044,43,5830,106,65,108,2021-06-02
317508,JAKARTA TIMUR,MAKASAR,9138,123,8768,162,85,208,2021-06-02
317408,JAKARTA SELATAN,PANCORAN,6815,91,6510,117,97,188,2021-06-02
317203,JAKARTA UTARA,KOJA,8834,73,8563,170,28,101,2021-06-02
317510,JAKARTA TIMUR,CIPAYUNG,11084,202,10566,135,181,383,2021-06-02
317509,JAKARTA TIMUR,CIRACAS,10018,156,9567,199,96,252,2021-06-02
317507,JAKARTA TIMUR,DUREN SAWIT,15071,189,14374,315,193,382,2021-06-02
317504,JAKARTA TIMUR,KRAMAT JATI,10621,107,10187,199,128,235,2021-06-02
317302,JAKARTA BARAT,GROGOL PETAMBURAN,8797,141,8372,170,114,255,2021-06-02
317409,JAKARTA SELATAN,JAGAKARSA,12434,112,11917,206,199,311,2021-06-02
317503,JAKARTA TIMUR,JATINEGARA,9441,104,9043,187,107,211,2021-06-02
317108,JAKARTA PUSAT,JOHAR BARU,4352,46,4141,108,57,103,2021-06-02
317306,JAKARTA BARAT,KALI DERES,8513,119,8154,154,86,205,2021-06-02
317407,JAKARTA SELATAN,KEBAYORAN BARU,7003,99,6709,105,90,189,2021-06-02
317101,JAKARTA PUSAT,GAMBIR,4052,61,3847,70,74,135,2021-06-02
317405,JAKARTA SELATAN,KEBAYORAN LAMA,10056,129,9583,194,150,279,2021-06-02
317305,JAKARTA BARAT,KEBON JERUK,11142,149,10610,197,186,335,2021-06-02
317206,JAKARTA UTARA,KELAPA GADING,6301,76,6047,103,75,151,2021-06-02
317103,JAKARTA PUSAT,KEMAYORAN,10445,168,10029,193,55,223,2021-06-02
317308,JAKARTA BARAT,KEMBANGAN,9605,101,9223,135,146,247,2021-06-02
310102,KAB.ADM.KEP.SERIBU,KEP. SERIBU SELATAN,244,0,241,3,0,0,2021-06-02
310101,KAB.ADM.KEP.SERIBU,KEP. SERIBU UTARA,333,5,320,4,4,9,2021-06-02
111111,Luar DKI & Proses Update,Luar DKI & Proses Update,143008,137,141294,1273,304,441,2021-06-03
310102,KAB.ADM.KEP.SERIBU,KEP. SERIBU SELATAN,244,0,241,3,0,0,2021-06-03
310101,KAB.ADM.KEP.SERIBU,KEP. SERIBU UTARA,333,0,325,4,4,4,2021-06-03
317203,JAKARTA UTARA,KOJA,8841,76,8565,171,29,105,2021-06-03
317504,JAKARTA TIMUR,KRAMAT JATI,10640,113,10198,199,130,243,2021-06-03
317508,JAKARTA TIMUR,MAKASAR,9162,133,8780,162,87,220,2021-06-03
317403,JAKARTA SELATAN,MAMPANG PRAPATAN,6052,41,5836,106,69,110,2021-06-03
317307,JAKARTA BARAT,PALMERAH,8205,135,7763,177,130,265,2021-06-03
317106,JAKARTA PUSAT,MENTENG,3396,40,3250,70,36,76,2021-06-03
317205,JAKARTA UTARA,PADEMANGAN,5640,78,5285,89,188,266,2021-06-03
317510,JAKARTA TIMUR,CIPAYUNG,11113,188,10584,135,206,394,2021-06-03
317408,JAKARTA SELATAN,PANCORAN,6832,89,6522,117,104,193,2021-06-03
317204,JAKARTA UTARA,CILINCING,8309,96,7938,171,104,200,2021-06-03
317308,JAKARTA BARAT,KEMBANGAN,9611,99,9242,135,135,234,2021-06-03
317501,JAKARTA TIMUR,MATRAMAN,6660,44,6413,148,55,99,2021-06-03
317103,JAKARTA PUSAT,KEMAYORAN,10467,166,10037,193,71,237,2021-06-03
317101,JAKARTA PUSAT,GAMBIR,4063,63,3852,70,78,141,2021-06-03
317305,JAKARTA BARAT,KEBON JERUK,11151,147,10626,197,181,328,2021-06-03
317507,JAKARTA TIMUR,DUREN SAWIT,15103,183,14409,316,195,378,2021-06-03
317404,JAKARTA SELATAN,PASAR MINGGU,12079,150,11565,227,137,287,2021-06-03
317506,JAKARTA TIMUR,CAKUNG,12307,168,11786,215,138,306,2021-06-03
317505,JAKARTA TIMUR,PASAR REBO,8602,78,8221,161,142,220,2021-06-03
317105,JAKARTA PUSAT,CEMPAKA PUTIH,5223,49,5061,87,26,75,2021-06-03
317301,JAKARTA BARAT,CENGKARENG,14049,221,13323,287,218,439,2021-06-03
317206,JAKARTA UTARA,KELAPA GADING,6306,78,6048,103,77,155,2021-06-03
317406,JAKARTA SELATAN,CILANDAK,8795,121,8375,140,159,280,2021-06-03
317409,JAKARTA SELATAN,JAGAKARSA,12457,103,11967,206,181,284,2021-06-03
317503,JAKARTA TIMUR,JATINEGARA,9466,104,9054,187,121,225,2021-06-03
317108,JAKARTA PUSAT,JOHAR BARU,4362,48,4145,108,61,109,2021-06-03
317306,JAKARTA BARAT,KALI DERES,8533,110,8167,157,99,209,2021-06-03
317407,JAKARTA SELATAN,KEBAYORAN BARU,7018,97,6718,106,97,194,2021-06-03
317405,JAKARTA SELATAN,KEBAYORAN LAMA,10083,124,9598,195,166,290,2021-06-03
317302,JAKARTA BARAT,GROGOL PETAMBURAN,8806,143,8380,171,112,255,2021-06-03
317509,JAKARTA TIMUR,CIRACAS,10026,148,9575,199,104,252,2021-06-03
317201,JAKARTA UTARA,PENJARINGAN,8687,167,8284,117,119,286,2021-06-03
317304,JAKARTA BARAT,TAMBORA,6300,92,5971,134,103,195,2021-06-03
317410,JAKARTA SELATAN,PESANGGRAHAN,7890,73,7531,134,152,225,2021-06-03
317502,JAKARTA TIMUR,PULO GADUNG,10590,160,10093,202,135,295,2021-06-03
317102,JAKARTA PUSAT,SAWAH BESAR,4297,59,4098,83,57,116,2021-06-03
317104,JAKARTA PUSAT,SENEN,4676,50,4490,98,38,88,2021-06-03
317402,JAKARTA SELATAN,SETIA BUDI,5835,114,5539,98,84,198,2021-06-03
317303,JAKARTA BARAT,TAMAN SARI,4127,51,3972,67,37,88,2021-06-03
317107,JAKARTA PUSAT,TANAH ABANG,6140,74,5865,123,78,152,2021-06-03
317202,JAKARTA UTARA,TANJUNG PRIOK,13140,149,12628,238,125,274,2021-06-03
317401,JAKARTA SELATAN,TEBET,8350,109,7991,157,93,202,2021-06-03
317205,JAKARTA UTARA,PADEMANGAN,5667,73,5304,89,201,274,2021-06-04
317106,JAKARTA PUSAT,MENTENG,3401,40,3254,71,36,76,2021-06-04
317501,JAKARTA TIMUR,MATRAMAN,6666,48,6420,148,50,98,2021-06-04
317403,JAKARTA SELATAN,MAMPANG PRAPATAN,6068,53,5842,106,67,120,2021-06-04
317505,JAKARTA TIMUR,PASAR REBO,8609,78,8229,161,141,219,2021-06-04
317307,JAKARTA BARAT,PALMERAH,8245,143,7773,178,151,294,2021-06-04
317504,JAKARTA TIMUR,KRAMAT JATI,10664,123,10216,199,126,249,2021-06-04
317404,JAKARTA SELATAN,PASAR MINGGU,12100,157,11583,227,133,290,2021-06-04
317508,JAKARTA TIMUR,MAKASAR,9174,139,8783,163,89,228,2021-06-04
317408,JAKARTA SELATAN,PANCORAN,6846,95,6531,117,103,198,2021-06-04
317201,JAKARTA UTARA,PENJARINGAN,8713,170,8319,118,106,276,2021-06-04
317102,JAKARTA PUSAT,SAWAH BESAR,4302,64,4101,83,54,118,2021-06-04
317104,JAKARTA PUSAT,SENEN,4678,46,4496,98,38,84,2021-06-04
317402,JAKARTA SELATAN,SETIA BUDI,5845,97,5568,98,82,179,2021-06-04
317303,JAKARTA BARAT,TAMAN SARI,4139,54,3976,67,42,96,2021-06-04
310101,KAB.ADM.KEP.SERIBU,KEP. SERIBU UTARA,334,0,326,5,3,3,2021-06-04
317304,JAKARTA BARAT,TAMBORA,6315,94,5984,134,103,197,2021-06-04
317107,JAKARTA PUSAT,TANAH ABANG,6157,78,5888,123,68,146,2021-06-04
317202,JAKARTA UTARA,TANJUNG PRIOK,13166,160,12644,238,124,284,2021-06-04
317401,JAKARTA SELATAN,TEBET,8369,105,8008,158,98,203,2021-06-04
317502,JAKARTA TIMUR,PULO GADUNG,10605,157,10122,203,123,280,2021-06-04
310102,KAB.ADM.KEP.SERIBU,KEP. SERIBU SELATAN,244,0,241,3,0,0,2021-06-04
317203,JAKARTA UTARA,KOJA,8860,83,8574,171,32,115,2021-06-04
317103,JAKARTA PUSAT,KEMAYORAN,10486,174,10056,193,63,237,2021-06-04
317410,JAKARTA SELATAN,PESANGGRAHAN,7896,74,7538,134,150,224,2021-06-04
111111,Luar DKI & Proses Update,Luar DKI & Proses Update,143008,137,141294,1273,304,441,2021-06-04
317308,JAKARTA BARAT,KEMBANGAN,9640,99,9256,135,150,249,2021-06-04
317105,JAKARTA PUSAT,CEMPAKA PUTIH,5233,45,5072,87,29,74,2021-06-04
317301,JAKARTA BARAT,CENGKARENG,14088,229,13358,287,214,443,2021-06-04
317406,JAKARTA SELATAN,CILANDAK,8822,95,8411,143,173,268,2021-06-04
317204,JAKARTA UTARA,CILINCING,8314,91,7951,171,101,192,2021-06-04
317510,JAKARTA TIMUR,CIPAYUNG,11118,174,10608,137,199,373,2021-06-04
317509,JAKARTA TIMUR,CIRACAS,10038,145,9592,200,101,246,2021-06-04
317507,JAKARTA TIMUR,DUREN SAWIT,15142,185,14432,316,209,394,2021-06-04
317506,JAKARTA TIMUR,CAKUNG,12322,170,11802,217,133,303,2021-06-04
317302,JAKARTA BARAT,GROGOL PETAMBURAN,8823,141,8406,171,105,246,2021-06-04
317101,JAKARTA PUSAT,GAMBIR,4070,54,3871,70,75,129,2021-06-04
317305,JAKARTA BARAT,KEBON JERUK,11185,137,10662,197,189,326,2021-06-04
317405,JAKARTA SELATAN,KEBAYORAN LAMA,10105,118,9624,197,166,284,2021-06-04
317407,JAKARTA SELATAN,KEBAYORAN BARU,7045,103,6737,107,98,201,2021-06-04
317206,JAKARTA UTARA,KELAPA GADING,6320,71,6071,104,74,145,2021-06-04
317108,JAKARTA PUSAT,JOHAR BARU,4370,53,4147,109,61,114,2021-06-04
317503,JAKARTA TIMUR,JATINEGARA,9470,100,9066,187,117,217,2021-06-04
317409,JAKARTA SELATAN,JAGAKARSA,12512,101,11985,206,220,321,2021-06-04
317306,JAKARTA BARAT,KALI DERES,8552,115,8180,158,99,214,2021-06-04
317302,JAKARTA BARAT,GROGOL PETAMBURAN,8850,130,8436,171,113,243,2021-06-05
317407,JAKARTA SELATAN,KEBAYORAN BARU,7056,94,6763,107,92,186,2021-06-05
317306,JAKARTA BARAT,KALI DERES,8586,112,8204,159,111,223,2021-06-05
317108,JAKARTA PUSAT,JOHAR BARU,4380,52,4150,110,68,120,2021-06-05
317503,JAKARTA TIMUR,JATINEGARA,9495,95,9085,187,128,223,2021-06-05
317409,JAKARTA SELATAN,JAGAKARSA,12535,110,12008,206,211,321,2021-06-05
317101,JAKARTA PUSAT,GAMBIR,4082,55,3877,70,80,135,2021-06-05
317406,JAKARTA SELATAN,CILANDAK,8831,99,8424,143,165,264,2021-06-05
317509,JAKARTA TIMUR,CIRACAS,10066,148,9604,200,114,262,2021-06-05
317510,JAKARTA TIMUR,CIPAYUNG,11160,176,10652,137,195,371,2021-06-05
317204,JAKARTA UTARA,CILINCING,8328,96,7961,172,99,195,2021-06-05
317301,JAKARTA BARAT,CENGKARENG,14169,245,13387,287,250,495,2021-06-05
317105,JAKARTA PUSAT,CEMPAKA PUTIH,5259,45,5080,87,47,92,2021-06-05
317506,JAKARTA TIMUR,CAKUNG,12378,182,11812,217,167,349,2021-06-05
317507,JAKARTA TIMUR,DUREN SAWIT,15163,191,14455,317,200,391,2021-06-05
317305,JAKARTA BARAT,KEBON JERUK,11226,140,10692,198,196,336,2021-06-05
317405,JAKARTA SELATAN,KEBAYORAN LAMA,10130,128,9647,199,156,284,2021-06-05
317103,JAKARTA PUSAT,KEMAYORAN,10550,182,10081,193,94,276,2021-06-05
111111,Luar DKI & Proses Update,Luar DKI & Proses Update,143008,137,141294,1273,304,441,2021-06-05
317401,JAKARTA SELATAN,TEBET,8377,96,8025,158,98,194,2021-06-05
317202,JAKARTA UTARA,TANJUNG PRIOK,13208,181,12649,240,138,319,2021-06-05
317107,JAKARTA PUSAT,TANAH ABANG,6167,79,5894,123,71,150,2021-06-05
317304,JAKARTA BARAT,TAMBORA,6355,95,6003,135,122,217,2021-06-05
317303,JAKARTA BARAT,TAMAN SARI,4147,45,3990,67,45,90,2021-06-05
317104,JAKARTA PUSAT,SENEN,4687,46,4500,98,43,89,2021-06-05
317102,JAKARTA PUSAT,SAWAH BESAR,4312,67,4105,84,56,123,2021-06-05
317502,JAKARTA TIMUR,PULO GADUNG,10649,157,10145,205,142,299,2021-06-05
317410,JAKARTA SELATAN,PESANGGRAHAN,7929,72,7568,134,155,227,2021-06-05
317201,JAKARTA UTARA,PENJARINGAN,8761,185,8335,118,123,308,2021-06-05
317505,JAKARTA TIMUR,PASAR REBO,8613,70,8253,161,129,199,2021-06-05
317404,JAKARTA SELATAN,PASAR MINGGU,12144,166,11597,228,153,319,2021-06-05
317408,JAKARTA SELATAN,PANCORAN,6866,85,6559,117,105,190,2021-06-05
317307,JAKARTA BARAT,PALMERAH,8283,144,7802,179,158,302,2021-06-05
317205,JAKARTA UTARA,PADEMANGAN,5693,73,5330,89,201,274,2021-06-05
317106,JAKARTA PUSAT,MENTENG,3398,41,3253,71,33,74,2021-06-05
317501,JAKARTA TIMUR,MATRAMAN,6694,48,6431,150,65,113,2021-06-05
317403,JAKARTA SELATAN,MAMPANG PRAPATAN,6097,58,5851,106,82,140,2021-06-05
317508,JAKARTA TIMUR,MAKASAR,9188,138,8799,163,88,226,2021-06-05
317504,JAKARTA TIMUR,KRAMAT JATI,10709,134,10240,199,136,270,2021-06-05
317203,JAKARTA UTARA,KOJA,8881,95,8575,173,38,133,2021-06-05
310101,KAB.ADM.KEP.SERIBU,KEP. SERIBU UTARA,334,0,327,5,2,2,2021-06-05
310102,KAB.ADM.KEP.SERIBU,KEP. SERIBU SELATAN,244,0,241,3,0,0,2021-06-05
317308,JAKARTA BARAT,KEMBANGAN,9674,89,9284,136,165,254,2021-06-05
317206,JAKARTA UTARA,KELAPA GADING,6341,74,6084,104,79,153,2021-06-05
317402,JAKARTA SELATAN,SETIA BUDI,5857,101,5576,98,82,183,2021-06-05
317401,JAKARTA SELATAN,TEBET,8388,84,8053,158,93,177,2021-06-06
317506,JAKARTA TIMUR,CAKUNG,12398,176,11847,217,158,334,2021-06-06
317508,JAKARTA TIMUR,MAKASAR,9207,137,8810,163,97,234,2021-06-06
317403,JAKARTA SELATAN,MAMPANG PRAPATAN,6105,61,5859,106,79,140,2021-06-06
317501,JAKARTA TIMUR,MATRAMAN,6712,56,6439,150,67,123,2021-06-06
317106,JAKARTA PUSAT,MENTENG,3413,44,3254,71,44,88,2021-06-06
317205,JAKARTA UTARA,PADEMANGAN,5721,69,5350,89,213,282,2021-06-06
317307,JAKARTA BARAT,PALMERAH,8308,144,7816,180,168,312,2021-06-06
317408,JAKARTA SELATAN,PANCORAN,6879,88,6565,118,108,196,2021-06-06
317404,JAKARTA SELATAN,PASAR MINGGU,12178,157,11629,228,164,321,2021-06-06
317505,JAKARTA TIMUR,PASAR REBO,8626,74,8271,162,119,193,2021-06-06
317201,JAKARTA UTARA,PENJARINGAN,8791,184,8355,119,133,317,2021-06-06
317410,JAKARTA SELATAN,PESANGGRAHAN,7955,70,7578,134,173,243,2021-06-06
317502,JAKARTA TIMUR,PULO GADUNG,10671,146,10182,205,138,284,2021-06-06
317102,JAKARTA PUSAT,SAWAH BESAR,4319,58,4127,84,50,108,2021-06-06
317104,JAKARTA PUSAT,SENEN,4708,46,4507,98,57,103,2021-06-06
317402,JAKARTA SELATAN,SETIA BUDI,5868,100,5588,99,81,181,2021-06-06
317303,JAKARTA BARAT,TAMAN SARI,4149,46,3992,67,44,90,2021-06-06
317304,JAKARTA BARAT,TAMBORA,6372,104,6011,135,122,226,2021-06-06
317107,JAKARTA PUSAT,TANAH ABANG,6195,90,5904,123,78,168,2021-06-06
317202,JAKARTA UTARA,TANJUNG PRIOK,13227,167,12677,240,143,310,2021-06-06
317504,JAKARTA TIMUR,KRAMAT JATI,10734,135,10255,200,144,279,2021-06-06
111111,Luar DKI & Proses Update,Luar DKI & Proses Update,143008,137,141294,1273,304,441,2021-06-06
317203,JAKARTA UTARA,KOJA,8892,95,8586,173,38,133,2021-06-06
310102,KAB.ADM.KEP.SERIBU,KEP. SERIBU SELATAN,245,1,241,3,0,1,2021-06-06
317105,JAKARTA PUSAT,CEMPAKA PUTIH,5265,49,5081,88,47,96,2021-06-06
317301,JAKARTA BARAT,CENGKARENG,14243,259,13431,287,266,525,2021-06-06
317406,JAKARTA SELATAN,CILANDAK,8839,94,8442,143,160,254,2021-06-06
317204,JAKARTA UTARA,CILINCING,8343,100,7968,172,103,203,2021-06-06
317510,JAKARTA TIMUR,CIPAYUNG,11186,163,10671,137,215,378,2021-06-06
317509,JAKARTA TIMUR,CIRACAS,10098,146,9617,200,135,281,2021-06-06
317507,JAKARTA TIMUR,DUREN SAWIT,15190,182,14498,319,191,373,2021-06-06
317101,JAKARTA PUSAT,GAMBIR,4104,56,3882,70,96,152,2021-06-06
317302,JAKARTA BARAT,GROGOL PETAMBURAN,8878,140,8457,171,110,250,2021-06-06
317409,JAKARTA SELATAN,JAGAKARSA,12574,109,12035,206,224,333,2021-06-06
317503,JAKARTA TIMUR,JATINEGARA,9522,90,9106,188,138,228,2021-06-06
317108,JAKARTA PUSAT,JOHAR BARU,4391,53,4154,111,73,126,2021-06-06
317306,JAKARTA BARAT,KALI DERES,8615,125,8221,159,110,235,2021-06-06
317407,JAKARTA SELATAN,KEBAYORAN BARU,7093,95,6781,108,109,204,2021-06-06
317405,JAKARTA SELATAN,KEBAYORAN LAMA,10163,123,9671,201,168,291,2021-06-06
317305,JAKARTA BARAT,KEBON JERUK,11260,143,10718,198,201,344,2021-06-06
317206,JAKARTA UTARA,KELAPA GADING,6349,57,6107,104,81,138,2021-06-06
317103,JAKARTA PUSAT,KEMAYORAN,10568,183,10093,194,98,281,2021-06-06
317308,JAKARTA BARAT,KEMBANGAN,9720,95,9313,136,176,271,2021-06-06
310101,KAB.ADM.KEP.SERIBU,KEP. SERIBU UTARA,335,0,327,5,3,3,2021-06-06
111111,Luar DKI & Proses Update,Luar DKI & Proses Update,143008,137,141294,1273,304,441,2021-06-07
317401,JAKARTA SELATAN,TEBET,8414,85,8077,158,94,179,2021-06-07
317404,JAKARTA SELATAN,PASAR MINGGU,12205,154,11647,228,176,330,2021-06-07
317504,JAKARTA TIMUR,KRAMAT JATI,10772,139,10270,201,162,301,2021-06-07
317508,JAKARTA TIMUR,MAKASAR,9229,138,8821,163,107,245,2021-06-07
317501,JAKARTA TIMUR,MATRAMAN,6746,53,6449,152,92,145,2021-06-07
317106,JAKARTA PUSAT,MENTENG,3414,34,3266,71,43,77,2021-06-07
317205,JAKARTA UTARA,PADEMANGAN,5737,70,5369,90,208,278,2021-06-07
317307,JAKARTA BARAT,PALMERAH,8322,148,7838,180,156,304,2021-06-07
317408,JAKARTA SELATAN,PANCORAN,6891,79,6585,118,109,188,2021-06-07
317505,JAKARTA TIMUR,PASAR REBO,8633,71,8283,162,117,188,2021-06-07
317203,JAKARTA UTARA,KOJA,8920,100,8596,173,51,151,2021-06-07
317201,JAKARTA UTARA,PENJARINGAN,8828,198,8371,119,140,338,2021-06-07
317502,JAKARTA TIMUR,PULO GADUNG,10683,142,10202,205,134,276,2021-06-07
317102,JAKARTA PUSAT,SAWAH BESAR,4324,52,4139,84,49,101,2021-06-07
317104,JAKARTA PUSAT,SENEN,4711,47,4510,98,56,103,2021-06-07
317402,JAKARTA SELATAN,SETIA BUDI,5881,95,5602,99,85,180,2021-06-07
317303,JAKARTA BARAT,TAMAN SARI,4157,45,3998,67,47,92,2021-06-07
317304,JAKARTA BARAT,TAMBORA,6406,114,6028,135,129,243,2021-06-07
317107,JAKARTA PUSAT,TANAH ABANG,6207,91,5913,123,80,171,2021-06-07
317202,JAKARTA UTARA,TANJUNG PRIOK,13275,176,12711,240,148,324,2021-06-07
317410,JAKARTA SELATAN,PESANGGRAHAN,7967,72,7611,134,150,222,2021-06-07
310101,KAB.ADM.KEP.SERIBU,KEP. SERIBU UTARA,336,1,327,5,3,4,2021-06-07
317403,JAKARTA SELATAN,MAMPANG PRAPATAN,6116,65,5863,106,82,147,2021-06-07
317308,JAKARTA BARAT,KEMBANGAN,9738,99,9319,136,184,283,2021-06-07
317506,JAKARTA TIMUR,CAKUNG,12424,174,11863,218,169,343,2021-06-07
317105,JAKARTA PUSAT,CEMPAKA PUTIH,5273,50,5085,89,49,99,2021-06-07
317301,JAKARTA BARAT,CENGKARENG,14330,278,13454,288,310,588,2021-06-07
317406,JAKARTA SELATAN,CILANDAK,8871,98,8466,143,164,262,2021-06-07
317204,JAKARTA UTARA,CILINCING,8368,102,7979,174,113,215,2021-06-07
317510,JAKARTA TIMUR,CIPAYUNG,11247,129,10732,138,248,377,2021-06-07
310102,KAB.ADM.KEP.SERIBU,KEP. SERIBU SELATAN,244,0,241,3,0,0,2021-06-07
317507,JAKARTA TIMUR,DUREN SAWIT,15216,181,14532,319,184,365,2021-06-07
317101,JAKARTA PUSAT,GAMBIR,4117,48,3918,70,81,129,2021-06-07
317302,JAKARTA BARAT,GROGOL PETAMBURAN,8910,146,8465,172,127,273,2021-06-07
317509,JAKARTA TIMUR,CIRACAS,10126,132,9638,200,156,288,2021-06-07
317103,JAKARTA PUSAT,KEMAYORAN,10591,189,10101,194,107,296,2021-06-07
317503,JAKARTA TIMUR,JATINEGARA,9532,78,9132,189,133,211,2021-06-07
317108,JAKARTA PUSAT,JOHAR BARU,4407,53,4162,111,81,134,2021-06-07
317306,JAKARTA BARAT,KALI DERES,8647,138,8224,159,126,264,2021-06-07
317407,JAKARTA SELATAN,KEBAYORAN BARU,7112,95,6803,111,103,198,2021-06-07
317405,JAKARTA SELATAN,KEBAYORAN LAMA,10203,126,9692,203,182,308,2021-06-07
317305,JAKARTA BARAT,KEBON JERUK,11282,146,10725,200,211,357,2021-06-07
317206,JAKARTA UTARA,KELAPA GADING,6367,57,6114,104,92,149,2021-06-07
317409,JAKARTA SELATAN,JAGAKARSA,12611,119,12056,206,230,349,2021-06-07
317404,JAKARTA SELATAN,PASAR MINGGU,12240,131,11704,230,175,306,2021-06-08
317408,JAKARTA SELATAN,PANCORAN,6906,77,6606,118,105,182,2021-06-08
317307,JAKARTA BARAT,PALMERAH,8328,127,7876,181,144,271,2021-06-08
317205,JAKARTA UTARA,PADEMANGAN,5745,72,5385,90,198,270,2021-06-08
317508,JAKARTA TIMUR,MAKASAR,9243,143,8829,164,107,250,2021-06-08
317501,JAKARTA TIMUR,MATRAMAN,6749,54,6452,152,91,145,2021-06-08
317403,JAKARTA SELATAN,MAMPANG PRAPATAN,6134,58,5889,106,81,139,2021-06-08
317505,JAKARTA TIMUR,PASAR REBO,8646,72,8294,163,117,189,2021-06-08
317106,JAKARTA PUSAT,MENTENG,3423,33,3277,71,42,75,2021-06-08
317201,JAKARTA UTARA,PENJARINGAN,8855,204,8388,119,144,348,2021-06-08
317503,JAKARTA TIMUR,JATINEGARA,9551,81,9149,191,130,211,2021-06-08
317502,JAKARTA TIMUR,PULO GADUNG,10692,141,10216,206,129,270,2021-06-08
317102,JAKARTA PUSAT,SAWAH BESAR,4327,49,4148,85,45,94,2021-06-08
317104,JAKARTA PUSAT,SENEN,4714,46,4519,98,51,97,2021-06-08
317402,JAKARTA SELATAN,SETIA BUDI,5888,86,5616,101,85,171,2021-06-08
317303,JAKARTA BARAT,TAMAN SARI,4163,48,4001,67,47,95,2021-06-08
317304,JAKARTA BARAT,TAMBORA,6418,119,6043,135,121,240,2021-06-08
317107,JAKARTA PUSAT,TANAH ABANG,6210,77,5927,123,83,160,2021-06-08
317202,JAKARTA UTARA,TANJUNG PRIOK,13288,177,12732,240,139,316,2021-06-08
317401,JAKARTA SELATAN,TEBET,8440,86,8100,160,94,180,2021-06-08
317504,JAKARTA TIMUR,KRAMAT JATI,10796,139,10287,202,168,307,2021-06-08
317410,JAKARTA SELATAN,PESANGGRAHAN,7975,70,7625,134,146,216,2021-06-08
111111,Luar DKI & Proses Update,Luar DKI & Proses Update,143008,137,141294,1273,304,441,2021-06-08
317510,JAKARTA TIMUR,CIPAYUNG,11262,115,10768,138,241,356,2021-06-08
310101,KAB.ADM.KEP.SERIBU,KEP. SERIBU UTARA,336,1,327,5,3,4,2021-06-08
317506,JAKARTA TIMUR,CAKUNG,12441,154,11896,218,173,327,2021-06-08
317105,JAKARTA PUSAT,CEMPAKA PUTIH,5284,47,5090,90,57,104,2021-06-08
317301,JAKARTA BARAT,CENGKARENG,14356,288,13470,288,310,598,2021-06-08
317406,JAKARTA SELATAN,CILANDAK,8888,95,8511,143,139,234,2021-06-08
317204,JAKARTA UTARA,CILINCING,8387,104,7994,174,115,219,2021-06-08
317203,JAKARTA UTARA,KOJA,8935,101,8607,173,54,155,2021-06-08
317507,JAKARTA TIMUR,DUREN SAWIT,15234,176,14561,321,176,352,2021-06-08
317101,JAKARTA PUSAT,GAMBIR,4132,49,3923,70,90,139,2021-06-08
317302,JAKARTA BARAT,GROGOL PETAMBURAN,8922,141,8490,172,119,260,2021-06-08
317409,JAKARTA SELATAN,JAGAKARSA,12626,134,12097,206,189,323,2021-06-08
317509,JAKARTA TIMUR,CIRACAS,10136,125,9664,200,147,272,2021-06-08
317108,JAKARTA PUSAT,JOHAR BARU,4410,48,4172,111,79,127,2021-06-08
317308,JAKARTA BARAT,KEMBANGAN,9756,106,9351,136,163,269,2021-06-08
317103,JAKARTA PUSAT,KEMAYORAN,10613,177,10133,195,108,285,2021-06-08
317206,JAKARTA UTARA,KELAPA GADING,6383,56,6123,104,100,156,2021-06-08
317305,JAKARTA BARAT,KEBON JERUK,11328,144,10754,201,229,373,2021-06-08
310102,KAB.ADM.KEP.SERIBU,KEP. SERIBU SELATAN,244,0,241,3,0,0,2021-06-08
317405,JAKARTA SELATAN,KEBAYORAN LAMA,10233,140,9716,204,173,313,2021-06-08
317407,JAKARTA SELATAN,KEBAYORAN BARU,7126,96,6813,111,106,202,2021-06-08
317306,JAKARTA BARAT,KALI DERES,8659,139,8235,159,126,265,2021-06-08
310102,KAB.ADM.KEP.SERIBU,KEP. SERIBU SELATAN,244,0,241,3,0,0,2021-06-09
317308,JAKARTA BARAT,KEMBANGAN,9828,122,9364,138,204,326,2021-06-09
317103,JAKARTA PUSAT,KEMAYORAN,10640,182,10152,195,111,293,2021-06-09
317206,JAKARTA UTARA,KELAPA GADING,6408,67,6134,104,103,170,2021-06-09
317305,JAKARTA BARAT,KEBON JERUK,11404,144,10810,201,249,393,2021-06-09
317405,JAKARTA SELATAN,KEBAYORAN LAMA,10257,144,9734,205,174,318,2021-06-09
317407,JAKARTA SELATAN,KEBAYORAN BARU,7145,103,6824,112,106,209,2021-06-09
317306,JAKARTA BARAT,KALI DERES,8682,147,8249,160,126,273,2021-06-09
317108,JAKARTA PUSAT,JOHAR BARU,4423,57,4184,111,71,128,2021-06-09
317503,JAKARTA TIMUR,JATINEGARA,9581,91,9160,191,139,230,2021-06-09
317409,JAKARTA SELATAN,JAGAKARSA,12643,125,12114,207,197,322,2021-06-09
317504,JAKARTA TIMUR,KRAMAT JATI,10827,133,10329,204,161,294,2021-06-09
317101,JAKARTA PUSAT,GAMBIR,4142,48,3935,70,89,137,2021-06-09
317507,JAKARTA TIMUR,DUREN SAWIT,15290,174,14590,321,205,379,2021-06-09
317509,JAKARTA TIMUR,CIRACAS,10154,124,9691,200,139,263,2021-06-09
317510,JAKARTA TIMUR,CIPAYUNG,11288,121,10810,138,219,340,2021-06-09
317204,JAKARTA UTARA,CILINCING,8403,99,8020,174,110,209,2021-06-09
317406,JAKARTA SELATAN,CILANDAK,8922,102,8539,143,138,240,2021-06-09
317301,JAKARTA BARAT,CENGKARENG,14413,320,13527,288,278,598,2021-06-09
317105,JAKARTA PUSAT,CEMPAKA PUTIH,5304,47,5102,90,65,112,2021-06-09
317506,JAKARTA TIMUR,CAKUNG,12471,153,11948,218,152,305,2021-06-09
310101,KAB.ADM.KEP.SERIBU,KEP. SERIBU UTARA,336,1,327,5,3,4,2021-06-09
317302,JAKARTA BARAT,GROGOL PETAMBURAN,8948,136,8509,175,128,264,2021-06-09
317203,JAKARTA UTARA,KOJA,8955,99,8621,173,62,161,2021-06-09
317408,JAKARTA SELATAN,PANCORAN,6919,78,6619,118,104,182,2021-06-09
317508,JAKARTA TIMUR,MAKASAR,9270,143,8867,164,96,239,2021-06-09
111111,Luar DKI & Proses Update,Luar DKI & Proses Update,143008,137,141294,1273,304,441,2021-06-09
317401,JAKARTA SELATAN,TEBET,8465,86,8115,161,103,189,2021-06-09
317202,JAKARTA UTARA,TANJUNG PRIOK,13331,190,12748,241,152,342,2021-06-09
317107,JAKARTA PUSAT,TANAH ABANG,6221,81,5950,123,67,148,2021-06-09
317304,JAKARTA BARAT,TAMBORA,6451,133,6059,136,123,256,2021-06-09
317402,JAKARTA SELATAN,SETIA BUDI,5913,96,5632,101,84,180,2021-06-09
317104,JAKARTA PUSAT,SENEN,4735,53,4528,98,56,109,2021-06-09
317102,JAKARTA PUSAT,SAWAH BESAR,4343,58,4159,85,41,99,2021-06-09
317502,JAKARTA TIMUR,PULO GADUNG,10731,145,10250,206,130,275,2021-06-09
317303,JAKARTA BARAT,TAMAN SARI,4175,53,4007,67,48,101,2021-06-09
317201,JAKARTA UTARA,PENJARINGAN,8881,202,8424,120,135,337,2021-06-09
317505,JAKARTA TIMUR,PASAR REBO,8665,67,8322,164,112,179,2021-06-09
317404,JAKARTA SELATAN,PASAR MINGGU,12276,132,11726,230,188,320,2021-06-09
317307,JAKARTA BARAT,PALMERAH,8386,132,7904,183,167,299,2021-06-09
317205,JAKARTA UTARA,PADEMANGAN,5759,65,5418,91,185,250,2021-06-09
317106,JAKARTA PUSAT,MENTENG,3448,41,3286,71,50,91,2021-06-09
317501,JAKARTA TIMUR,MATRAMAN,6762,58,6466,153,85,143,2021-06-09
317410,JAKARTA SELATAN,PESANGGRAHAN,7984,70,7646,134,134,204,2021-06-09
317403,JAKARTA SELATAN,MAMPANG PRAPATAN,6144,61,5896,106,81,142,2021-06-09
317303,JAKARTA BARAT,TAMAN SARI,4188,59,4023,69,37,96,2021-06-10
317304,JAKARTA BARAT,TAMBORA,6488,134,6078,137,139,273,2021-06-10
317107,JAKARTA PUSAT,TANAH ABANG,6275,83,5962,125,105,188,2021-06-10
111111,Luar DKI & Proses Update,Luar DKI & Proses Update,143008,137,141294,1273,304,441,2021-06-10
317401,JAKARTA SELATAN,TEBET,8497,82,8140,161,114,196,2021-06-10
317508,JAKARTA TIMUR,MAKASAR,9319,124,8910,164,121,245,2021-06-10
317402,JAKARTA SELATAN,SETIA BUDI,5939,92,5653,101,93,185,2021-06-10
317202,JAKARTA UTARA,TANJUNG PRIOK,13379,198,12772,243,166,364,2021-06-10
317104,JAKARTA PUSAT,SENEN,4753,58,4537,98,60,118,2021-06-10
317106,JAKARTA PUSAT,MENTENG,3462,44,3292,71,55,99,2021-06-10
317502,JAKARTA TIMUR,PULO GADUNG,10793,152,10277,206,158,310,2021-06-10
317410,JAKARTA SELATAN,PESANGGRAHAN,8035,69,7671,134,161,230,2021-06-10
317201,JAKARTA UTARA,PENJARINGAN,8929,208,8446,122,153,361,2021-06-10
317505,JAKARTA TIMUR,PASAR REBO,8721,66,8352,164,139,205,2021-06-10
317404,JAKARTA SELATAN,PASAR MINGGU,12334,139,11756,231,208,347,2021-06-10
317408,JAKARTA SELATAN,PANCORAN,6957,77,6634,119,127,204,2021-06-10
317307,JAKARTA BARAT,PALMERAH,8430,137,7929,183,181,318,2021-06-10
317205,JAKARTA UTARA,PADEMANGAN,5785,63,5436,91,195,258,2021-06-10
317501,JAKARTA TIMUR,MATRAMAN,6809,53,6479,154,123,176,2021-06-10
317102,JAKARTA PUSAT,SAWAH BESAR,4361,56,4172,85,48,104,2021-06-10
317504,JAKARTA TIMUR,KRAMAT JATI,10887,147,10356,205,179,326,2021-06-10
317403,JAKARTA SELATAN,MAMPANG PRAPATAN,6168,66,5900,106,96,162,2021-06-10
310101,KAB.ADM.KEP.SERIBU,KEP. SERIBU UTARA,336,1,327,5,3,4,2021-06-10
317206,JAKARTA UTARA,KELAPA GADING,6413,69,6140,105,99,168,2021-06-10
317305,JAKARTA BARAT,KEBON JERUK,11472,159,10843,201,269,428,2021-06-10
317405,JAKARTA SELATAN,KEBAYORAN LAMA,10293,145,9771,205,172,317,2021-06-10
317407,JAKARTA SELATAN,KEBAYORAN BARU,7188,105,6850,112,121,226,2021-06-10
317203,JAKARTA UTARA,KOJA,8974,114,8630,174,56,170,2021-06-10
317108,JAKARTA PUSAT,JOHAR BARU,4449,63,4191,111,84,147,2021-06-10
317503,JAKARTA TIMUR,JATINEGARA,9608,94,9178,191,145,239,2021-06-10
317409,JAKARTA SELATAN,JAGAKARSA,12726,112,12149,207,258,370,2021-06-10
317103,JAKARTA PUSAT,KEMAYORAN,10699,172,10184,195,148,320,2021-06-10
317302,JAKARTA BARAT,GROGOL PETAMBURAN,8996,133,8543,175,145,278,2021-06-10
317306,JAKARTA BARAT,KALI DERES,8731,140,8278,160,153,293,2021-06-10
317507,JAKARTA TIMUR,DUREN SAWIT,15360,169,14629,322,240,409,2021-06-10
317509,JAKARTA TIMUR,CIRACAS,10218,113,9734,200,171,284,2021-06-10
317510,JAKARTA TIMUR,CIPAYUNG,11367,114,10830,139,284,398,2021-06-10
317204,JAKARTA UTARA,CILINCING,8439,107,8035,174,123,230,2021-06-10
317406,JAKARTA SELATAN,CILANDAK,8981,103,8556,143,179,282,2021-06-10
317301,JAKARTA BARAT,CENGKARENG,14516,337,13574,290,315,652,2021-06-10
317105,JAKARTA PUSAT,CEMPAKA PUTIH,5325,51,5108,91,75,126,2021-06-10
317506,JAKARTA TIMUR,CAKUNG,12537,158,11963,221,195,353,2021-06-10
317308,JAKARTA BARAT,KEMBANGAN,9873,121,9403,139,210,331,2021-06-10
310102,KAB.ADM.KEP.SERIBU,KEP. SERIBU SELATAN,246,0,241,3,2,2,2021-06-10
317101,JAKARTA PUSAT,GAMBIR,4183,56,3944,70,113,169,2021-06-10
317503,JAKARTA TIMUR,JATINEGARA,9666,97,9195,193,181,278,2021-06-11
317409,JAKARTA SELATAN,JAGAKARSA,12789,126,12183,208,272,398,2021-06-11
317302,JAKARTA BARAT,GROGOL PETAMBURAN,9046,143,8566,176,161,304,2021-06-11
317101,JAKARTA PUSAT,GAMBIR,4196,55,3958,70,113,168,2021-06-11
317507,JAKARTA TIMUR,DUREN SAWIT,15430,179,14656,323,272,451,2021-06-11
317105,JAKARTA PUSAT,CEMPAKA PUTIH,5362,70,5120,91,81,151,2021-06-11
317510,JAKARTA TIMUR,CIPAYUNG,11420,105,10877,140,298,403,2021-06-11
317204,JAKARTA UTARA,CILINCING,8491,119,8052,174,146,265,2021-06-11
317406,JAKARTA SELATAN,CILANDAK,9010,102,8594,143,171,273,2021-06-11
317301,JAKARTA BARAT,CENGKARENG,14617,340,13627,291,359,699,2021-06-11
317506,JAKARTA TIMUR,CAKUNG,12607,152,12007,221,227,379,2021-06-11
317509,JAKARTA TIMUR,CIRACAS,10266,107,9768,200,191,298,2021-06-11
317108,JAKARTA PUSAT,JOHAR BARU,4477,78,4203,112,84,162,2021-06-11
317407,JAKARTA SELATAN,KEBAYORAN BARU,7234,118,6865,112,139,257,2021-06-11
317405,JAKARTA SELATAN,KEBAYORAN LAMA,10352,161,9797,205,189,350,2021-06-11
111111,Luar DKI & Proses Update,Luar DKI & Proses Update,143008,137,141294,1273,304,441,2021-06-11
317401,JAKARTA SELATAN,TEBET,8539,99,8154,161,125,224,2021-06-11
317202,JAKARTA UTARA,TANJUNG PRIOK,13430,203,12812,244,171,374,2021-06-11
317107,JAKARTA PUSAT,TANAH ABANG,6300,90,5980,125,105,195,2021-06-11
317304,JAKARTA BARAT,TAMBORA,6529,135,6096,137,161,296,2021-06-11
317303,JAKARTA BARAT,TAMAN SARI,4209,63,4030,70,46,109,2021-06-11
317402,JAKARTA SELATAN,SETIA BUDI,5965,92,5680,101,92,184,2021-06-11
317104,JAKARTA PUSAT,SENEN,4782,62,4544,99,77,139,2021-06-11
317102,JAKARTA PUSAT,SAWAH BESAR,4391,61,4186,86,58,119,2021-06-11
317410,JAKARTA SELATAN,PESANGGRAHAN,8088,73,7706,135,174,247,2021-06-11
317201,JAKARTA UTARA,PENJARINGAN,8983,203,8475,124,181,384,2021-06-11
317505,JAKARTA TIMUR,PASAR REBO,8770,79,8382,164,145,224,2021-06-11
317404,JAKARTA SELATAN,PASAR MINGGU,12386,144,11783,231,228,372,2021-06-11
317306,JAKARTA BARAT,KALI DERES,8793,149,8298,160,186,335,2021-06-11
317408,JAKARTA SELATAN,PANCORAN,6992,80,6657,119,136,216,2021-06-11
317205,JAKARTA UTARA,PADEMANGAN,5803,61,5466,92,184,245,2021-06-11
317106,JAKARTA PUSAT,MENTENG,3470,47,3301,71,51,98,2021-06-11
317501,JAKARTA TIMUR,MATRAMAN,6821,62,6478,154,127,189,2021-06-11
317403,JAKARTA SELATAN,MAMPANG PRAPATAN,6198,72,5912,106,108,180,2021-06-11
317508,JAKARTA TIMUR,MAKASAR,9358,129,8941,164,124,253,2021-06-11
317504,JAKARTA TIMUR,KRAMAT JATI,10943,152,10377,205,209,361,2021-06-11
317203,JAKARTA UTARA,KOJA,9011,130,8638,174,69,199,2021-06-11
310101,KAB.ADM.KEP.SERIBU,KEP. SERIBU UTARA,336,0,331,5,0,0,2021-06-11
310102,KAB.ADM.KEP.SERIBU,KEP. SERIBU SELATAN,246,0,241,3,2,2,2021-06-11
317308,JAKARTA BARAT,KEMBANGAN,9947,133,9424,140,250,383,2021-06-11
317103,JAKARTA PUSAT,KEMAYORAN,10754,177,10200,195,182,359,2021-06-11
317206,JAKARTA UTARA,KELAPA GADING,6463,68,6171,105,119,187,2021-06-11
317305,JAKARTA BARAT,KEBON JERUK,11545,167,10875,202,301,468,2021-06-11
317307,JAKARTA BARAT,PALMERAH,8500,144,7965,183,208,352,2021-06-11
317502,JAKARTA TIMUR,PULO GADUNG,10875,169,10321,206,179,348,2021-06-11
111111,Luar DKI & Proses Update,Luar DKI & Proses Update,143008,137,141294,1273,304,441,2021-06-12
317501,JAKARTA TIMUR,MATRAMAN,6885,68,6489,154,174,242,2021-06-12
317102,JAKARTA PUSAT,SAWAH BESAR,4426,71,4189,86,80,151,2021-06-12
317308,JAKARTA BARAT,KEMBANGAN,10013,146,9433,140,294,440,2021-06-12
310102,KAB.ADM.KEP.SERIBU,KEP. SERIBU SELATAN,246,0,241,3,2,2,2021-06-12
310101,KAB.ADM.KEP.SERIBU,KEP. SERIBU UTARA,337,1,331,5,0,1,2021-06-12
317203,JAKARTA UTARA,KOJA,9045,139,8645,174,87,226,2021-06-12
317504,JAKARTA TIMUR,KRAMAT JATI,10997,157,10396,205,239,396,2021-06-12
317508,JAKARTA TIMUR,MAKASAR,9416,152,8953,164,147,299,2021-06-12
317103,JAKARTA PUSAT,KEMAYORAN,10815,194,10216,196,209,403,2021-06-12
317403,JAKARTA SELATAN,MAMPANG PRAPATAN,6218,75,5921,106,116,191,2021-06-12
317205,JAKARTA UTARA,PADEMANGAN,5849,68,5500,92,189,257,2021-06-12
317307,JAKARTA BARAT,PALMERAH,8568,154,7983,183,248,402,2021-06-12
317408,JAKARTA SELATAN,PANCORAN,7012,82,6663,119,148,230,2021-06-12
317404,JAKARTA SELATAN,PASAR MINGGU,12441,145,11812,231,253,398,2021-06-12
317505,JAKARTA TIMUR,PASAR REBO,8821,91,8393,166,171,262,2021-06-12
317201,JAKARTA UTARA,PENJARINGAN,9042,219,8492,124,207,426,2021-06-12
317106,JAKARTA PUSAT,MENTENG,3503,50,3308,71,74,124,2021-06-12
317206,JAKARTA UTARA,KELAPA GADING,6500,81,6177,107,135,216,2021-06-12
317305,JAKARTA BARAT,KEBON JERUK,11631,209,10884,202,336,545,2021-06-12
317405,JAKARTA SELATAN,KEBAYORAN LAMA,10423,179,9810,205,229,408,2021-06-12
317506,JAKARTA TIMUR,CAKUNG,12671,171,12020,221,259,430,2021-06-12
317105,JAKARTA PUSAT,CEMPAKA PUTIH,5396,83,5125,91,97,180,2021-06-12
317301,JAKARTA BARAT,CENGKARENG,14743,384,13646,293,420,804,2021-06-12
317406,JAKARTA SELATAN,CILANDAK,9030,100,8610,144,176,276,2021-06-12
317204,JAKARTA UTARA,CILINCING,8545,144,8058,174,169,313,2021-06-12
317510,JAKARTA TIMUR,CIPAYUNG,11505,112,10906,140,347,459,2021-06-12
317509,JAKARTA TIMUR,CIRACAS,10326,123,9791,200,212,335,2021-06-12
317507,JAKARTA TIMUR,DUREN SAWIT,15490,193,14701,323,273,466,2021-06-12
317101,JAKARTA PUSAT,GAMBIR,4216,63,3961,70,122,185,2021-06-12
317302,JAKARTA BARAT,GROGOL PETAMBURAN,9109,157,8582,178,192,349,2021-06-12
317409,JAKARTA SELATAN,JAGAKARSA,12872,143,12200,209,320,463,2021-06-12
317503,JAKARTA TIMUR,JATINEGARA,9704,103,9218,193,190,293,2021-06-12
317108,JAKARTA PUSAT,JOHAR BARU,4504,87,4210,112,95,182,2021-06-12
317306,JAKARTA BARAT,KALI DERES,8842,169,8310,160,203,372,2021-06-12
317407,JAKARTA SELATAN,KEBAYORAN BARU,7258,124,6872,112,150,274,2021-06-12
317410,JAKARTA SELATAN,PESANGGRAHAN,8149,98,7713,135,203,301,2021-06-12
317502,JAKARTA TIMUR,PULO GADUNG,10942,180,10338,206,218,398,2021-06-12
317104,JAKARTA PUSAT,SENEN,4814,77,4548,100,89,166,2021-06-12
317401,JAKARTA SELATAN,TEBET,8584,97,8165,161,161,258,2021-06-12
317202,JAKARTA UTARA,TANJUNG PRIOK,13487,216,12841,245,185,401,2021-06-12
317107,JAKARTA PUSAT,TANAH ABANG,6344,97,5984,126,137,234,2021-06-12
317304,JAKARTA BARAT,TAMBORA,6571,153,6100,137,181,334,2021-06-12
317303,JAKARTA BARAT,TAMAN SARI,4238,79,4032,70,57,136,2021-06-12
317402,JAKARTA SELATAN,SETIA BUDI,5986,95,5688,101,102,197,2021-06-12
317408,JAKARTA SELATAN,PANCORAN,7059,89,6686,119,165,254,2021-06-13
317409,JAKARTA SELATAN,JAGAKARSA,12960,153,12215,209,383,536,2021-06-13
317503,JAKARTA TIMUR,JATINEGARA,9742,103,9240,193,206,309,2021-06-13
317108,JAKARTA PUSAT,JOHAR BARU,4523,90,4237,112,84,174,2021-06-13
317306,JAKARTA BARAT,KALI DERES,8907,191,8337,160,219,410,2021-06-13
317407,JAKARTA SELATAN,KEBAYORAN BARU,7300,123,6886,112,179,302,2021-06-13
317405,JAKARTA SELATAN,KEBAYORAN LAMA,10506,188,9837,205,276,464,2021-06-13
317302,JAKARTA BARAT,GROGOL PETAMBURAN,9165,160,8605,178,222,382,2021-06-13
317305,JAKARTA BARAT,KEBON JERUK,11732,233,10914,202,383,616,2021-06-13
317103,JAKARTA PUSAT,KEMAYORAN,10895,210,10241,196,248,458,2021-06-13
317308,JAKARTA BARAT,KEMBANGAN,10102,160,9451,141,350,510,2021-06-13
310102,KAB.ADM.KEP.SERIBU,KEP. SERIBU SELATAN,246,0,241,3,2,2,2021-06-13
310101,KAB.ADM.KEP.SERIBU,KEP. SERIBU UTARA,339,1,331,5,2,3,2021-06-13
317203,JAKARTA UTARA,KOJA,9097,176,8657,174,90,266,2021-06-13
317504,JAKARTA TIMUR,KRAMAT JATI,11066,164,10415,205,282,446,2021-06-13
317508,JAKARTA TIMUR,MAKASAR,9475,181,8965,164,165,346,2021-06-13
317403,JAKARTA SELATAN,MAMPANG PRAPATAN,6250,81,5931,106,132,213,2021-06-13
317501,JAKARTA TIMUR,MATRAMAN,6912,76,6500,154,182,258,2021-06-13
317106,JAKARTA PUSAT,MENTENG,3519,57,3308,72,82,139,2021-06-13
317205,JAKARTA UTARA,PADEMANGAN,5900,81,5524,93,202,283,2021-06-13
317307,JAKARTA BARAT,PALMERAH,8631,167,8002,183,279,446,2021-06-13
317206,JAKARTA UTARA,KELAPA GADING,6537,90,6185,107,155,245,2021-06-13
317101,JAKARTA PUSAT,GAMBIR,4255,70,3978,70,137,207,2021-06-13
317510,JAKARTA TIMUR,CIPAYUNG,11583,117,10930,140,396,513,2021-06-13
317509,JAKARTA TIMUR,CIRACAS,10411,128,9804,200,279,407,2021-06-13
317404,JAKARTA SELATAN,PASAR MINGGU,12497,155,11826,231,285,440,2021-06-13
317505,JAKARTA TIMUR,PASAR REBO,8878,107,8401,166,204,311,2021-06-13
317201,JAKARTA UTARA,PENJARINGAN,9114,239,8511,124,240,479,2021-06-13
317410,JAKARTA SELATAN,PESANGGRAHAN,8209,112,7719,135,243,355,2021-06-13
317502,JAKARTA TIMUR,PULO GADUNG,10968,183,10355,206,224,407,2021-06-13
317102,JAKARTA PUSAT,SAWAH BESAR,4450,84,4193,87,86,170,2021-06-13
317104,JAKARTA PUSAT,SENEN,4848,87,4558,100,103,190,2021-06-13
317402,JAKARTA SELATAN,SETIA BUDI,6024,108,5702,102,112,220,2021-06-13
317303,JAKARTA BARAT,TAMAN SARI,4270,96,4035,72,67,163,2021-06-13
317507,JAKARTA TIMUR,DUREN SAWIT,15554,213,14736,323,282,495,2021-06-13
317304,JAKARTA BARAT,TAMBORA,6622,179,6120,137,186,365,2021-06-13
317202,JAKARTA UTARA,TANJUNG PRIOK,13569,229,12861,245,234,463,2021-06-13
317401,JAKARTA SELATAN,TEBET,8631,117,8179,162,173,290,2021-06-13
111111,Luar DKI & Proses Update,Luar DKI & Proses Update,143008,137,141294,1273,304,441,2021-06-13
317506,JAKARTA TIMUR,CAKUNG,12725,185,12054,221,265,450,2021-06-13
317105,JAKARTA PUSAT,CEMPAKA PUTIH,5430,85,5129,93,123,208,2021-06-13
317301,JAKARTA BARAT,CENGKARENG,14862,419,13670,294,479,898,2021-06-13
317406,JAKARTA SELATAN,CILANDAK,9095,109,8618,145,223,332,2021-06-13
317204,JAKARTA UTARA,CILINCING,8576,147,8097,174,158,305,2021-06-13
317107,JAKARTA PUSAT,TANAH ABANG,6391,110,5993,127,161,271,2021-06-13
111111,Luar DKI & Proses Update,Luar DKI & Proses Update,143008,137,141294,1273,304,441,2021-06-14
317202,JAKARTA UTARA,TANJUNG PRIOK,13657,244,12892,247,274,518,2021-06-14
317401,JAKARTA SELATAN,TEBET,8704,133,8189,162,220,353,2021-06-14
317107,JAKARTA PUSAT,TANAH ABANG,6434,117,6011,128,178,295,2021-06-14
317408,JAKARTA SELATAN,PANCORAN,7114,95,6689,120,210,305,2021-06-14
317303,JAKARTA BARAT,TAMAN SARI,4290,101,4047,72,70,171,2021-06-14
317404,JAKARTA SELATAN,PASAR MINGGU,12561,164,11848,232,317,481,2021-06-14
317307,JAKARTA BARAT,PALMERAH,8664,174,8026,183,281,455,2021-06-14
317205,JAKARTA UTARA,PADEMANGAN,5947,93,5583,93,178,271,2021-06-14
317106,JAKARTA PUSAT,MENTENG,3545,61,3313,73,98,159,2021-06-14
317501,JAKARTA TIMUR,MATRAMAN,6955,77,6503,155,220,297,2021-06-14
317403,JAKARTA SELATAN,MAMPANG PRAPATAN,6287,84,5939,106,158,242,2021-06-14
317508,JAKARTA TIMUR,MAKASAR,9524,194,8986,165,179,373,2021-06-14
317504,JAKARTA TIMUR,KRAMAT JATI,11141,169,10437,205,330,499,2021-06-14
317203,JAKARTA UTARA,KOJA,9164,196,8666,174,128,324,2021-06-14
310101,KAB.ADM.KEP.SERIBU,KEP. SERIBU UTARA,338,2,331,5,0,2,2021-06-14
310102,KAB.ADM.KEP.SERIBU,KEP. SERIBU SELATAN,246,0,241,3,2,2,2021-06-14
317308,JAKARTA BARAT,KEMBANGAN,10173,180,9469,142,382,562,2021-06-14
317103,JAKARTA PUSAT,KEMAYORAN,10924,210,10279,196,239,449,2021-06-14
317206,JAKARTA UTARA,KELAPA GADING,6580,106,6198,107,169,275,2021-06-14
317305,JAKARTA BARAT,KEBON JERUK,11805,247,10941,202,415,662,2021-06-14
317405,JAKARTA SELATAN,KEBAYORAN LAMA,10582,200,9854,207,321,521,2021-06-14
317407,JAKARTA SELATAN,KEBAYORAN BARU,7337,116,6915,112,194,310,2021-06-14
317506,JAKARTA TIMUR,CAKUNG,12786,208,12083,221,274,482,2021-06-14
317105,JAKARTA PUSAT,CEMPAKA PUTIH,5463,94,5132,93,144,238,2021-06-14
317301,JAKARTA BARAT,CENGKARENG,15013,451,13749,300,513,964,2021-06-14
317406,JAKARTA SELATAN,CILANDAK,9159,119,8647,145,248,367,2021-06-14
317204,JAKARTA UTARA,CILINCING,8662,151,8126,174,211,362,2021-06-14
317510,JAKARTA TIMUR,CIPAYUNG,11688,131,10962,141,454,585,2021-06-14
317304,JAKARTA BARAT,TAMBORA,6669,183,6151,137,198,381,2021-06-14
317509,JAKARTA TIMUR,CIRACAS,10479,133,9814,203,329,462,2021-06-14
317101,JAKARTA PUSAT,GAMBIR,4273,75,3994,70,134,209,2021-06-14
317302,JAKARTA BARAT,GROGOL PETAMBURAN,9200,169,8620,179,232,401,2021-06-14
317409,JAKARTA SELATAN,JAGAKARSA,13032,159,12247,213,413,572,2021-06-14
317503,JAKARTA TIMUR,JATINEGARA,9794,105,9253,195,241,346,2021-06-14
317108,JAKARTA PUSAT,JOHAR BARU,4544,95,4250,112,87,182,2021-06-14
317306,JAKARTA BARAT,KALI DERES,8977,199,8368,161,249,448,2021-06-14
317507,JAKARTA TIMUR,DUREN SAWIT,15640,231,14751,324,334,565,2021-06-14
317201,JAKARTA UTARA,PENJARINGAN,9181,252,8541,125,263,515,2021-06-14
317505,JAKARTA TIMUR,PASAR REBO,8945,118,8416,166,245,363,2021-06-14
317502,JAKARTA TIMUR,PULO GADUNG,11044,194,10376,206,268,462,2021-06-14
317104,JAKARTA PUSAT,SENEN,4881,91,4569,100,121,212,2021-06-14
317410,JAKARTA SELATAN,PESANGGRAHAN,8272,114,7732,135,291,405,2021-06-14
317102,JAKARTA PUSAT,SAWAH BESAR,4479,88,4205,88,98,186,2021-06-14
317402,JAKARTA SELATAN,SETIA BUDI,6049,96,5728,103,122,218,2021-06-14
317506,JAKARTA TIMUR,CAKUNG,12832,211,12095,223,303,514,2021-06-15
317105,JAKARTA PUSAT,CEMPAKA PUTIH,5465,99,5163,93,110,209,2021-06-15
317301,JAKARTA BARAT,CENGKARENG,15060,455,13833,302,470,925,2021-06-15
317406,JAKARTA SELATAN,CILANDAK,9190,129,8673,146,242,371,2021-06-15
317204,JAKARTA UTARA,CILINCING,8681,163,8136,174,208,371,2021-06-15
317108,JAKARTA PUSAT,JOHAR BARU,4555,88,4269,112,86,174,2021-06-15
317509,JAKARTA TIMUR,CIRACAS,10506,146,9827,204,329,475,2021-06-15
317507,JAKARTA TIMUR,DUREN SAWIT,15686,240,14814,324,308,548,2021-06-15
317101,JAKARTA PUSAT,GAMBIR,4296,89,4007,70,130,219,2021-06-15
317302,JAKARTA BARAT,GROGOL PETAMBURAN,9258,170,8653,179,256,426,2021-06-15
317409,JAKARTA SELATAN,JAGAKARSA,13071,162,12310,213,386,548,2021-06-15
317503,JAKARTA TIMUR,JATINEGARA,9823,118,9274,195,236,354,2021-06-15
317307,JAKARTA BARAT,PALMERAH,8678,163,8085,185,245,408,2021-06-15
317407,JAKARTA SELATAN,KEBAYORAN BARU,7355,112,6935,113,195,307,2021-06-15
317405,JAKARTA SELATAN,KEBAYORAN LAMA,10622,210,9898,207,307,517,2021-06-15
111111,Luar DKI & Proses Update,Luar DKI & Proses Update,143008,137,141294,1273,304,441,2021-06-15
317205,JAKARTA UTARA,PADEMANGAN,5978,113,5621,94,150,263,2021-06-15
317106,JAKARTA PUSAT,MENTENG,3551,60,3319,74,98,158,2021-06-15
317501,JAKARTA TIMUR,MATRAMAN,6968,86,6509,155,218,304,2021-06-15
317403,JAKARTA SELATAN,MAMPANG PRAPATAN,6299,75,5961,106,157,232,2021-06-15
317508,JAKARTA TIMUR,MAKASAR,9586,214,8998,166,208,422,2021-06-15
317306,JAKARTA BARAT,KALI DERES,9001,199,8404,163,235,434,2021-06-15
317504,JAKARTA TIMUR,KRAMAT JATI,11173,181,10458,207,327,508,2021-06-15
310101,KAB.ADM.KEP.SERIBU,KEP. SERIBU UTARA,338,2,331,5,0,2,2021-06-15
310102,KAB.ADM.KEP.SERIBU,KEP. SERIBU SELATAN,247,0,241,3,3,3,2021-06-15
317308,JAKARTA BARAT,KEMBANGAN,10208,195,9516,142,355,550,2021-06-15
317103,JAKARTA PUSAT,KEMAYORAN,10984,194,10338,196,256,450,2021-06-15
317206,JAKARTA UTARA,KELAPA GADING,6622,111,6212,107,192,303,2021-06-15
317305,JAKARTA BARAT,KEBON JERUK,11832,247,10998,203,384,631,2021-06-15
317203,JAKARTA UTARA,KOJA,9190,206,8684,174,126,332,2021-06-15
317510,JAKARTA TIMUR,CIPAYUNG,11712,145,10966,143,458,603,2021-06-15
317408,JAKARTA SELATAN,PANCORAN,7147,93,6721,120,213,306,2021-06-15
317107,JAKARTA PUSAT,TANAH ABANG,6449,121,6028,128,172,293,2021-06-15
317401,JAKARTA SELATAN,TEBET,8731,137,8212,162,220,357,2021-06-15
317202,JAKARTA UTARA,TANJUNG PRIOK,13698,256,12910,248,284,540,2021-06-15
317304,JAKARTA BARAT,TAMBORA,6712,189,6195,137,191,380,2021-06-15
317303,JAKARTA BARAT,TAMAN SARI,4311,110,4066,73,62,172,2021-06-15
317104,JAKARTA PUSAT,SENEN,4888,94,4574,100,120,214,2021-06-15
317402,JAKARTA SELATAN,SETIA BUDI,6058,101,5740,103,114,215,2021-06-15
317502,JAKARTA TIMUR,PULO GADUNG,11081,213,10400,207,261,474,2021-06-15
317410,JAKARTA SELATAN,PESANGGRAHAN,8294,125,7762,135,272,397,2021-06-15
317201,JAKARTA UTARA,PENJARINGAN,9229,267,8566,125,271,538,2021-06-15
317505,JAKARTA TIMUR,PASAR REBO,8964,123,8423,167,251,374,2021-06-15
317404,JAKARTA SELATAN,PASAR MINGGU,12623,155,11886,232,350,505,2021-06-15
317102,JAKARTA PUSAT,SAWAH BESAR,4510,103,4209,89,109,212,2021-06-15
317508,JAKARTA TIMUR,MAKASAR,9626,228,9017,166,215,443,2021-06-16
317501,JAKARTA TIMUR,MATRAMAN,6985,85,6540,155,205,290,2021-06-16
317403,JAKARTA SELATAN,MAMPANG PRAPATAN,6327,73,5995,106,153,226,2021-06-16
317504,JAKARTA TIMUR,KRAMAT JATI,11225,195,10514,208,308,503,2021-06-16
317404,JAKARTA SELATAN,PASAR MINGGU,12670,173,11923,232,342,515,2021-06-16
310101,KAB.ADM.KEP.SERIBU,KEP. SERIBU UTARA,338,2,331,5,0,2,2021-06-16
310102,KAB.ADM.KEP.SERIBU,KEP. SERIBU SELATAN,246,0,241,3,2,2,2021-06-16
317106,JAKARTA PUSAT,MENTENG,3564,59,3330,74,101,160,2021-06-16
317203,JAKARTA UTARA,KOJA,9229,211,8711,174,133,344,2021-06-16
317205,JAKARTA UTARA,PADEMANGAN,5992,115,5638,94,145,260,2021-06-16
317107,JAKARTA PUSAT,TANAH ABANG,6471,119,6046,129,177,296,2021-06-16
317104,JAKARTA PUSAT,SENEN,4948,100,4591,100,157,257,2021-06-16
317307,JAKARTA BARAT,PALMERAH,8776,169,8105,186,316,485,2021-06-16
317402,JAKARTA SELATAN,SETIA BUDI,6088,104,5757,104,123,227,2021-06-16
317303,JAKARTA BARAT,TAMAN SARI,4333,124,4069,74,66,190,2021-06-16
317304,JAKARTA BARAT,TAMBORA,6763,206,6212,139,206,412,2021-06-16
317308,JAKARTA BARAT,KEMBANGAN,10341,215,9548,143,435,650,2021-06-16
317202,JAKARTA UTARA,TANJUNG PRIOK,13752,264,12954,248,286,550,2021-06-16
317401,JAKARTA SELATAN,TEBET,8770,153,8219,163,235,388,2021-06-16
317505,JAKARTA TIMUR,PASAR REBO,8995,139,8439,168,249,388,2021-06-16
317502,JAKARTA TIMUR,PULO GADUNG,11158,242,10448,210,258,500,2021-06-16
317103,JAKARTA PUSAT,KEMAYORAN,11038,217,10365,199,257,474,2021-06-16
317102,JAKARTA PUSAT,SAWAH BESAR,4550,126,4217,90,117,243,2021-06-16
317305,JAKARTA BARAT,KEBON JERUK,11970,284,11019,207,460,744,2021-06-16
317506,JAKARTA TIMUR,CAKUNG,12875,221,12155,223,276,497,2021-06-16
317206,JAKARTA UTARA,KELAPA GADING,6658,121,6230,107,200,321,2021-06-16
317105,JAKARTA PUSAT,CEMPAKA PUTIH,5498,94,5167,93,144,238,2021-06-16
317301,JAKARTA BARAT,CENGKARENG,15229,509,13875,303,542,1051,2021-06-16
317406,JAKARTA SELATAN,CILANDAK,9234,143,8686,146,259,402,2021-06-16
317204,JAKARTA UTARA,CILINCING,8702,173,8149,175,205,378,2021-06-16
317510,JAKARTA TIMUR,CIPAYUNG,11746,139,11027,143,437,576,2021-06-16
317509,JAKARTA TIMUR,CIRACAS,10538,166,9874,205,293,459,2021-06-16
317507,JAKARTA TIMUR,DUREN SAWIT,15755,263,14846,324,322,585,2021-06-16
317101,JAKARTA PUSAT,GAMBIR,4325,93,4018,70,144,237,2021-06-16
317408,JAKARTA SELATAN,PANCORAN,7172,100,6742,121,209,309,2021-06-16
317302,JAKARTA BARAT,GROGOL PETAMBURAN,9331,213,8675,179,264,477,2021-06-16
317306,JAKARTA BARAT,KALI DERES,9044,215,8428,164,237,452,2021-06-16
317108,JAKARTA PUSAT,JOHAR BARU,4577,93,4278,112,94,187,2021-06-16
111111,Luar DKI & Proses Update,Luar DKI & Proses Update,143008,137,141294,1273,304,441,2021-06-16
317405,JAKARTA SELATAN,KEBAYORAN LAMA,10687,231,9934,207,315,546,2021-06-16
317201,JAKARTA UTARA,PENJARINGAN,9317,301,8616,126,274,575,2021-06-16
317503,JAKARTA TIMUR,JATINEGARA,9842,118,9307,195,222,340,2021-06-16
317409,JAKARTA SELATAN,JAGAKARSA,13105,165,12338,217,385,550,2021-06-16
317410,JAKARTA SELATAN,PESANGGRAHAN,8344,136,7794,135,279,415,2021-06-16
317407,JAKARTA SELATAN,KEBAYORAN BARU,7404,120,6957,113,214,334,2021-06-16
317106,JAKARTA PUSAT,MENTENG,3623,77,3347,74,125,202,2021-06-17
310101,KAB.ADM.KEP.SERIBU,KEP. SERIBU UTARA,342,2,331,5,4,6,2021-06-17
317203,JAKARTA UTARA,KOJA,9249,206,8747,175,121,327,2021-06-17
317504,JAKARTA TIMUR,KRAMAT JATI,11382,195,10566,210,411,606,2021-06-17
317508,JAKARTA TIMUR,MAKASAR,9757,258,9060,167,272,530,2021-06-17
317403,JAKARTA SELATAN,MAMPANG PRAPATAN,6381,75,6010,106,190,265,2021-06-17
317501,JAKARTA TIMUR,MATRAMAN,7066,93,6585,156,232,325,2021-06-17
317404,JAKARTA SELATAN,PASAR MINGGU,12786,206,11972,233,375,581,2021-06-17
317307,JAKARTA BARAT,PALMERAH,8856,178,8141,188,349,527,2021-06-17
317408,JAKARTA SELATAN,PANCORAN,7241,117,6763,122,239,356,2021-06-17
310102,KAB.ADM.KEP.SERIBU,KEP. SERIBU SELATAN,247,0,241,3,3,3,2021-06-17
317505,JAKARTA TIMUR,PASAR REBO,9102,169,8462,169,302,471,2021-06-17
317201,JAKARTA UTARA,PENJARINGAN,9414,308,8686,126,294,602,2021-06-17
317410,JAKARTA SELATAN,PESANGGRAHAN,8422,146,7833,135,308,454,2021-06-17
317502,JAKARTA TIMUR,PULO GADUNG,11243,254,10477,210,302,556,2021-06-17
317102,JAKARTA PUSAT,SAWAH BESAR,4597,129,4231,91,146,275,2021-06-17
317205,JAKARTA UTARA,PADEMANGAN,6047,104,5680,94,169,273,2021-06-17
317308,JAKARTA BARAT,KEMBANGAN,10463,247,9595,144,477,724,2021-06-17
317405,JAKARTA SELATAN,KEBAYORAN LAMA,10793,241,10009,207,336,577,2021-06-17
317206,JAKARTA UTARA,KELAPA GADING,6677,121,6257,107,192,313,2021-06-17
317506,JAKARTA TIMUR,CAKUNG,12972,227,12205,226,314,541,2021-06-17
317105,JAKARTA PUSAT,CEMPAKA PUTIH,5547,106,5177,94,170,276,2021-06-17
317301,JAKARTA BARAT,CENGKARENG,15465,544,14027,307,587,1131,2021-06-17
317406,JAKARTA SELATAN,CILANDAK,9314,149,8712,147,306,455,2021-06-17
317204,JAKARTA UTARA,CILINCING,8746,157,8198,176,215,372,2021-06-17
317510,JAKARTA TIMUR,CIPAYUNG,11923,173,11100,145,505,678,2021-06-17
317509,JAKARTA TIMUR,CIRACAS,10701,176,9916,206,403,579,2021-06-17
317103,JAKARTA PUSAT,KEMAYORAN,11097,235,10402,201,259,494,2021-06-17
317507,JAKARTA TIMUR,DUREN SAWIT,15942,277,14899,326,440,717,2021-06-17
317409,JAKARTA SELATAN,JAGAKARSA,13275,191,12397,219,468,659,2021-06-17
317503,JAKARTA TIMUR,JATINEGARA,9962,138,9352,196,276,414,2021-06-17
317108,JAKARTA PUSAT,JOHAR BARU,4639,108,4298,112,121,229,2021-06-17
317306,JAKARTA BARAT,KALI DERES,9166,244,8478,166,278,522,2021-06-17
317407,JAKARTA SELATAN,KEBAYORAN BARU,7494,118,7003,114,259,377,2021-06-17
317104,JAKARTA PUSAT,SENEN,4973,115,4605,100,153,268,2021-06-17
317305,JAKARTA BARAT,KEBON JERUK,12083,308,11072,211,492,800,2021-06-17
317101,JAKARTA PUSAT,GAMBIR,4404,125,4052,72,155,280,2021-06-17
317302,JAKARTA BARAT,GROGOL PETAMBURAN,9419,250,8725,180,264,514,2021-06-17
317402,JAKARTA SELATAN,SETIA BUDI,6142,110,5778,105,149,259,2021-06-17
317304,JAKARTA BARAT,TAMBORA,6811,205,6263,140,203,408,2021-06-17
317107,JAKARTA PUSAT,TANAH ABANG,6528,118,6074,129,207,325,2021-06-17
317202,JAKARTA UTARA,TANJUNG PRIOK,13856,260,13021,249,326,586,2021-06-17
317401,JAKARTA SELATAN,TEBET,8852,150,8263,163,276,426,2021-06-17
111111,Luar DKI & Proses Update,Luar DKI & Proses Update,143008,137,141294,1273,304,441,2021-06-17
317303,JAKARTA BARAT,TAMAN SARI,4370,127,4080,75,88,215,2021-06-17
317403,JAKARTA SELATAN,MAMPANG PRAPATAN,6454,76,6040,106,232,308,2021-06-18
317501,JAKARTA TIMUR,MATRAMAN,7092,98,6600,158,236,334,2021-06-18
317106,JAKARTA PUSAT,MENTENG,3609,62,3356,73,118,180,2021-06-18
317205,JAKARTA UTARA,PADEMANGAN,6122,111,5708,95,208,319,2021-06-18
317307,JAKARTA BARAT,PALMERAH,8955,164,8211,188,392,556,2021-06-18
317408,JAKARTA SELATAN,PANCORAN,7339,119,6798,122,300,419,2021-06-18
317404,JAKARTA SELATAN,PASAR MINGGU,12887,199,12048,236,404,603,2021-06-18
317505,JAKARTA TIMUR,PASAR REBO,9187,164,8529,172,322,486,2021-06-18
317201,JAKARTA UTARA,PENJARINGAN,9508,324,8770,128,286,610,2021-06-18
317102,JAKARTA PUSAT,SAWAH BESAR,4639,118,4254,92,175,293,2021-06-18
317502,JAKARTA TIMUR,PULO GADUNG,11416,278,10550,210,378,656,2021-06-18
317104,JAKARTA PUSAT,SENEN,5030,114,4634,101,181,295,2021-06-18
317402,JAKARTA SELATAN,SETIA BUDI,6217,113,5810,105,189,302,2021-06-18
317303,JAKARTA BARAT,TAMAN SARI,4415,122,4103,76,114,236,2021-06-18
317304,JAKARTA BARAT,TAMBORA,6871,199,6303,144,225,424,2021-06-18
317107,JAKARTA PUSAT,TANAH ABANG,6598,119,6094,129,256,375,2021-06-18
317202,JAKARTA UTARA,TANJUNG PRIOK,14037,289,13082,250,416,705,2021-06-18
317401,JAKARTA SELATAN,TEBET,8935,141,8309,165,320,461,2021-06-18
111111,Luar DKI & Proses Update,Luar DKI & Proses Update,143008,137,141294,1273,304,441,2021-06-18
317410,JAKARTA SELATAN,PESANGGRAHAN,8494,154,7856,136,348,502,2021-06-18
317508,JAKARTA TIMUR,MAKASAR,9853,257,9133,171,292,549,2021-06-18
317203,JAKARTA UTARA,KOJA,9405,250,8787,177,191,441,2021-06-18
310101,KAB.ADM.KEP.SERIBU,KEP. SERIBU UTARA,339,3,331,5,0,3,2021-06-18
317506,JAKARTA TIMUR,CAKUNG,13090,254,12250,227,359,613,2021-06-18
317105,JAKARTA PUSAT,CEMPAKA PUTIH,5592,127,5207,94,164,291,2021-06-18
317301,JAKARTA BARAT,CENGKARENG,15665,570,14110,309,676,1246,2021-06-18
317406,JAKARTA SELATAN,CILANDAK,9402,143,8761,148,350,493,2021-06-18
317204,JAKARTA UTARA,CILINCING,8883,179,8245,179,280,459,2021-06-18
317510,JAKARTA TIMUR,CIPAYUNG,12055,174,11202,147,532,706,2021-06-18
317509,JAKARTA TIMUR,CIRACAS,10860,167,9989,207,497,664,2021-06-18
317507,JAKARTA TIMUR,DUREN SAWIT,16115,280,14971,329,535,815,2021-06-18
317101,JAKARTA PUSAT,GAMBIR,4488,167,4082,74,165,332,2021-06-18
317504,JAKARTA TIMUR,KRAMAT JATI,11492,189,10668,212,423,612,2021-06-18
317302,JAKARTA BARAT,GROGOL PETAMBURAN,9538,259,8768,182,329,588,2021-06-18
317503,JAKARTA TIMUR,JATINEGARA,10069,143,9392,198,336,479,2021-06-18
317108,JAKARTA PUSAT,JOHAR BARU,4684,102,4323,112,147,249,2021-06-18
317306,JAKARTA BARAT,KALI DERES,9287,270,8519,167,331,601,2021-06-18
317407,JAKARTA SELATAN,KEBAYORAN BARU,7560,107,7049,114,290,397,2021-06-18
317405,JAKARTA SELATAN,KEBAYORAN LAMA,10903,238,10062,209,394,632,2021-06-18
317305,JAKARTA BARAT,KEBON JERUK,12206,304,11207,212,483,787,2021-06-18
317103,JAKARTA PUSAT,KEMAYORAN,11220,238,10453,206,323,561,2021-06-18
317308,JAKARTA BARAT,KEMBANGAN,10563,240,9692,146,485,725,2021-06-18
310102,KAB.ADM.KEP.SERIBU,KEP. SERIBU SELATAN,246,0,243,3,0,0,2021-06-18
317409,JAKARTA SELATAN,JAGAKARSA,13445,188,12440,220,597,785,2021-06-18
317206,JAKARTA UTARA,KELAPA GADING,6799,136,6301,108,254,390,2021-06-18
317308,JAKARTA BARAT,KEMBANGAN,10711,272,9745,148,546,818,2021-06-19
317304,JAKARTA BARAT,TAMBORA,6953,220,6329,144,260,480,2021-06-19
317402,JAKARTA SELATAN,SETIA BUDI,6283,125,5834,105,219,344,2021-06-19
317104,JAKARTA PUSAT,SENEN,5099,128,4655,102,214,342,2021-06-19
317102,JAKARTA PUSAT,SAWAH BESAR,4705,123,4274,94,214,337,2021-06-19
317502,JAKARTA TIMUR,PULO GADUNG,11540,292,10615,213,420,712,2021-06-19
317410,JAKARTA SELATAN,PESANGGRAHAN,8590,169,7905,139,377,546,2021-06-19
317206,JAKARTA UTARA,KELAPA GADING,6837,146,6345,108,238,384,2021-06-19
317505,JAKARTA TIMUR,PASAR REBO,9296,158,8560,172,406,564,2021-06-19
317404,JAKARTA SELATAN,PASAR MINGGU,13025,190,12112,237,486,676,2021-06-19
317408,JAKARTA SELATAN,PANCORAN,7413,113,6835,123,342,455,2021-06-19
317307,JAKARTA BARAT,PALMERAH,9039,177,8257,188,417,594,2021-06-19
317205,JAKARTA UTARA,PADEMANGAN,6177,129,5727,96,225,354,2021-06-19
317106,JAKARTA PUSAT,MENTENG,3640,60,3370,73,137,197,2021-06-19
317501,JAKARTA TIMUR,MATRAMAN,7159,124,6655,159,221,345,2021-06-19
317403,JAKARTA SELATAN,MAMPANG PRAPATAN,6541,76,6066,107,292,368,2021-06-19
317508,JAKARTA TIMUR,MAKASAR,9956,266,9170,173,347,613,2021-06-19
317504,JAKARTA TIMUR,KRAMAT JATI,11648,210,10710,213,515,725,2021-06-19
317203,JAKARTA UTARA,KOJA,9453,256,8832,178,187,443,2021-06-19
310101,KAB.ADM.KEP.SERIBU,KEP. SERIBU UTARA,343,4,331,5,3,7,2021-06-19
310102,KAB.ADM.KEP.SERIBU,KEP. SERIBU SELATAN,247,0,243,3,1,1,2021-06-19
317303,JAKARTA BARAT,TAMAN SARI,4439,130,4108,79,122,252,2021-06-19
317103,JAKARTA PUSAT,KEMAYORAN,11440,261,10529,206,444,705,2021-06-19
317201,JAKARTA UTARA,PENJARINGAN,9598,353,8770,130,345,698,2021-06-19
317202,JAKARTA UTARA,TANJUNG PRIOK,14219,329,13130,254,506,835,2021-06-19
317506,JAKARTA TIMUR,CAKUNG,13225,265,12331,228,401,666,2021-06-19
317105,JAKARTA PUSAT,CEMPAKA PUTIH,5645,113,5243,95,194,307,2021-06-19
317301,JAKARTA BARAT,CENGKARENG,15794,620,14206,314,654,1274,2021-06-19
317406,JAKARTA SELATAN,CILANDAK,9490,147,8827,150,366,513,2021-06-19
317204,JAKARTA UTARA,CILINCING,8936,192,8295,182,267,459,2021-06-19
317510,JAKARTA TIMUR,CIPAYUNG,12224,201,11255,149,619,820,2021-06-19
317509,JAKARTA TIMUR,CIRACAS,11003,193,10044,208,558,751,2021-06-19
317507,JAKARTA TIMUR,DUREN SAWIT,16266,293,15055,332,586,879,2021-06-19
317101,JAKARTA PUSAT,GAMBIR,4568,190,4114,74,190,380,2021-06-19
317302,JAKARTA BARAT,GROGOL PETAMBURAN,9631,290,8826,182,333,623,2021-06-19
317409,JAKARTA SELATAN,JAGAKARSA,13613,220,12533,224,636,856,2021-06-19
317503,JAKARTA TIMUR,JATINEGARA,10131,157,9433,199,342,499,2021-06-19
317108,JAKARTA PUSAT,JOHAR BARU,4728,93,4361,112,162,255,2021-06-19
317306,JAKARTA BARAT,KALI DERES,9445,308,8581,169,387,695,2021-06-19
317407,JAKARTA SELATAN,KEBAYORAN BARU,7634,111,7093,115,315,426,2021-06-19
317405,JAKARTA SELATAN,KEBAYORAN LAMA,11038,270,10109,210,449,719,2021-06-19
317305,JAKARTA BARAT,KEBON JERUK,12362,331,11274,214,543,874,2021-06-19
111111,Luar DKI & Proses Update,Luar DKI & Proses Update,143008,137,141294,1273,304,441,2021-06-19
317401,JAKARTA SELATAN,TEBET,9036,151,8348,166,371,522,2021-06-19
317107,JAKARTA PUSAT,TANAH ABANG,6654,123,6158,129,244,367,2021-06-19
111111,Luar DKI & Proses Update,Luar DKI & Proses Update,143008,137,141294,1273,304,441,2021-06-20
317503,JAKARTA TIMUR,JATINEGARA,10244,172,9485,199,388,560,2021-06-20
317202,JAKARTA UTARA,TANJUNG PRIOK,14414,361,13192,255,606,967,2021-06-20
317103,JAKARTA PUSAT,KEMAYORAN,11603,274,10597,207,525,799,2021-06-20
317206,JAKARTA UTARA,KELAPA GADING,6970,156,6379,108,327,483,2021-06-20
317305,JAKARTA BARAT,KEBON JERUK,12531,333,11378,215,605,938,2021-06-20
317405,JAKARTA SELATAN,KEBAYORAN LAMA,11179,303,10182,213,481,784,2021-06-20
317407,JAKARTA SELATAN,KEBAYORAN BARU,7693,118,7130,115,330,448,2021-06-20
317306,JAKARTA BARAT,KALI DERES,9564,325,8660,173,406,731,2021-06-20
317108,JAKARTA PUSAT,JOHAR BARU,4787,92,4383,112,200,292,2021-06-20
317409,JAKARTA SELATAN,JAGAKARSA,13791,227,12611,226,727,954,2021-06-20
317308,JAKARTA BARAT,KEMBANGAN,10850,285,9816,149,600,885,2021-06-20
317302,JAKARTA BARAT,GROGOL PETAMBURAN,9799,320,8891,184,404,724,2021-06-20
317507,JAKARTA TIMUR,DUREN SAWIT,16431,325,15134,337,635,960,2021-06-20
317509,JAKARTA TIMUR,CIRACAS,11164,196,10111,210,647,843,2021-06-20
317510,JAKARTA TIMUR,CIPAYUNG,12380,210,11350,152,668,878,2021-06-20
317204,JAKARTA UTARA,CILINCING,9127,198,8352,184,393,591,2021-06-20
317406,JAKARTA SELATAN,CILANDAK,9602,159,8860,150,433,592,2021-06-20
317301,JAKARTA BARAT,CENGKARENG,16011,625,14359,321,706,1331,2021-06-20
317105,JAKARTA PUSAT,CEMPAKA PUTIH,5710,116,5266,96,232,348,2021-06-20
317506,JAKARTA TIMUR,CAKUNG,13389,288,12400,234,467,755,2021-06-20
317101,JAKARTA PUSAT,GAMBIR,4609,195,4136,74,204,399,2021-06-20
310102,KAB.ADM.KEP.SERIBU,KEP. SERIBU SELATAN,247,0,243,3,1,1,2021-06-20
310101,KAB.ADM.KEP.SERIBU,KEP. SERIBU UTARA,350,3,332,5,10,13,2021-06-20
317203,JAKARTA UTARA,KOJA,9583,249,8873,179,282,531,2021-06-20
317107,JAKARTA PUSAT,TANAH ABANG,6724,149,6173,130,272,421,2021-06-20
317304,JAKARTA BARAT,TAMBORA,7039,219,6374,145,301,520,2021-06-20
317303,JAKARTA BARAT,TAMAN SARI,4518,140,4135,80,163,303,2021-06-20
317402,JAKARTA SELATAN,SETIA BUDI,6352,131,5861,106,254,385,2021-06-20
317104,JAKARTA PUSAT,SENEN,5165,127,4687,103,248,375,2021-06-20
317102,JAKARTA PUSAT,SAWAH BESAR,4769,131,4303,96,239,370,2021-06-20
317502,JAKARTA TIMUR,PULO GADUNG,11689,317,10671,214,487,804,2021-06-20
317410,JAKARTA SELATAN,PESANGGRAHAN,8649,180,7966,139,364,544,2021-06-20
317201,JAKARTA UTARA,PENJARINGAN,9784,429,8822,130,403,832,2021-06-20
317505,JAKARTA TIMUR,PASAR REBO,9411,186,8600,175,450,636,2021-06-20
317404,JAKARTA SELATAN,PASAR MINGGU,13158,223,12157,238,540,763,2021-06-20
317408,JAKARTA SELATAN,PANCORAN,7487,127,6869,123,368,495,2021-06-20
317307,JAKARTA BARAT,PALMERAH,9150,200,8331,190,429,629,2021-06-20
317205,JAKARTA UTARA,PADEMANGAN,6275,156,5745,96,278,434,2021-06-20
317106,JAKARTA PUSAT,MENTENG,3675,58,3377,74,166,224,2021-06-20
317501,JAKARTA TIMUR,MATRAMAN,7251,138,6672,162,279,417,2021-06-20
317403,JAKARTA SELATAN,MAMPANG PRAPATAN,6573,76,6097,107,293,369,2021-06-20
317508,JAKARTA TIMUR,MAKASAR,10104,280,9226,174,424,704,2021-06-20
317504,JAKARTA TIMUR,KRAMAT JATI,11845,248,10747,215,635,883,2021-06-20
317401,JAKARTA SELATAN,TEBET,9151,167,8378,168,438,605,2021-06-20
111111,Luar DKI & Proses Update,Luar DKI & Proses Update,143008,137,141294,1273,304,441,2021-06-21
317502,JAKARTA TIMUR,PULO GADUNG,11884,326,10752,215,591,917,2021-06-21
317404,JAKARTA SELATAN,PASAR MINGGU,13302,224,12234,240,604,828,2021-06-21
317504,JAKARTA TIMUR,KRAMAT JATI,12029,267,10840,216,706,973,2021-06-21
317508,JAKARTA TIMUR,MAKASAR,10238,278,9304,175,481,759,2021-06-21
317501,JAKARTA TIMUR,MATRAMAN,7296,146,6740,165,245,391,2021-06-21
317106,JAKARTA PUSAT,MENTENG,3716,61,3405,76,174,235,2021-06-21
317205,JAKARTA UTARA,PADEMANGAN,6306,140,5807,96,263,403,2021-06-21
317307,JAKARTA BARAT,PALMERAH,9213,208,8413,192,400,608,2021-06-21
317408,JAKARTA SELATAN,PANCORAN,7563,128,6904,125,406,534,2021-06-21
317505,JAKARTA TIMUR,PASAR REBO,9533,185,8661,178,509,694,2021-06-21
317203,JAKARTA UTARA,KOJA,9702,242,8942,179,339,581,2021-06-21
317201,JAKARTA UTARA,PENJARINGAN,9917,443,8913,133,428,871,2021-06-21
317102,JAKARTA PUSAT,SAWAH BESAR,4811,111,4355,96,249,360,2021-06-21
317104,JAKARTA PUSAT,SENEN,5238,125,4715,103,295,420,2021-06-21
317402,JAKARTA SELATAN,SETIA BUDI,6439,134,5891,107,307,441,2021-06-21
317303,JAKARTA BARAT,TAMAN SARI,4548,125,4176,80,167,292,2021-06-21
317304,JAKARTA BARAT,TAMBORA,7152,213,6441,146,352,565,2021-06-21
317107,JAKARTA PUSAT,TANAH ABANG,6796,149,6234,132,281,430,2021-06-21
317202,JAKARTA UTARA,TANJUNG PRIOK,14625,402,13265,258,700,1102,2021-06-21
317401,JAKARTA SELATAN,TEBET,9241,152,8453,171,465,617,2021-06-21
317410,JAKARTA SELATAN,PESANGGRAHAN,8759,167,8026,143,423,590,2021-06-21
310101,KAB.ADM.KEP.SERIBU,KEP. SERIBU UTARA,352,2,333,5,12,14,2021-06-21
317403,JAKARTA SELATAN,MAMPANG PRAPATAN,6650,78,6131,108,333,411,2021-06-21
317308,JAKARTA BARAT,KEMBANGAN,11004,313,9909,150,632,945,2021-06-21
317506,JAKARTA TIMUR,CAKUNG,13505,289,12484,237,495,784,2021-06-21
317105,JAKARTA PUSAT,CEMPAKA PUTIH,5769,122,5296,96,255,377,2021-06-21
317301,JAKARTA BARAT,CENGKARENG,16265,648,14511,326,780,1428,2021-06-21
317406,JAKARTA SELATAN,CILANDAK,9669,166,8920,152,431,597,2021-06-21
317204,JAKARTA UTARA,CILINCING,9281,229,8377,185,490,719,2021-06-21
317510,JAKARTA TIMUR,CIPAYUNG,12588,220,11438,154,776,996,2021-06-21
310102,KAB.ADM.KEP.SERIBU,KEP. SERIBU SELATAN,247,0,243,3,1,1,2021-06-21
317507,JAKARTA TIMUR,DUREN SAWIT,16669,330,15217,339,783,1113,2021-06-21
317101,JAKARTA PUSAT,GAMBIR,4680,196,4155,77,252,448,2021-06-21
317302,JAKARTA BARAT,GROGOL PETAMBURAN,9960,363,8951,184,462,825,2021-06-21
317509,JAKARTA TIMUR,CIRACAS,11350,224,10194,211,721,945,2021-06-21
317103,JAKARTA PUSAT,KEMAYORAN,11674,285,10660,210,519,804,2021-06-21
317503,JAKARTA TIMUR,JATINEGARA,10347,188,9523,201,435,623,2021-06-21
317108,JAKARTA PUSAT,JOHAR BARU,4842,90,4405,112,235,325,2021-06-21
317306,JAKARTA BARAT,KALI DERES,9677,330,8711,175,461,791,2021-06-21
317407,JAKARTA SELATAN,KEBAYORAN BARU,7731,124,7166,115,326,450,2021-06-21
317405,JAKARTA SELATAN,KEBAYORAN LAMA,11283,323,10262,214,484,807,2021-06-21
317305,JAKARTA BARAT,KEBON JERUK,12662,342,11453,218,649,991,2021-06-21
317206,JAKARTA UTARA,KELAPA GADING,7034,176,6410,109,339,515,2021-06-21
317409,JAKARTA SELATAN,JAGAKARSA,13851,232,12700,229,690,922,2021-06-21
317404,JAKARTA SELATAN,PASAR MINGGU,13438,236,12300,241,661,897,2021-06-22
317408,JAKARTA SELATAN,PANCORAN,7675,120,6949,125,481,601,2021-06-22
317307,JAKARTA BARAT,PALMERAH,9211,182,8471,192,366,548,2021-06-22
317205,JAKARTA UTARA,PADEMANGAN,6393,135,5851,96,311,446,2021-06-22
317508,JAKARTA TIMUR,MAKASAR,10268,258,9358,175,477,735,2021-06-22
317501,JAKARTA TIMUR,MATRAMAN,7421,142,6770,166,343,485,2021-06-22
317403,JAKARTA SELATAN,MAMPANG PRAPATAN,6670,79,6154,111,326,405,2021-06-22
317505,JAKARTA TIMUR,PASAR REBO,9566,180,8722,179,485,665,2021-06-22
317106,JAKARTA PUSAT,MENTENG,3729,68,3411,77,173,241,2021-06-22
317201,JAKARTA UTARA,PENJARINGAN,9978,439,9013,133,393,832,2021-06-22
317202,JAKARTA UTARA,TANJUNG PRIOK,14678,384,13383,259,652,1036,2021-06-22
317502,JAKARTA TIMUR,PULO GADUNG,11953,335,10807,215,596,931,2021-06-22
317102,JAKARTA PUSAT,SAWAH BESAR,4840,98,4395,97,250,348,2021-06-22
317104,JAKARTA PUSAT,SENEN,5259,127,4748,104,280,407,2021-06-22
317402,JAKARTA SELATAN,SETIA BUDI,6460,132,5927,108,293,425,2021-06-22
317303,JAKARTA BARAT,TAMAN SARI,4601,110,4219,80,192,302,2021-06-22
317304,JAKARTA BARAT,TAMBORA,7240,201,6506,147,386,587,2021-06-22
317107,JAKARTA PUSAT,TANAH ABANG,6806,139,6280,132,255,394,2021-06-22
317401,JAKARTA SELATAN,TEBET,9295,150,8494,171,480,630,2021-06-22
111111,Luar DKI & Proses Update,Luar DKI & Proses Update,143008,137,141294,1273,304,441,2021-06-22
317504,JAKARTA TIMUR,KRAMAT JATI,12075,253,10888,218,716,969,2021-06-22
317410,JAKARTA SELATAN,PESANGGRAHAN,8783,154,8092,144,393,547,2021-06-22
317203,JAKARTA UTARA,KOJA,9795,233,9005,181,376,609,2021-06-22
317409,JAKARTA SELATAN,JAGAKARSA,13948,234,12776,233,705,939,2021-06-22
310102,KAB.ADM.KEP.SERIBU,KEP. SERIBU SELATAN,246,0,243,3,0,0,2021-06-22
310101,KAB.ADM.KEP.SERIBU,KEP. SERIBU UTARA,357,2,333,5,17,19,2021-06-22
317105,JAKARTA PUSAT,CEMPAKA PUTIH,5793,129,5325,96,243,372,2021-06-22
317301,JAKARTA BARAT,CENGKARENG,16492,578,14686,328,900,1478,2021-06-22
317406,JAKARTA SELATAN,CILANDAK,9753,174,8981,153,445,619,2021-06-22
317204,JAKARTA UTARA,CILINCING,9347,248,8480,187,432,680,2021-06-22
317510,JAKARTA TIMUR,CIPAYUNG,12656,230,11539,154,733,963,2021-06-22
317509,JAKARTA TIMUR,CIRACAS,11396,231,10282,212,671,902,2021-06-22
317507,JAKARTA TIMUR,DUREN SAWIT,16778,334,15285,339,820,1154,2021-06-22
317101,JAKARTA PUSAT,GAMBIR,4725,180,4209,77,259,439,2021-06-22
317302,JAKARTA BARAT,GROGOL PETAMBURAN,10092,325,9050,185,532,857,2021-06-22
317506,JAKARTA TIMUR,CAKUNG,13628,297,12541,239,551,848,2021-06-22
317503,JAKARTA TIMUR,JATINEGARA,10496,196,9580,201,519,715,2021-06-22
317103,JAKARTA PUSAT,KEMAYORAN,11798,279,10736,212,571,850,2021-06-22
317206,JAKARTA UTARA,KELAPA GADING,7102,157,6465,109,371,528,2021-06-22
317305,JAKARTA BARAT,KEBON JERUK,12682,312,11563,218,589,901,2021-06-22
317308,JAKARTA BARAT,KEMBANGAN,11033,292,10006,150,585,877,2021-06-22
317407,JAKARTA SELATAN,KEBAYORAN BARU,7801,124,7207,116,354,478,2021-06-22
317306,JAKARTA BARAT,KALI DERES,9803,321,8780,178,524,845,2021-06-22
317108,JAKARTA PUSAT,JOHAR BARU,4873,91,4425,112,245,336,2021-06-22
317405,JAKARTA SELATAN,KEBAYORAN LAMA,11321,296,10358,214,453,749,2021-06-22
317403,JAKARTA SELATAN,MAMPANG PRAPATAN,6715,92,6159,112,352,444,2021-06-23
317201,JAKARTA UTARA,PENJARINGAN,10134,522,9054,133,425,947,2021-06-23
317501,JAKARTA TIMUR,MATRAMAN,7459,157,6778,167,357,514,2021-06-23
317106,JAKARTA PUSAT,MENTENG,3717,63,3415,77,162,225,2021-06-23
317205,JAKARTA UTARA,PADEMANGAN,6431,149,5863,96,323,472,2021-06-23
317307,JAKARTA BARAT,PALMERAH,9407,228,8483,192,504,732,2021-06-23
317408,JAKARTA SELATAN,PANCORAN,7727,139,6959,126,503,642,2021-06-23
317404,JAKARTA SELATAN,PASAR MINGGU,13584,263,12326,245,750,1013,2021-06-23
317505,JAKARTA TIMUR,PASAR REBO,9624,219,8773,180,452,671,2021-06-23
317410,JAKARTA SELATAN,PESANGGRAHAN,8952,189,8100,145,518,707,2021-06-23
317402,JAKARTA SELATAN,SETIA BUDI,6513,163,5932,109,309,472,2021-06-23
317102,JAKARTA PUSAT,SAWAH BESAR,4874,116,4401,98,259,375,2021-06-23
317104,JAKARTA PUSAT,SENEN,5298,147,4760,104,287,434,2021-06-23
317508,JAKARTA TIMUR,MAKASAR,10354,320,9383,176,475,795,2021-06-23
317303,JAKARTA BARAT,TAMAN SARI,4644,134,4224,80,206,340,2021-06-23
317304,JAKARTA BARAT,TAMBORA,7330,246,6522,147,415,661,2021-06-23
317107,JAKARTA PUSAT,TANAH ABANG,6864,163,6296,132,273,436,2021-06-23
317202,JAKARTA UTARA,TANJUNG PRIOK,14795,435,13439,262,659,1094,2021-06-23
317401,JAKARTA SELATAN,TEBET,9378,190,8511,171,506,696,2021-06-23
111111,Luar DKI & Proses Update,Luar DKI & Proses Update,143008,137,141294,1273,304,441,2021-06-23
317502,JAKARTA TIMUR,PULO GADUNG,12057,369,10840,216,632,1001,2021-06-23
317504,JAKARTA TIMUR,KRAMAT JATI,12154,281,10952,219,702,983,2021-06-23
317510,JAKARTA TIMUR,CIPAYUNG,12733,258,11550,154,771,1029,2021-06-23
310101,KAB.ADM.KEP.SERIBU,KEP. SERIBU UTARA,357,1,334,5,17,18,2021-06-23
317203,JAKARTA UTARA,KOJA,9862,273,9023,181,385,658,2021-06-23
317506,JAKARTA TIMUR,CAKUNG,13703,304,12574,239,586,890,2021-06-23
317301,JAKARTA BARAT,CENGKARENG,16763,719,14764,329,951,1670,2021-06-23
317406,JAKARTA SELATAN,CILANDAK,9843,201,8995,154,493,694,2021-06-23
317204,JAKARTA UTARA,CILINCING,9407,280,8492,190,445,725,2021-06-23
317509,JAKARTA TIMUR,CIRACAS,11480,267,10292,215,706,973,2021-06-23
317507,JAKARTA TIMUR,DUREN SAWIT,16885,359,15305,341,880,1239,2021-06-23
317101,JAKARTA PUSAT,GAMBIR,4774,196,4216,77,285,481,2021-06-23
317302,JAKARTA BARAT,GROGOL PETAMBURAN,10223,403,9071,185,564,967,2021-06-23
317409,JAKARTA SELATAN,JAGAKARSA,14109,262,12788,234,825,1087,2021-06-23
317105,JAKARTA PUSAT,CEMPAKA PUTIH,5887,136,5336,98,317,453,2021-06-23
317108,JAKARTA PUSAT,JOHAR BARU,4907,99,4433,112,263,362,2021-06-23
317503,JAKARTA TIMUR,JATINEGARA,10602,224,9583,205,590,814,2021-06-23
317308,JAKARTA BARAT,KEMBANGAN,11183,329,10051,152,651,980,2021-06-23
317103,JAKARTA PUSAT,KEMAYORAN,11867,309,10758,215,585,894,2021-06-23
317206,JAKARTA UTARA,KELAPA GADING,7191,192,6474,109,416,608,2021-06-23
310102,KAB.ADM.KEP.SERIBU,KEP. SERIBU SELATAN,246,0,243,3,0,0,2021-06-23
317405,JAKARTA SELATAN,KEBAYORAN LAMA,11572,378,10374,214,606,984,2021-06-23
317407,JAKARTA SELATAN,KEBAYORAN BARU,7867,147,7212,116,392,539,2021-06-23
317306,JAKARTA BARAT,KALI DERES,9904,377,8839,179,509,886,2021-06-23
317305,JAKARTA BARAT,KEBON JERUK,12837,366,11622,219,630,996,2021-06-23
317504,JAKARTA TIMUR,KRAMAT JATI,12441,331,10973,219,918,1249,2021-06-24
317307,JAKARTA BARAT,PALMERAH,9603,264,8523,194,622,886,2021-06-24
317403,JAKARTA SELATAN,MAMPANG PRAPATAN,6822,95,6210,112,405,500,2021-06-24
317501,JAKARTA TIMUR,MATRAMAN,7606,178,6825,169,434,612,2021-06-24
317106,JAKARTA PUSAT,MENTENG,3773,61,3449,78,185,246,2021-06-24
317205,JAKARTA UTARA,PADEMANGAN,6565,170,5895,96,404,574,2021-06-24
317508,JAKARTA TIMUR,MAKASAR,10645,355,9452,177,661,1016,2021-06-24
317410,JAKARTA SELATAN,PESANGGRAHAN,9022,210,8172,146,494,704,2021-06-24
317404,JAKARTA SELATAN,PASAR MINGGU,13813,290,12403,246,874,1164,2021-06-24
317505,JAKARTA TIMUR,PASAR REBO,9822,254,8800,181,587,841,2021-06-24
317201,JAKARTA UTARA,PENJARINGAN,10352,583,9115,134,520,1103,2021-06-24
317502,JAKARTA TIMUR,PULO GADUNG,12358,453,10898,221,786,1239,2021-06-24
317102,JAKARTA PUSAT,SAWAH BESAR,4942,119,4433,98,292,411,2021-06-24
317104,JAKARTA PUSAT,SENEN,5419,171,4798,105,345,516,2021-06-24
111111,Luar DKI & Proses Update,Luar DKI & Proses Update,143008,137,141294,1273,304,441,2021-06-24
317203,JAKARTA UTARA,KOJA,9919,297,9039,183,400,697,2021-06-24
317408,JAKARTA SELATAN,PANCORAN,7780,138,7049,126,467,605,2021-06-24
310101,KAB.ADM.KEP.SERIBU,KEP. SERIBU UTARA,359,1,334,5,19,20,2021-06-24
317409,JAKARTA SELATAN,JAGAKARSA,14238,287,12893,235,823,1110,2021-06-24
317308,JAKARTA BARAT,KEMBANGAN,11499,362,10116,154,867,1229,2021-06-24
317506,JAKARTA TIMUR,CAKUNG,13895,394,12611,244,646,1040,2021-06-24
317105,JAKARTA PUSAT,CEMPAKA PUTIH,5987,156,5371,98,362,518,2021-06-24
317301,JAKARTA BARAT,CENGKARENG,16980,801,14854,331,994,1795,2021-06-24
317406,JAKARTA SELATAN,CILANDAK,9986,226,9067,154,539,765,2021-06-24
317204,JAKARTA UTARA,CILINCING,9621,330,8504,191,596,926,2021-06-24
317510,JAKARTA TIMUR,CIPAYUNG,13071,273,11601,156,1041,1314,2021-06-24
317509,JAKARTA TIMUR,CIRACAS,11829,294,10322,217,996,1290,2021-06-24
317507,JAKARTA TIMUR,DUREN SAWIT,17012,384,15400,343,885,1269,2021-06-24
310102,KAB.ADM.KEP.SERIBU,KEP. SERIBU SELATAN,246,0,243,3,0,0,2021-06-24
317101,JAKARTA PUSAT,GAMBIR,4885,185,4266,77,357,542,2021-06-24
317503,JAKARTA TIMUR,JATINEGARA,10679,234,9652,207,586,820,2021-06-24
317108,JAKARTA PUSAT,JOHAR BARU,4993,101,4474,112,306,407,2021-06-24
317306,JAKARTA BARAT,KALI DERES,10031,384,8891,180,576,960,2021-06-24
317407,JAKARTA SELATAN,KEBAYORAN BARU,7942,164,7264,117,397,561,2021-06-24
317405,JAKARTA SELATAN,KEBAYORAN LAMA,11735,388,10471,215,661,1049,2021-06-24
317305,JAKARTA BARAT,KEBON JERUK,13082,401,11688,220,773,1174,2021-06-24
317206,JAKARTA UTARA,KELAPA GADING,7282,233,6508,109,432,665,2021-06-24
317103,JAKARTA PUSAT,KEMAYORAN,12035,336,10835,219,645,981,2021-06-24
317302,JAKARTA BARAT,GROGOL PETAMBURAN,10459,452,9164,185,658,1110,2021-06-24
317402,JAKARTA SELATAN,SETIA BUDI,6577,187,5960,109,321,508,2021-06-24
317303,JAKARTA BARAT,TAMAN SARI,4718,143,4241,80,254,397,2021-06-24
317304,JAKARTA BARAT,TAMBORA,7443,287,6588,147,421,708,2021-06-24
317401,JAKARTA SELATAN,TEBET,9450,194,8578,172,506,700,2021-06-24
317107,JAKARTA PUSAT,TANAH ABANG,6982,177,6335,133,337,514,2021-06-24
317202,JAKARTA UTARA,TANJUNG PRIOK,15018,488,13470,264,796,1284,2021-06-24
317506,JAKARTA TIMUR,CAKUNG,13996,409,12690,245,652,1061,2021-06-25
317403,JAKARTA SELATAN,MAMPANG PRAPATAN,6928,110,6231,115,472,582,2021-06-25
317501,JAKARTA TIMUR,MATRAMAN,7690,188,6846,172,484,672,2021-06-25
317106,JAKARTA PUSAT,MENTENG,3847,124,3453,79,191,315,2021-06-25
317205,JAKARTA UTARA,PADEMANGAN,6681,182,5909,97,493,675,2021-06-25
317307,JAKARTA BARAT,PALMERAH,9797,307,8611,195,684,991,2021-06-25
317408,JAKARTA SELATAN,PANCORAN,7977,155,7068,127,627,782,2021-06-25
317404,JAKARTA SELATAN,PASAR MINGGU,13934,337,12475,249,873,1210,2021-06-25
317505,JAKARTA TIMUR,PASAR REBO,10016,282,8845,181,708,990,2021-06-25
317410,JAKARTA SELATAN,PESANGGRAHAN,9085,223,8226,147,489,712,2021-06-25
317502,JAKARTA TIMUR,PULO GADUNG,12473,455,11004,222,792,1247,2021-06-25
317102,JAKARTA PUSAT,SAWAH BESAR,5011,123,4455,98,335,458,2021-06-25
317104,JAKARTA PUSAT,SENEN,5528,182,4856,106,384,566,2021-06-25
317402,JAKARTA SELATAN,SETIA BUDI,6736,184,5995,110,447,631,2021-06-25
317303,JAKARTA BARAT,TAMAN SARI,4765,152,4256,81,276,428,2021-06-25
317304,JAKARTA BARAT,TAMBORA,7596,313,6625,148,510,823,2021-06-25
317107,JAKARTA PUSAT,TANAH ABANG,7108,277,6355,135,341,618,2021-06-25
317202,JAKARTA UTARA,TANJUNG PRIOK,15210,498,13548,270,894,1392,2021-06-25
317401,JAKARTA SELATAN,TEBET,9595,233,8628,173,561,794,2021-06-25
111111,Luar DKI & Proses Update,Luar DKI & Proses Update,143008,137,141294,1273,304,441,2021-06-25
317508,JAKARTA TIMUR,MAKASAR,10856,408,9496,178,774,1182,2021-06-25
317504,JAKARTA TIMUR,KRAMAT JATI,12670,361,11034,220,1055,1416,2021-06-25
317201,JAKARTA UTARA,PENJARINGAN,10602,629,9188,138,647,1276,2021-06-25
310101,KAB.ADM.KEP.SERIBU,KEP. SERIBU UTARA,364,1,334,5,24,25,2021-06-25
317105,JAKARTA PUSAT,CEMPAKA PUTIH,6096,242,5425,98,331,573,2021-06-25
317203,JAKARTA UTARA,KOJA,10137,291,9113,186,547,838,2021-06-25
317406,JAKARTA SELATAN,CILANDAK,10056,251,9105,156,544,795,2021-06-25
317204,JAKARTA UTARA,CILINCING,9771,345,8563,192,671,1016,2021-06-25
317510,JAKARTA TIMUR,CIPAYUNG,13198,328,11643,156,1071,1399,2021-06-25
317509,JAKARTA TIMUR,CIRACAS,11924,341,10351,219,1013,1354,2021-06-25
317507,JAKARTA TIMUR,DUREN SAWIT,17310,448,15460,347,1055,1503,2021-06-25
317101,JAKARTA PUSAT,GAMBIR,4943,165,4333,77,368,533,2021-06-25
317302,JAKARTA BARAT,GROGOL PETAMBURAN,10590,494,9202,186,708,1202,2021-06-25
317409,JAKARTA SELATAN,JAGAKARSA,14445,328,12927,235,955,1283,2021-06-25
317301,JAKARTA BARAT,CENGKARENG,17282,853,15010,333,1086,1939,2021-06-25
317108,JAKARTA PUSAT,JOHAR BARU,5158,121,4493,113,431,552,2021-06-25
317503,JAKARTA TIMUR,JATINEGARA,10895,254,9682,208,751,1005,2021-06-25
310102,KAB.ADM.KEP.SERIBU,KEP. SERIBU SELATAN,246,0,243,3,0,0,2021-06-25
317103,JAKARTA PUSAT,KEMAYORAN,12219,371,10888,220,740,1111,2021-06-25
317206,JAKARTA UTARA,KELAPA GADING,7399,242,6578,111,468,710,2021-06-25
317305,JAKARTA BARAT,KEBON JERUK,13193,431,11792,223,747,1178,2021-06-25
317308,JAKARTA BARAT,KEMBANGAN,11605,402,10239,154,810,1212,2021-06-25
317407,JAKARTA SELATAN,KEBAYORAN BARU,8056,185,7301,117,453,638,2021-06-25
317306,JAKARTA BARAT,KALI DERES,10209,395,8939,184,691,1086,2021-06-25
317405,JAKARTA SELATAN,KEBAYORAN LAMA,11870,451,10504,219,696,1147,2021-06-25
317404,JAKARTA SELATAN,PASAR MINGGU,14052,379,12497,252,924,1303,2021-06-26
317501,JAKARTA TIMUR,MATRAMAN,7794,222,6918,172,482,704,2021-06-26
317106,JAKARTA PUSAT,MENTENG,3939,194,3457,79,209,403,2021-06-26
317403,JAKARTA SELATAN,MAMPANG PRAPATAN,7038,130,6241,115,552,682,2021-06-26
317205,JAKARTA UTARA,PADEMANGAN,6881,211,5963,97,610,821,2021-06-26
317307,JAKARTA BARAT,PALMERAH,10025,383,8627,198,817,1200,2021-06-26
317508,JAKARTA TIMUR,MAKASAR,10985,455,9596,178,756,1211,2021-06-26
317408,JAKARTA SELATAN,PANCORAN,8116,172,7082,129,733,905,2021-06-26
317505,JAKARTA TIMUR,PASAR REBO,10267,341,8920,181,825,1166,2021-06-26
317104,JAKARTA PUSAT,SENEN,5578,196,4874,106,402,598,2021-06-26
317410,JAKARTA SELATAN,PESANGGRAHAN,9378,250,8254,149,725,975,2021-06-26
317502,JAKARTA TIMUR,PULO GADUNG,12721,515,11060,223,923,1438,2021-06-26
317102,JAKARTA PUSAT,SAWAH BESAR,5079,148,4461,99,371,519,2021-06-26
317402,JAKARTA SELATAN,SETIA BUDI,6895,205,6012,110,568,773,2021-06-26
317303,JAKARTA BARAT,TAMAN SARI,4873,177,4273,81,342,519,2021-06-26
317202,JAKARTA UTARA,TANJUNG PRIOK,15702,554,13587,272,1289,1843,2021-06-26
317401,JAKARTA SELATAN,TEBET,9768,257,8651,173,687,944,2021-06-26
317504,JAKARTA TIMUR,KRAMAT JATI,12951,380,11188,222,1161,1541,2021-06-26
111111,Luar DKI & Proses Update,Luar DKI & Proses Update,143008,137,141294,1273,304,441,2021-06-26
317201,JAKARTA UTARA,PENJARINGAN,10858,686,9286,139,747,1433,2021-06-26
317203,JAKARTA UTARA,KOJA,10351,332,9141,189,689,1021,2021-06-26
317107,JAKARTA PUSAT,TANAH ABANG,7237,372,6364,135,366,738,2021-06-26
310102,KAB.ADM.KEP.SERIBU,KEP. SERIBU SELATAN,250,0,243,3,4,4,2021-06-26
317506,JAKARTA TIMUR,CAKUNG,14203,449,12790,245,719,1168,2021-06-26
310101,KAB.ADM.KEP.SERIBU,KEP. SERIBU UTARA,367,2,335,5,25,27,2021-06-26
317105,JAKARTA PUSAT,CEMPAKA PUTIH,6158,244,5460,99,355,599,2021-06-26
317301,JAKARTA BARAT,CENGKARENG,17674,884,15219,335,1236,2120,2021-06-26
317406,JAKARTA SELATAN,CILANDAK,10154,275,9128,156,595,870,2021-06-26
317204,JAKARTA UTARA,CILINCING,9959,389,8620,193,757,1146,2021-06-26
317510,JAKARTA TIMUR,CIPAYUNG,13505,356,11790,156,1203,1559,2021-06-26
317509,JAKARTA TIMUR,CIRACAS,12264,360,10505,219,1180,1540,2021-06-26
317507,JAKARTA TIMUR,DUREN SAWIT,17592,506,15613,350,1123,1629,2021-06-26
317101,JAKARTA PUSAT,GAMBIR,5042,176,4392,79,395,571,2021-06-26
317304,JAKARTA BARAT,TAMBORA,7828,393,6638,148,649,1042,2021-06-26
317409,JAKARTA SELATAN,JAGAKARSA,14665,337,12970,240,1118,1455,2021-06-26
317103,JAKARTA PUSAT,KEMAYORAN,12410,402,10947,221,840,1242,2021-06-26
317302,JAKARTA BARAT,GROGOL PETAMBURAN,10872,570,9261,186,855,1425,2021-06-26
317206,JAKARTA UTARA,KELAPA GADING,7554,288,6606,112,548,836,2021-06-26
317305,JAKARTA BARAT,KEBON JERUK,13473,469,11870,224,910,1379,2021-06-26
317405,JAKARTA SELATAN,KEBAYORAN LAMA,12047,522,10556,221,748,1270,2021-06-26
317308,JAKARTA BARAT,KEMBANGAN,11867,424,10286,154,1003,1427,2021-06-26
317407,JAKARTA SELATAN,KEBAYORAN BARU,8240,204,7323,118,595,799,2021-06-26
317306,JAKARTA BARAT,KALI DERES,10429,413,9046,186,784,1197,2021-06-26
317108,JAKARTA PUSAT,JOHAR BARU,5190,139,4534,115,402,541,2021-06-26
317503,JAKARTA TIMUR,JATINEGARA,11159,300,9771,208,880,1180,2021-06-26
317501,JAKARTA TIMUR,MATRAMAN,8001,220,6960,174,647,867,2021-06-27
317106,JAKARTA PUSAT,MENTENG,4027,204,3512,79,232,436,2021-06-27
317205,JAKARTA UTARA,PADEMANGAN,7039,227,6004,98,710,937,2021-06-27
317307,JAKARTA BARAT,PALMERAH,10244,435,8783,198,828,1263,2021-06-27
317408,JAKARTA SELATAN,PANCORAN,8189,192,7133,130,734,926,2021-06-27
317505,JAKARTA TIMUR,PASAR REBO,10510,369,8950,183,1008,1377,2021-06-27
317403,JAKARTA SELATAN,MAMPANG PRAPATAN,7087,133,6290,116,548,681,2021-06-27
317201,JAKARTA UTARA,PENJARINGAN,11123,762,9333,140,888,1650,2021-06-27
317402,JAKARTA SELATAN,SETIA BUDI,7042,206,6081,110,645,851,2021-06-27
317502,JAKARTA TIMUR,PULO GADUNG,12964,547,11153,223,1041,1588,2021-06-27
317104,JAKARTA PUSAT,SENEN,5702,208,4922,108,464,672,2021-06-27
317508,JAKARTA TIMUR,MAKASAR,11383,477,9668,179,1059,1536,2021-06-27
317303,JAKARTA BARAT,TAMAN SARI,4978,192,4316,82,388,580,2021-06-27
317304,JAKARTA BARAT,TAMBORA,8007,408,6712,148,739,1147,2021-06-27
317107,JAKARTA PUSAT,TANAH ABANG,7379,379,6476,135,389,768,2021-06-27
317202,JAKARTA UTARA,TANJUNG PRIOK,16013,612,13732,275,1394,2006,2021-06-27
317401,JAKARTA SELATAN,TEBET,9903,285,8736,174,708,993,2021-06-27
111111,Luar DKI & Proses Update,Luar DKI & Proses Update,143008,137,141294,1273,304,441,2021-06-27
317410,JAKARTA SELATAN,PESANGGRAHAN,9513,254,8331,149,779,1033,2021-06-27
317504,JAKARTA TIMUR,KRAMAT JATI,13239,409,11235,224,1371,1780,2021-06-27
317102,JAKARTA PUSAT,SAWAH BESAR,5171,151,4538,99,383,534,2021-06-27
310101,KAB.ADM.KEP.SERIBU,KEP. SERIBU UTARA,370,3,336,5,26,29,2021-06-27
317506,JAKARTA TIMUR,CAKUNG,14467,484,12843,247,893,1377,2021-06-27
317203,JAKARTA UTARA,KOJA,10572,397,9157,194,824,1221,2021-06-27
317105,JAKARTA PUSAT,CEMPAKA PUTIH,6270,251,5515,99,405,656,2021-06-27
317301,JAKARTA BARAT,CENGKARENG,18094,952,15341,338,1463,2415,2021-06-27
317406,JAKARTA SELATAN,CILANDAK,10409,287,9217,157,748,1035,2021-06-27
317204,JAKARTA UTARA,CILINCING,10127,453,8638,194,842,1295,2021-06-27
317510,JAKARTA TIMUR,CIPAYUNG,13825,375,11838,156,1456,1831,2021-06-27
317509,JAKARTA TIMUR,CIRACAS,12708,387,10553,221,1547,1934,2021-06-27
317507,JAKARTA TIMUR,DUREN SAWIT,17909,525,15695,350,1339,1864,2021-06-27
317101,JAKARTA PUSAT,GAMBIR,5145,182,4419,79,465,647,2021-06-27
317302,JAKARTA BARAT,GROGOL PETAMBURAN,11076,611,9335,186,944,1555,2021-06-27
317404,JAKARTA SELATAN,PASAR MINGGU,14262,401,12594,254,1013,1414,2021-06-27
317409,JAKARTA SELATAN,JAGAKARSA,14754,343,13142,241,1028,1371,2021-06-27
310102,KAB.ADM.KEP.SERIBU,KEP. SERIBU SELATAN,250,0,243,3,4,4,2021-06-27
317206,JAKARTA UTARA,KELAPA GADING,7706,306,6639,112,649,955,2021-06-27
317305,JAKARTA BARAT,KEBON JERUK,13738,510,12039,224,965,1475,2021-06-27
317405,JAKARTA SELATAN,KEBAYORAN LAMA,12191,524,10660,225,782,1306,2021-06-27
317103,JAKARTA PUSAT,KEMAYORAN,12665,420,11002,222,1021,1441,2021-06-27
317306,JAKARTA BARAT,KALI DERES,10668,437,9122,187,922,1359,2021-06-27
317108,JAKARTA PUSAT,JOHAR BARU,5283,143,4561,116,463,606,2021-06-27
317503,JAKARTA TIMUR,JATINEGARA,11349,342,9814,208,985,1327,2021-06-27
317407,JAKARTA SELATAN,KEBAYORAN BARU,8384,197,7407,120,660,857,2021-06-27
317308,JAKARTA BARAT,KEMBANGAN,12122,454,10461,155,1052,1506,2021-06-27
317205,JAKARTA UTARA,PADEMANGAN,7178,219,6085,98,776,995,2021-06-28
317203,JAKARTA UTARA,KOJA,10832,407,9271,197,957,1364,2021-06-28
317504,JAKARTA TIMUR,KRAMAT JATI,13346,422,11354,226,1344,1766,2021-06-28
317508,JAKARTA TIMUR,MAKASAR,11483,498,9762,180,1043,1541,2021-06-28
317403,JAKARTA SELATAN,MAMPANG PRAPATAN,7282,141,6351,117,673,814,2021-06-28
317501,JAKARTA TIMUR,MATRAMAN,8108,232,6979,177,720,952,2021-06-28
317106,JAKARTA PUSAT,MENTENG,4107,256,3514,79,258,514,2021-06-28
317201,JAKARTA UTARA,PENJARINGAN,11265,707,9477,141,940,1647,2021-06-28
317408,JAKARTA SELATAN,PANCORAN,8331,198,7231,131,771,969,2021-06-28
317404,JAKARTA SELATAN,PASAR MINGGU,14466,423,12691,256,1096,1519,2021-06-28
317505,JAKARTA TIMUR,PASAR REBO,10609,410,9038,186,975,1385,2021-06-28
310101,KAB.ADM.KEP.SERIBU,KEP. SERIBU UTARA,374,3,338,5,28,31,2021-06-28
317410,JAKARTA SELATAN,PESANGGRAHAN,9653,258,8399,150,846,1104,2021-06-28
317502,JAKARTA TIMUR,PULO GADUNG,13184,584,11220,224,1156,1740,2021-06-28
111111,Luar DKI & Proses Update,Luar DKI & Proses Update,143008,137,141294,1273,304,441,2021-06-28
317307,JAKARTA BARAT,PALMERAH,10367,464,8806,202,895,1359,2021-06-28
310102,KAB.ADM.KEP.SERIBU,KEP. SERIBU SELATAN,259,1,243,3,12,13,2021-06-28
317405,JAKARTA SELATAN,KEBAYORAN LAMA,12462,542,10791,227,902,1444,2021-06-28
317103,JAKARTA PUSAT,KEMAYORAN,12877,443,11042,225,1167,1610,2021-06-28
317506,JAKARTA TIMUR,CAKUNG,14571,500,12895,249,927,1427,2021-06-28
317105,JAKARTA PUSAT,CEMPAKA PUTIH,6422,359,5530,99,434,793,2021-06-28
317301,JAKARTA BARAT,CENGKARENG,18462,996,15411,351,1704,2700,2021-06-28
317406,JAKARTA SELATAN,CILANDAK,10503,309,9290,157,747,1056,2021-06-28
317204,JAKARTA UTARA,CILINCING,10340,477,8762,195,906,1383,2021-06-28
317510,JAKARTA TIMUR,CIPAYUNG,14168,389,11973,157,1649,2038,2021-06-28
317509,JAKARTA TIMUR,CIRACAS,12812,419,10710,222,1461,1880,2021-06-28
317507,JAKARTA TIMUR,DUREN SAWIT,18106,572,15774,351,1409,1981,2021-06-28
317302,JAKARTA BARAT,GROGOL PETAMBURAN,11428,695,9391,188,1154,1849,2021-06-28
317409,JAKARTA SELATAN,JAGAKARSA,15006,375,13299,242,1090,1465,2021-06-28
317503,JAKARTA TIMUR,JATINEGARA,11591,361,9874,211,1145,1506,2021-06-28
317108,JAKARTA PUSAT,JOHAR BARU,5373,155,4570,118,530,685,2021-06-28
317306,JAKARTA BARAT,KALI DERES,10762,440,9168,190,964,1404,2021-06-28
317407,JAKARTA SELATAN,KEBAYORAN BARU,8525,220,7471,121,713,933,2021-06-28
317102,JAKARTA PUSAT,SAWAH BESAR,5271,175,4560,99,437,612,2021-06-28
317305,JAKARTA BARAT,KEBON JERUK,14090,607,12077,226,1180,1787,2021-06-28
317206,JAKARTA UTARA,KELAPA GADING,7889,316,6747,113,713,1029,2021-06-28
317308,JAKARTA BARAT,KEMBANGAN,12472,495,10488,155,1334,1829,2021-06-28
317101,JAKARTA PUSAT,GAMBIR,5243,187,4433,80,543,730,2021-06-28
317104,JAKARTA PUSAT,SENEN,5814,230,4929,111,544,774,2021-06-28
317303,JAKARTA BARAT,TAMAN SARI,5053,200,4352,82,419,619,2021-06-28
317107,JAKARTA PUSAT,TANAH ABANG,7518,470,6514,137,397,867,2021-06-28
317202,JAKARTA UTARA,TANJUNG PRIOK,16294,605,13879,279,1531,2136,2021-06-28
317401,JAKARTA SELATAN,TEBET,10229,308,8812,174,935,1243,2021-06-28
317304,JAKARTA BARAT,TAMBORA,8180,449,6737,149,845,1294,2021-06-28
317402,JAKARTA SELATAN,SETIA BUDI,7176,224,6144,110,698,922,2021-06-28
317304,JAKARTA BARAT,TAMBORA,8375,470,6835,150,920,1390,2021-06-29
317504,JAKARTA TIMUR,KRAMAT JATI,13603,438,11368,230,1567,2005,2021-06-29
317508,JAKARTA TIMUR,MAKASAR,11732,513,9780,181,1258,1771,2021-06-29
317403,JAKARTA SELATAN,MAMPANG PRAPATAN,7371,153,6430,119,669,822,2021-06-29
317501,JAKARTA TIMUR,MATRAMAN,8379,247,6988,180,964,1211,2021-06-29
317106,JAKARTA PUSAT,MENTENG,4134,255,3547,80,252,507,2021-06-29
317205,JAKARTA UTARA,PADEMANGAN,7229,234,6101,100,794,1028,2021-06-29
317307,JAKARTA BARAT,PALMERAH,10435,447,8905,205,878,1325,2021-06-29
317408,JAKARTA SELATAN,PANCORAN,8382,199,7295,132,756,955,2021-06-29
317404,JAKARTA SELATAN,PASAR MINGGU,14659,459,12795,259,1146,1605,2021-06-29
317203,JAKARTA UTARA,KOJA,11031,446,9292,201,1092,1538,2021-06-29
317505,JAKARTA TIMUR,PASAR REBO,10802,413,9059,188,1142,1555,2021-06-29
317410,JAKARTA SELATAN,PESANGGRAHAN,9857,269,8463,151,974,1243,2021-06-29
317502,JAKARTA TIMUR,PULO GADUNG,13309,611,11303,227,1168,1779,2021-06-29
317102,JAKARTA PUSAT,SAWAH BESAR,5365,183,4629,99,454,637,2021-06-29
317104,JAKARTA PUSAT,SENEN,5948,242,5005,111,590,832,2021-06-29
317402,JAKARTA SELATAN,SETIA BUDI,7258,224,6196,110,728,952,2021-06-29
317303,JAKARTA BARAT,TAMAN SARI,5126,210,4378,82,456,666,2021-06-29
317107,JAKARTA PUSAT,TANAH ABANG,7560,456,6564,137,403,859,2021-06-29
317202,JAKARTA UTARA,TANJUNG PRIOK,16422,619,13925,280,1598,2217,2021-06-29
317401,JAKARTA SELATAN,TEBET,10400,326,8880,175,1019,1345,2021-06-29
317201,JAKARTA UTARA,PENJARINGAN,11421,730,9543,141,1007,1737,2021-06-29
310101,KAB.ADM.KEP.SERIBU,KEP. SERIBU UTARA,380,3,338,5,34,37,2021-06-29
111111,Luar DKI & Proses Update,Luar DKI & Proses Update,143008,137,141294,1273,304,441,2021-06-29
317308,JAKARTA BARAT,KEMBANGAN,12614,488,10637,156,1333,1821,2021-06-29
310102,KAB.ADM.KEP.SERIBU,KEP. SERIBU SELATAN,259,1,243,3,12,13,2021-06-29
317506,JAKARTA TIMUR,CAKUNG,14763,518,13036,254,955,1473,2021-06-29
317301,JAKARTA BARAT,CENGKARENG,18638,994,15609,354,1681,2675,2021-06-29
317406,JAKARTA SELATAN,CILANDAK,10648,311,9379,160,798,1109,2021-06-29
317204,JAKARTA UTARA,CILINCING,10537,511,8784,197,1045,1556,2021-06-29
317510,JAKARTA TIMUR,CIPAYUNG,14514,395,11996,159,1964,2359,2021-06-29
317509,JAKARTA TIMUR,CIRACAS,13118,445,10730,222,1721,2166,2021-06-29
317507,JAKARTA TIMUR,DUREN SAWIT,18372,610,15896,353,1513,2123,2021-06-29
317101,JAKARTA PUSAT,GAMBIR,5335,191,4512,80,552,743,2021-06-29
317105,JAKARTA PUSAT,CEMPAKA PUTIH,6469,362,5584,100,423,785,2021-06-29
317409,JAKARTA SELATAN,JAGAKARSA,15248,381,13440,246,1181,1562,2021-06-29
317503,JAKARTA TIMUR,JATINEGARA,11736,393,9929,215,1199,1592,2021-06-29
317108,JAKARTA PUSAT,JOHAR BARU,5449,156,4627,118,548,704,2021-06-29
317306,JAKARTA BARAT,KALI DERES,10997,450,9336,192,1019,1469,2021-06-29
317407,JAKARTA SELATAN,KEBAYORAN BARU,8589,216,7537,121,715,931,2021-06-29
317405,JAKARTA SELATAN,KEBAYORAN LAMA,12613,548,10878,227,960,1508,2021-06-29
317305,JAKARTA BARAT,KEBON JERUK,14336,643,12202,227,1264,1907,2021-06-29
317103,JAKARTA PUSAT,KEMAYORAN,13052,438,11307,229,1078,1516,2021-06-29
317206,JAKARTA UTARA,KELAPA GADING,8048,351,6758,117,822,1173,2021-06-29
317302,JAKARTA BARAT,GROGOL PETAMBURAN,11600,684,9547,188,1181,1865,2021-06-29
317501,JAKARTA TIMUR,MATRAMAN,8440,254,7039,180,967,1221,2021-06-30
317403,JAKARTA SELATAN,MAMPANG PRAPATAN,7443,170,6447,120,706,876,2021-06-30
310101,KAB.ADM.KEP.SERIBU,KEP. SERIBU UTARA,381,4,346,5,26,30,2021-06-30
317504,JAKARTA TIMUR,KRAMAT JATI,13748,465,11534,231,1518,1983,2021-06-30
317203,JAKARTA UTARA,KOJA,11237,447,9363,202,1225,1672,2021-06-30
310102,KAB.ADM.KEP.SERIBU,KEP. SERIBU SELATAN,265,0,243,3,19,19,2021-06-30
317508,JAKARTA TIMUR,MAKASAR,11893,578,9882,181,1252,1830,2021-06-30
317106,JAKARTA PUSAT,MENTENG,4151,258,3571,80,242,500,2021-06-30
317404,JAKARTA SELATAN,PASAR MINGGU,14818,466,12883,261,1208,1674,2021-06-30
317307,JAKARTA BARAT,PALMERAH,10523,471,8974,206,872,1343,2021-06-30
317408,JAKARTA SELATAN,PANCORAN,8669,231,7324,134,980,1211,2021-06-30
317505,JAKARTA TIMUR,PASAR REBO,10901,439,9177,189,1096,1535,2021-06-30
317201,JAKARTA UTARA,PENJARINGAN,11702,861,9638,144,1059,1920,2021-06-30
317410,JAKARTA SELATAN,PESANGGRAHAN,9930,290,8493,151,996,1286,2021-06-30
317502,JAKARTA TIMUR,PULO GADUNG,13592,649,11441,229,1273,1922,2021-06-30
317308,JAKARTA BARAT,KEMBANGAN,12724,548,10729,161,1286,1834,2021-06-30
317102,JAKARTA PUSAT,SAWAH BESAR,5476,257,4645,99,475,732,2021-06-30
317205,JAKARTA UTARA,PADEMANGAN,7314,240,6164,100,810,1050,2021-06-30
317103,JAKARTA PUSAT,KEMAYORAN,13280,492,11362,230,1196,1688,2021-06-30
317101,JAKARTA PUSAT,GAMBIR,5399,216,4527,80,576,792,2021-06-30
317305,JAKARTA BARAT,KEBON JERUK,14448,691,12316,229,1212,1903,2021-06-30
317402,JAKARTA SELATAN,SETIA BUDI,7393,235,6235,110,813,1048,2021-06-30
111111,Luar DKI & Proses Update,Luar DKI & Proses Update,143008,137,141294,1273,304,441,2021-06-30
317506,JAKARTA TIMUR,CAKUNG,15078,539,13096,257,1186,1725,2021-06-30
317105,JAKARTA PUSAT,CEMPAKA PUTIH,6590,443,5633,101,413,856,2021-06-30
317301,JAKARTA BARAT,CENGKARENG,19020,1123,15664,362,1871,2994,2021-06-30
317406,JAKARTA SELATAN,CILANDAK,10760,333,9489,161,777,1110,2021-06-30
317204,JAKARTA UTARA,CILINCING,10641,522,8867,199,1053,1575,2021-06-30
317510,JAKARTA TIMUR,CIPAYUNG,14619,402,12162,161,1894,2296,2021-06-30
317509,JAKARTA TIMUR,CIRACAS,13204,438,10880,224,1662,2100,2021-06-30
317507,JAKARTA TIMUR,DUREN SAWIT,18660,626,16062,358,1614,2240,2021-06-30
317302,JAKARTA BARAT,GROGOL PETAMBURAN,11901,768,9582,188,1363,2131,2021-06-30
317409,JAKARTA SELATAN,JAGAKARSA,15340,391,13535,249,1165,1556,2021-06-30
317503,JAKARTA TIMUR,JATINEGARA,12019,398,10004,215,1402,1800,2021-06-30
317108,JAKARTA PUSAT,JOHAR BARU,5533,166,4643,118,606,772,2021-06-30
317306,JAKARTA BARAT,KALI DERES,11257,532,9364,192,1169,1701,2021-06-30
317407,JAKARTA SELATAN,KEBAYORAN BARU,8749,236,7566,121,826,1062,2021-06-30
317405,JAKARTA SELATAN,KEBAYORAN LAMA,12762,571,10934,227,1030,1601,2021-06-30
317206,JAKARTA UTARA,KELAPA GADING,8159,352,6811,118,878,1230,2021-06-30
317104,JAKARTA PUSAT,SENEN,6019,266,5038,113,602,868,2021-06-30
317304,JAKARTA BARAT,TAMBORA,8599,551,6882,152,1014,1565,2021-06-30
317107,JAKARTA PUSAT,TANAH ABANG,7621,476,6609,138,398,874,2021-06-30
317202,JAKARTA UTARA,TANJUNG PRIOK,16573,635,14118,283,1537,2172,2021-06-30
317401,JAKARTA SELATAN,TEBET,10566,339,8922,176,1129,1468,2021-06-30
317303,JAKARTA BARAT,TAMAN SARI,5287,278,4397,83,529,807,2021-06-30
317303,JAKARTA BARAT,TAMAN SARI,5351,286,4452,83,530,816,2021-07-01
317508,JAKARTA TIMUR,MAKASAR,12038,626,10006,184,1222,1848,2021-07-01
317403,JAKARTA SELATAN,MAMPANG PRAPATAN,7598,198,6478,120,802,1000,2021-07-01
317501,JAKARTA TIMUR,MATRAMAN,8522,302,7061,180,979,1281,2021-07-01
317106,JAKARTA PUSAT,MENTENG,4190,275,3577,80,258,533,2021-07-01
317307,JAKARTA BARAT,PALMERAH,10804,507,9010,207,1080,1587,2021-07-01
317408,JAKARTA SELATAN,PANCORAN,8760,268,7391,134,967,1235,2021-07-01
317404,JAKARTA SELATAN,PASAR MINGGU,15000,512,12982,262,1244,1756,2021-07-01
317505,JAKARTA TIMUR,PASAR REBO,11025,476,9274,190,1085,1561,2021-07-01
317201,JAKARTA UTARA,PENJARINGAN,12030,931,9764,144,1191,2122,2021-07-01
317102,JAKARTA PUSAT,SAWAH BESAR,5572,260,4699,100,513,773,2021-07-01
317502,JAKARTA TIMUR,PULO GADUNG,13722,683,11578,230,1231,1914,2021-07-01
317504,JAKARTA TIMUR,KRAMAT JATI,13910,526,11688,233,1463,1989,2021-07-01
317104,JAKARTA PUSAT,SENEN,6095,306,5091,113,585,891,2021-07-01
317402,JAKARTA SELATAN,SETIA BUDI,7487,262,6306,110,809,1071,2021-07-01
317304,JAKARTA BARAT,TAMBORA,8792,602,6934,153,1103,1705,2021-07-01
317107,JAKARTA PUSAT,TANAH ABANG,7699,482,6633,138,446,928,2021-07-01
317202,JAKARTA UTARA,TANJUNG PRIOK,17022,691,14279,283,1769,2460,2021-07-01
317401,JAKARTA SELATAN,TEBET,10677,380,9023,177,1097,1477,2021-07-01
111111,Luar DKI & Proses Update,Luar DKI & Proses Update,143008,137,141294,1273,304,441,2021-07-01
317410,JAKARTA SELATAN,PESANGGRAHAN,10007,296,8538,154,1019,1315,2021-07-01
317203,JAKARTA UTARA,KOJA,11348,489,9480,202,1177,1666,2021-07-01
317205,JAKARTA UTARA,PADEMANGAN,7493,279,6233,101,880,1159,2021-07-01
310102,KAB.ADM.KEP.SERIBU,KEP. SERIBU SELATAN,306,0,243,3,60,60,2021-07-01
317506,JAKARTA TIMUR,CAKUNG,15318,600,13155,259,1304,1904,2021-07-01
317105,JAKARTA PUSAT,CEMPAKA PUTIH,6682,482,5648,101,451,933,2021-07-01
310101,KAB.ADM.KEP.SERIBU,KEP. SERIBU UTARA,395,6,346,5,38,44,2021-07-01
317406,JAKARTA SELATAN,CILANDAK,10956,362,9518,161,915,1277,2021-07-01
317204,JAKARTA UTARA,CILINCING,10741,563,9037,200,941,1504,2021-07-01
317510,JAKARTA TIMUR,CIPAYUNG,14732,426,12298,163,1845,2271,2021-07-01
317509,JAKARTA TIMUR,CIRACAS,13338,475,11040,224,1599,2074,2021-07-01
317507,JAKARTA TIMUR,DUREN SAWIT,18800,685,16127,361,1627,2312,2021-07-01
317101,JAKARTA PUSAT,GAMBIR,5554,240,4555,80,679,919,2021-07-01
317302,JAKARTA BARAT,GROGOL PETAMBURAN,12039,806,9657,190,1386,2192,2021-07-01
317301,JAKARTA BARAT,CENGKARENG,19455,1246,15711,367,2131,3377,2021-07-01
317503,JAKARTA TIMUR,JATINEGARA,12197,453,10056,215,1473,1926,2021-07-01
317409,JAKARTA SELATAN,JAGAKARSA,15477,425,13633,250,1169,1594,2021-07-01
317308,JAKARTA BARAT,KEMBANGAN,13107,613,10759,162,1573,2186,2021-07-01
317206,JAKARTA UTARA,KELAPA GADING,8231,375,6909,119,828,1203,2021-07-01
317305,JAKARTA BARAT,KEBON JERUK,14725,737,12364,229,1395,2132,2021-07-01
317103,JAKARTA PUSAT,KEMAYORAN,13427,562,11449,232,1184,1746,2021-07-01
317407,JAKARTA SELATAN,KEBAYORAN BARU,8860,271,7618,121,850,1121,2021-07-01
317306,JAKARTA BARAT,KALI DERES,11422,571,9432,193,1226,1797,2021-07-01
317108,JAKARTA PUSAT,JOHAR BARU,5703,191,4696,119,697,888,2021-07-01
317405,JAKARTA SELATAN,KEBAYORAN LAMA,12916,552,11084,227,1053,1605,2021-07-01
310101,KAB.ADM.KEP.SERIBU,KEP. SERIBU UTARA,399,7,350,5,37,44,2021-07-02
317106,JAKARTA PUSAT,MENTENG,4361,413,3613,80,255,668,2021-07-02
317203,JAKARTA UTARA,KOJA,11461,532,9582,202,1145,1677,2021-07-02
317504,JAKARTA TIMUR,KRAMAT JATI,14379,571,11737,234,1837,2408,2021-07-02
317508,JAKARTA TIMUR,MAKASAR,12212,696,10048,184,1284,1980,2021-07-02
317403,JAKARTA SELATAN,MAMPANG PRAPATAN,7689,211,6555,120,803,1014,2021-07-02
317501,JAKARTA TIMUR,MATRAMAN,8643,338,7157,181,967,1305,2021-07-02
317205,JAKARTA UTARA,PADEMANGAN,7666,303,6265,101,997,1300,2021-07-02
317201,JAKARTA UTARA,PENJARINGAN,12211,903,9935,145,1228,2131,2021-07-02
317408,JAKARTA SELATAN,PANCORAN,9040,291,7466,134,1149,1440,2021-07-02
317404,JAKARTA SELATAN,PASAR MINGGU,15260,554,13047,262,1397,1951,2021-07-02
317505,JAKARTA TIMUR,PASAR REBO,11287,497,9326,191,1273,1770,2021-07-02
317410,JAKARTA SELATAN,PESANGGRAHAN,10154,296,8575,155,1128,1424,2021-07-02
317104,JAKARTA PUSAT,SENEN,6285,328,5177,115,665,993,2021-07-02
111111,Luar DKI & Proses Update,Luar DKI & Proses Update,143008,137,141294,1273,304,441,2021-07-02
310102,KAB.ADM.KEP.SERIBU,KEP. SERIBU SELATAN,317,0,243,3,71,71,2021-07-02
317307,JAKARTA BARAT,PALMERAH,11075,502,9094,208,1271,1773,2021-07-02
317308,JAKARTA BARAT,KEMBANGAN,13267,597,10917,163,1590,2187,2021-07-02
317402,JAKARTA SELATAN,SETIA BUDI,7676,281,6333,111,951,1232,2021-07-02
317206,JAKARTA UTARA,KELAPA GADING,8322,397,6957,119,849,1246,2021-07-02
317102,JAKARTA PUSAT,SAWAH BESAR,5627,271,4754,101,501,772,2021-07-02
317506,JAKARTA TIMUR,CAKUNG,15485,651,13335,260,1239,1890,2021-07-02
317105,JAKARTA PUSAT,CEMPAKA PUTIH,6802,545,5713,102,442,987,2021-07-02
317301,JAKARTA BARAT,CENGKARENG,19648,1194,16111,368,1975,3169,2021-07-02
317406,JAKARTA SELATAN,CILANDAK,11096,400,9593,162,941,1341,2021-07-02
317204,JAKARTA UTARA,CILINCING,10830,595,9173,200,862,1457,2021-07-02
317510,JAKARTA TIMUR,CIPAYUNG,15170,469,12354,163,2184,2653,2021-07-02
317509,JAKARTA TIMUR,CIRACAS,13797,502,11089,224,1982,2484,2021-07-02
317103,JAKARTA PUSAT,KEMAYORAN,13709,571,11534,232,1372,1943,2021-07-02
317507,JAKARTA TIMUR,DUREN SAWIT,19140,726,16385,361,1668,2394,2021-07-02
317302,JAKARTA BARAT,GROGOL PETAMBURAN,12265,822,9917,190,1336,2158,2021-07-02
317409,JAKARTA SELATAN,JAGAKARSA,15609,455,13692,250,1212,1667,2021-07-02
317503,JAKARTA TIMUR,JATINEGARA,12502,457,10210,215,1620,2077,2021-07-02
317108,JAKARTA PUSAT,JOHAR BARU,5787,236,4759,119,673,909,2021-07-02
317306,JAKARTA BARAT,KALI DERES,11659,567,9579,193,1320,1887,2021-07-02
317407,JAKARTA SELATAN,KEBAYORAN BARU,9012,298,7665,121,928,1226,2021-07-02
317405,JAKARTA SELATAN,KEBAYORAN LAMA,13127,588,11180,228,1131,1719,2021-07-02
317305,JAKARTA BARAT,KEBON JERUK,15023,736,12536,229,1522,2258,2021-07-02
317101,JAKARTA PUSAT,GAMBIR,5655,244,4642,80,689,933,2021-07-02
317502,JAKARTA TIMUR,PULO GADUNG,13960,720,11761,230,1249,1969,2021-07-02
317303,JAKARTA BARAT,TAMAN SARI,5414,294,4515,83,522,816,2021-07-02
317304,JAKARTA BARAT,TAMBORA,8932,591,7110,153,1078,1669,2021-07-02
317107,JAKARTA PUSAT,TANAH ABANG,7904,622,6702,138,442,1064,2021-07-02
317202,JAKARTA UTARA,TANJUNG PRIOK,17176,687,14472,284,1733,2420,2021-07-02
317401,JAKARTA SELATAN,TEBET,10870,391,9076,177,1226,1617,2021-07-02
111111,Luar DKI & Proses Update,Luar DKI & Proses Update,143008,137,141294,1273,304,441,2021-07-03
317508,JAKARTA TIMUR,MAKASAR,12477,737,10222,186,1332,2069,2021-07-03
317403,JAKARTA SELATAN,MAMPANG PRAPATAN,7815,247,6581,120,867,1114,2021-07-03
317501,JAKARTA TIMUR,MATRAMAN,8957,386,7298,181,1092,1478,2021-07-03
317106,JAKARTA PUSAT,MENTENG,4441,424,3642,80,295,719,2021-07-03
317205,JAKARTA UTARA,PADEMANGAN,7782,364,6345,101,972,1336,2021-07-03
317307,JAKARTA BARAT,PALMERAH,11313,535,9135,209,1434,1969,2021-07-03
317408,JAKARTA SELATAN,PANCORAN,9143,314,7583,135,1111,1425,2021-07-03
317404,JAKARTA SELATAN,PASAR MINGGU,15416,582,13290,262,1282,1864,2021-07-03
317505,JAKARTA TIMUR,PASAR REBO,11536,542,9471,191,1332,1874,2021-07-03
317502,JAKARTA TIMUR,PULO GADUNG,14191,733,11883,231,1344,2077,2021-07-03
317410,JAKARTA SELATAN,PESANGGRAHAN,10289,328,8717,155,1089,1417,2021-07-03
317504,JAKARTA TIMUR,KRAMAT JATI,14723,601,11942,236,1944,2545,2021-07-03
317102,JAKARTA PUSAT,SAWAH BESAR,5825,352,4777,101,595,947,2021-07-03
317104,JAKARTA PUSAT,SENEN,6373,353,5219,115,686,1039,2021-07-03
317402,JAKARTA SELATAN,SETIA BUDI,7790,306,6405,111,968,1274,2021-07-03
317304,JAKARTA BARAT,TAMBORA,9151,703,7218,153,1077,1780,2021-07-03
317107,JAKARTA PUSAT,TANAH ABANG,8068,652,6718,138,560,1212,2021-07-03
317202,JAKARTA UTARA,TANJUNG PRIOK,17642,741,14530,285,2086,2827,2021-07-03
317401,JAKARTA SELATAN,TEBET,11006,453,9189,177,1187,1640,2021-07-03
317201,JAKARTA UTARA,PENJARINGAN,12427,1006,10042,145,1234,2240,2021-07-03
317203,JAKARTA UTARA,KOJA,11740,567,9679,203,1291,1858,2021-07-03
317303,JAKARTA BARAT,TAMAN SARI,5530,348,4574,84,524,872,2021-07-03
310102,KAB.ADM.KEP.SERIBU,KEP. SERIBU SELATAN,323,0,243,3,77,77,2021-07-03
310101,KAB.ADM.KEP.SERIBU,KEP. SERIBU UTARA,400,7,354,5,34,41,2021-07-03
317506,JAKARTA TIMUR,CAKUNG,15647,696,13503,261,1187,1883,2021-07-03
317301,JAKARTA BARAT,CENGKARENG,20027,1178,16516,370,1963,3141,2021-07-03
317406,JAKARTA SELATAN,CILANDAK,11299,438,9684,163,1014,1452,2021-07-03
317204,JAKARTA UTARA,CILINCING,10937,624,9252,201,860,1484,2021-07-03
317510,JAKARTA TIMUR,CIPAYUNG,15461,508,12583,163,2207,2715,2021-07-03
317509,JAKARTA TIMUR,CIRACAS,13933,541,11266,225,1901,2442,2021-07-03
317507,JAKARTA TIMUR,DUREN SAWIT,19305,779,16521,367,1638,2417,2021-07-03
317101,JAKARTA PUSAT,GAMBIR,5814,277,4713,80,744,1021,2021-07-03
317302,JAKARTA BARAT,GROGOL PETAMBURAN,12644,890,10117,190,1447,2337,2021-07-03
317105,JAKARTA PUSAT,CEMPAKA PUTIH,6935,619,5749,102,465,1084,2021-07-03
317503,JAKARTA TIMUR,JATINEGARA,12623,516,10359,218,1530,2046,2021-07-03
317108,JAKARTA PUSAT,JOHAR BARU,5991,400,4802,119,670,1070,2021-07-03
317306,JAKARTA BARAT,KALI DERES,11788,575,9774,194,1245,1820,2021-07-03
317407,JAKARTA SELATAN,KEBAYORAN BARU,9284,343,7740,122,1079,1422,2021-07-03
317405,JAKARTA SELATAN,KEBAYORAN LAMA,13262,630,11255,229,1148,1778,2021-07-03
317305,JAKARTA BARAT,KEBON JERUK,15323,770,12625,229,1699,2469,2021-07-03
317206,JAKARTA UTARA,KELAPA GADING,8514,425,7069,119,901,1326,2021-07-03
317308,JAKARTA BARAT,KEMBANGAN,13531,596,11049,164,1722,2318,2021-07-03
317103,JAKARTA PUSAT,KEMAYORAN,13926,614,11690,232,1390,2004,2021-07-03
317409,JAKARTA SELATAN,JAGAKARSA,15715,475,13814,250,1176,1651,2021-07-03
317205,JAKARTA UTARA,PADEMANGAN,8041,357,6473,102,1109,1466,2021-07-04
317106,JAKARTA PUSAT,MENTENG,4582,399,3703,81,399,798,2021-07-04
317504,JAKARTA TIMUR,KRAMAT JATI,15034,612,12046,238,2138,2750,2021-07-04
317403,JAKARTA SELATAN,MAMPANG PRAPATAN,8083,240,6631,121,1091,1331,2021-07-04
317508,JAKARTA TIMUR,MAKASAR,12594,732,10328,187,1347,2079,2021-07-04
317203,JAKARTA UTARA,KOJA,11851,581,9760,203,1307,1888,2021-07-04
317501,JAKARTA TIMUR,MATRAMAN,9174,393,7392,181,1208,1601,2021-07-04
317307,JAKARTA BARAT,PALMERAH,11498,551,9317,212,1418,1969,2021-07-04
317201,JAKARTA UTARA,PENJARINGAN,12751,1005,10269,146,1331,2336,2021-07-04
317404,JAKARTA SELATAN,PASAR MINGGU,15608,577,13463,263,1305,1882,2021-07-04
317505,JAKARTA TIMUR,PASAR REBO,11689,538,9544,193,1414,1952,2021-07-04
317410,JAKARTA SELATAN,PESANGGRAHAN,10449,332,8867,159,1091,1423,2021-07-04
317502,JAKARTA TIMUR,PULO GADUNG,14456,738,12131,235,1352,2090,2021-07-04
317102,JAKARTA PUSAT,SAWAH BESAR,5886,364,4811,101,610,974,2021-07-04
317104,JAKARTA PUSAT,SENEN,6491,378,5250,115,748,1126,2021-07-04
310101,KAB.ADM.KEP.SERIBU,KEP. SERIBU UTARA,408,10,354,5,39,49,2021-07-04
317402,JAKARTA SELATAN,SETIA BUDI,8052,319,6454,112,1167,1486,2021-07-04
317408,JAKARTA SELATAN,PANCORAN,9344,319,7643,135,1247,1566,2021-07-04
310102,KAB.ADM.KEP.SERIBU,KEP. SERIBU SELATAN,375,0,243,3,129,129,2021-07-04
317302,JAKARTA BARAT,GROGOL PETAMBURAN,12859,913,10299,192,1455,2368,2021-07-04
317103,JAKARTA PUSAT,KEMAYORAN,14126,612,11843,235,1436,2048,2021-07-04
317303,JAKARTA BARAT,TAMAN SARI,5599,362,4639,85,513,875,2021-07-04
317506,JAKARTA TIMUR,CAKUNG,15853,712,13627,262,1252,1964,2021-07-04
317105,JAKARTA PUSAT,CEMPAKA PUTIH,6993,553,5920,102,418,971,2021-07-04
317301,JAKARTA BARAT,CENGKARENG,20393,1249,16698,371,2075,3324,2021-07-04
317406,JAKARTA SELATAN,CILANDAK,11422,456,9766,165,1035,1491,2021-07-04
317204,JAKARTA UTARA,CILINCING,11205,638,9464,204,899,1537,2021-07-04
317510,JAKARTA TIMUR,CIPAYUNG,15978,491,12700,164,2623,3114,2021-07-04
317509,JAKARTA TIMUR,CIRACAS,14363,518,11376,228,2241,2759,2021-07-04
317308,JAKARTA BARAT,KEMBANGAN,13818,652,11170,167,1829,2481,2021-07-04
317507,JAKARTA TIMUR,DUREN SAWIT,19519,777,16685,370,1687,2464,2021-07-04
317409,JAKARTA SELATAN,JAGAKARSA,16183,455,13993,251,1484,1939,2021-07-04
317503,JAKARTA TIMUR,JATINEGARA,12922,518,10472,220,1712,2230,2021-07-04
317108,JAKARTA PUSAT,JOHAR BARU,6036,405,4864,122,645,1050,2021-07-04
317306,JAKARTA BARAT,KALI DERES,11998,597,9833,197,1371,1968,2021-07-04
317407,JAKARTA SELATAN,KEBAYORAN BARU,9540,351,7806,122,1261,1612,2021-07-04
317405,JAKARTA SELATAN,KEBAYORAN LAMA,13452,608,11467,234,1143,1751,2021-07-04
317305,JAKARTA BARAT,KEBON JERUK,15541,803,12748,230,1760,2563,2021-07-04
317206,JAKARTA UTARA,KELAPA GADING,8688,422,7183,123,960,1382,2021-07-04
317101,JAKARTA PUSAT,GAMBIR,5932,287,4770,81,794,1081,2021-07-04
317107,JAKARTA PUSAT,TANAH ABANG,8175,577,6866,138,594,1171,2021-07-04
111111,Luar DKI & Proses Update,Luar DKI & Proses Update,143008,137,141294,1273,304,441,2021-07-04
317304,JAKARTA BARAT,TAMBORA,9293,728,7304,155,1106,1834,2021-07-04
317401,JAKARTA SELATAN,TEBET,11362,459,9283,179,1441,1900,2021-07-04
317202,JAKARTA UTARA,TANJUNG PRIOK,18125,744,14777,288,2316,3060,2021-07-04
317403,JAKARTA SELATAN,MAMPANG PRAPATAN,8236,256,6733,121,1126,1382,2021-07-05
317501,JAKARTA TIMUR,MATRAMAN,9235,393,7478,184,1180,1573,2021-07-05
317106,JAKARTA PUSAT,MENTENG,4604,345,3787,83,389,734,2021-07-05
317205,JAKARTA UTARA,PADEMANGAN,8245,376,6524,102,1243,1619,2021-07-05
317307,JAKARTA BARAT,PALMERAH,11753,545,9656,215,1337,1882,2021-07-05
317408,JAKARTA SELATAN,PANCORAN,9697,334,7679,139,1545,1879,2021-07-05
317404,JAKARTA SELATAN,PASAR MINGGU,15986,634,13631,269,1452,2086,2021-07-05
317201,JAKARTA UTARA,PENJARINGAN,12829,970,10352,148,1359,2329,2021-07-05
317410,JAKARTA SELATAN,PESANGGRAHAN,10544,340,8928,161,1115,1455,2021-07-05
317102,JAKARTA PUSAT,SAWAH BESAR,6002,365,4881,102,654,1019,2021-07-05
317508,JAKARTA TIMUR,MAKASAR,13006,766,10604,189,1447,2213,2021-07-05
317104,JAKARTA PUSAT,SENEN,6642,416,5357,116,753,1169,2021-07-05
317402,JAKARTA SELATAN,SETIA BUDI,8238,323,6503,115,1297,1620,2021-07-05
317303,JAKARTA BARAT,TAMAN SARI,5838,357,4709,90,682,1039,2021-07-05
317304,JAKARTA BARAT,TAMBORA,9442,735,7505,160,1042,1777,2021-07-05
317107,JAKARTA PUSAT,TANAH ABANG,8318,504,7048,144,622,1126,2021-07-05
317202,JAKARTA UTARA,TANJUNG PRIOK,18386,751,14848,291,2496,3247,2021-07-05
317401,JAKARTA SELATAN,TEBET,11760,482,9348,181,1749,2231,2021-07-05
111111,Luar DKI & Proses Update,Luar DKI & Proses Update,143008,137,141294,1273,304,441,2021-07-05
317502,JAKARTA TIMUR,PULO GADUNG,14601,763,12235,238,1365,2128,2021-07-05
317504,JAKARTA TIMUR,KRAMAT JATI,15351,654,12292,248,2157,2811,2021-07-05
317505,JAKARTA TIMUR,PASAR REBO,12039,565,9727,195,1552,2117,2021-07-05
310101,KAB.ADM.KEP.SERIBU,KEP. SERIBU UTARA,415,10,358,5,42,52,2021-07-05
317506,JAKARTA TIMUR,CAKUNG,16276,782,13713,264,1517,2299,2021-07-05
317203,JAKARTA UTARA,KOJA,12011,648,9801,206,1356,2004,2021-07-05
317301,JAKARTA BARAT,CENGKARENG,20772,1248,16972,386,2166,3414,2021-07-05
317406,JAKARTA SELATAN,CILANDAK,11612,481,9899,165,1067,1548,2021-07-05
317204,JAKARTA UTARA,CILINCING,11492,711,9501,208,1072,1783,2021-07-05
317510,JAKARTA TIMUR,CIPAYUNG,16650,494,13013,166,2977,3471,2021-07-05
317509,JAKARTA TIMUR,CIRACAS,15021,573,11683,231,2534,3107,2021-07-05
317507,JAKARTA TIMUR,DUREN SAWIT,19858,817,16774,374,1893,2710,2021-07-05
317101,JAKARTA PUSAT,GAMBIR,6048,279,4895,81,793,1072,2021-07-05
317302,JAKARTA BARAT,GROGOL PETAMBURAN,13065,897,10489,194,1485,2382,2021-07-05
317409,JAKARTA SELATAN,JAGAKARSA,16494,465,14098,254,1677,2142,2021-07-05
317105,JAKARTA PUSAT,CEMPAKA PUTIH,7074,567,6032,102,373,940,2021-07-05
317108,JAKARTA PUSAT,JOHAR BARU,6130,451,5018,123,538,989,2021-07-05
317503,JAKARTA TIMUR,JATINEGARA,13062,547,10535,223,1757,2304,2021-07-05
317308,JAKARTA BARAT,KEMBANGAN,14145,668,11465,169,1843,2511,2021-07-05
317103,JAKARTA PUSAT,KEMAYORAN,14331,620,11935,240,1536,2156,2021-07-05
317206,JAKARTA UTARA,KELAPA GADING,8779,451,7222,123,983,1434,2021-07-05
310102,KAB.ADM.KEP.SERIBU,KEP. SERIBU SELATAN,415,0,243,3,169,169,2021-07-05
317405,JAKARTA SELATAN,KEBAYORAN LAMA,13674,548,11681,236,1209,1757,2021-07-05
317407,JAKARTA SELATAN,KEBAYORAN BARU,9762,362,7877,122,1401,1763,2021-07-05
317306,JAKARTA BARAT,KALI DERES,12089,590,10049,199,1251,1841,2021-07-05
317305,JAKARTA BARAT,KEBON JERUK,15829,826,13026,232,1745,2571,2021-07-05
317505,JAKARTA TIMUR,PASAR REBO,12159,569,9931,198,1461,2030,2021-07-06
317501,JAKARTA TIMUR,MATRAMAN,9562,387,7573,186,1416,1803,2021-07-06
317106,JAKARTA PUSAT,MENTENG,4698,358,3796,83,461,819,2021-07-06
317205,JAKARTA UTARA,PADEMANGAN,8498,377,6671,102,1348,1725,2021-07-06
317307,JAKARTA BARAT,PALMERAH,11838,546,9706,220,1366,1912,2021-07-06
317408,JAKARTA SELATAN,PANCORAN,9867,356,7872,140,1499,1855,2021-07-06
317403,JAKARTA SELATAN,MAMPANG PRAPATAN,8396,272,6834,123,1167,1439,2021-07-06
317404,JAKARTA SELATAN,PASAR MINGGU,16172,661,13748,271,1492,2153,2021-07-06
317201,JAKARTA UTARA,PENJARINGAN,13137,997,10641,150,1349,2346,2021-07-06
317402,JAKARTA SELATAN,SETIA BUDI,8387,310,6679,116,1282,1592,2021-07-06
317502,JAKARTA TIMUR,PULO GADUNG,14849,751,12379,240,1479,2230,2021-07-06
317102,JAKARTA PUSAT,SAWAH BESAR,6052,374,4959,102,617,991,2021-07-06
317104,JAKARTA PUSAT,SENEN,6730,447,5457,117,709,1156,2021-07-06
317303,JAKARTA BARAT,TAMAN SARI,5950,368,4737,90,755,1123,2021-07-06
317304,JAKARTA BARAT,TAMBORA,9684,760,7569,160,1195,1955,2021-07-06
317107,JAKARTA PUSAT,TANAH ABANG,8467,509,7095,145,718,1227,2021-07-06
317202,JAKARTA UTARA,TANJUNG PRIOK,18802,809,15068,293,2632,3441,2021-07-06
111111,Luar DKI & Proses Update,Luar DKI & Proses Update,143008,137,141294,1273,304,441,2021-07-06
317508,JAKARTA TIMUR,MAKASAR,13139,755,10816,189,1379,2134,2021-07-06
317410,JAKARTA SELATAN,PESANGGRAHAN,10643,362,8987,162,1132,1494,2021-07-06
317504,JAKARTA TIMUR,KRAMAT JATI,15502,668,12564,253,2017,2685,2021-07-06
317401,JAKARTA SELATAN,TEBET,11901,484,9484,182,1751,2235,2021-07-06
310101,KAB.ADM.KEP.SERIBU,KEP. SERIBU UTARA,425,10,358,5,52,62,2021-07-06
317105,JAKARTA PUSAT,CEMPAKA PUTIH,7180,630,6051,102,397,1027,2021-07-06
317301,JAKARTA BARAT,CENGKARENG,20956,1265,17083,396,2212,3477,2021-07-06
317406,JAKARTA SELATAN,CILANDAK,11703,499,9952,166,1086,1585,2021-07-06
317204,JAKARTA UTARA,CILINCING,11783,742,9654,211,1176,1918,2021-07-06
317510,JAKARTA TIMUR,CIPAYUNG,17009,501,13146,166,3196,3697,2021-07-06
317509,JAKARTA TIMUR,CIRACAS,15234,596,11825,232,2581,3177,2021-07-06
317507,JAKARTA TIMUR,DUREN SAWIT,20146,822,17066,379,1879,2701,2021-07-06
317101,JAKARTA PUSAT,GAMBIR,6183,302,4910,83,888,1190,2021-07-06
317302,JAKARTA BARAT,GROGOL PETAMBURAN,13318,904,10557,197,1660,2564,2021-07-06
317203,JAKARTA UTARA,KOJA,12388,668,10022,209,1489,2157,2021-07-06
317409,JAKARTA SELATAN,JAGAKARSA,16621,516,14264,254,1587,2103,2021-07-06
317108,JAKARTA PUSAT,JOHAR BARU,6230,515,5069,123,523,1038,2021-07-06
317306,JAKARTA BARAT,KALI DERES,12356,617,10103,202,1434,2051,2021-07-06
317407,JAKARTA SELATAN,KEBAYORAN BARU,9932,380,7976,123,1453,1833,2021-07-06
317405,JAKARTA SELATAN,KEBAYORAN LAMA,13814,554,11776,238,1246,1800,2021-07-06
317305,JAKARTA BARAT,KEBON JERUK,16062,819,13117,234,1892,2711,2021-07-06
317206,JAKARTA UTARA,KELAPA GADING,8944,420,7376,125,1023,1443,2021-07-06
317103,JAKARTA PUSAT,KEMAYORAN,14562,648,12079,247,1588,2236,2021-07-06
317308,JAKARTA BARAT,KEMBANGAN,14419,715,11500,170,2034,2749,2021-07-06
310102,KAB.ADM.KEP.SERIBU,KEP. SERIBU SELATAN,440,1,243,3,193,194,2021-07-06
317503,JAKARTA TIMUR,JATINEGARA,13275,556,10784,225,1710,2266,2021-07-06
317506,JAKARTA TIMUR,CAKUNG,16665,781,13829,264,1791,2572,2021-07-06
317406,JAKARTA SELATAN,CILANDAK,11813,508,10010,173,1122,1630,2021-07-07
111111,Luar DKI & Proses Update,Luar DKI & Proses Update,143008,137,141294,1273,304,441,2021-07-07
317508,JAKARTA TIMUR,MAKASAR,13386,812,10882,200,1492,2304,2021-07-07
317403,JAKARTA SELATAN,MAMPANG PRAPATAN,8499,291,6870,122,1216,1507,2021-07-07
317501,JAKARTA TIMUR,MATRAMAN,9737,402,7626,188,1521,1923,2021-07-07
317106,JAKARTA PUSAT,MENTENG,4731,356,3810,89,476,832,2021-07-07
317205,JAKARTA UTARA,PADEMANGAN,8673,393,6877,108,1295,1688,2021-07-07
317307,JAKARTA BARAT,PALMERAH,12056,567,9861,224,1404,1971,2021-07-07
317408,JAKARTA SELATAN,PANCORAN,10184,384,7905,138,1757,2141,2021-07-07
317404,JAKARTA SELATAN,PASAR MINGGU,16393,671,13841,274,1607,2278,2021-07-07
317201,JAKARTA UTARA,PENJARINGAN,13332,1053,10804,147,1328,2381,2021-07-07
317410,JAKARTA SELATAN,PESANGGRAHAN,10764,371,9059,164,1170,1541,2021-07-07
317502,JAKARTA TIMUR,PULO GADUNG,15163,822,12472,241,1628,2450,2021-07-07
317102,JAKARTA PUSAT,SAWAH BESAR,6237,424,4996,106,711,1135,2021-07-07
317104,JAKARTA PUSAT,SENEN,6933,456,5542,119,816,1272,2021-07-07
317402,JAKARTA SELATAN,SETIA BUDI,8517,325,6750,120,1322,1647,2021-07-07
317303,JAKARTA BARAT,TAMAN SARI,6063,410,4760,93,800,1210,2021-07-07
317304,JAKARTA BARAT,TAMBORA,9955,822,7698,161,1274,2096,2021-07-07
317107,JAKARTA PUSAT,TANAH ABANG,8547,519,7149,148,731,1250,2021-07-07
317202,JAKARTA UTARA,TANJUNG PRIOK,19019,841,15539,294,2345,3186,2021-07-07
317401,JAKARTA SELATAN,TEBET,12047,518,9546,179,1804,2322,2021-07-07
317504,JAKARTA TIMUR,KRAMAT JATI,15678,696,12769,253,1960,2656,2021-07-07
317203,JAKARTA UTARA,KOJA,12679,685,10219,217,1558,2243,2021-07-07
317505,JAKARTA TIMUR,PASAR REBO,12458,588,10117,207,1546,2134,2021-07-07
310102,KAB.ADM.KEP.SERIBU,KEP. SERIBU SELATAN,469,1,240,6,222,223,2021-07-07
310101,KAB.ADM.KEP.SERIBU,KEP. SERIBU UTARA,429,9,362,5,53,62,2021-07-07
317506,JAKARTA TIMUR,CAKUNG,16966,798,13999,268,1901,2699,2021-07-07
317105,JAKARTA PUSAT,CEMPAKA PUTIH,7402,613,6162,114,513,1126,2021-07-07
317301,JAKARTA BARAT,CENGKARENG,21347,1275,17253,407,2412,3687,2021-07-07
317204,JAKARTA UTARA,CILINCING,12149,766,9897,224,1262,2028,2021-07-07
317510,JAKARTA TIMUR,CIPAYUNG,17415,510,13376,172,3357,3867,2021-07-07
317507,JAKARTA TIMUR,DUREN SAWIT,20505,860,17135,394,2116,2976,2021-07-07
317101,JAKARTA PUSAT,GAMBIR,6256,309,4929,91,927,1236,2021-07-07
317302,JAKARTA BARAT,GROGOL PETAMBURAN,13652,967,10635,203,1847,2814,2021-07-07
317409,JAKARTA SELATAN,JAGAKARSA,16793,527,14352,261,1653,2180,2021-07-07
317509,JAKARTA TIMUR,CIRACAS,15598,605,12108,236,2649,3254,2021-07-07
317308,JAKARTA BARAT,KEMBANGAN,14609,715,11637,173,2084,2799,2021-07-07
317108,JAKARTA PUSAT,JOHAR BARU,6410,513,5132,114,651,1164,2021-07-07
317306,JAKARTA BARAT,KALI DERES,12687,624,10214,207,1642,2266,2021-07-07
317407,JAKARTA SELATAN,KEBAYORAN BARU,10078,415,8067,124,1472,1887,2021-07-07
317405,JAKARTA SELATAN,KEBAYORAN LAMA,14016,582,11883,243,1308,1890,2021-07-07
317305,JAKARTA BARAT,KEBON JERUK,16231,862,13199,235,1935,2797,2021-07-07
317206,JAKARTA UTARA,KELAPA GADING,9143,458,7480,126,1079,1537,2021-07-07
317103,JAKARTA PUSAT,KEMAYORAN,14730,668,12184,243,1635,2303,2021-07-07
317503,JAKARTA TIMUR,JATINEGARA,13662,559,10884,233,1986,2545,2021-07-07
317404,JAKARTA SELATAN,PASAR MINGGU,16592,638,13977,279,1698,2336,2021-07-08
317408,JAKARTA SELATAN,PANCORAN,10287,382,8047,141,1717,2099,2021-07-08
317307,JAKARTA BARAT,PALMERAH,12299,566,10079,224,1430,1996,2021-07-08
317205,JAKARTA UTARA,PADEMANGAN,8947,396,7090,112,1349,1745,2021-07-08
317508,JAKARTA TIMUR,MAKASAR,13610,813,11278,200,1319,2132,2021-07-08
317501,JAKARTA TIMUR,MATRAMAN,10094,402,7738,190,1764,2166,2021-07-08
317403,JAKARTA SELATAN,MAMPANG PRAPATAN,8614,289,6981,122,1222,1511,2021-07-08
317505,JAKARTA TIMUR,PASAR REBO,12797,596,10382,212,1607,2203,2021-07-08
317106,JAKARTA PUSAT,MENTENG,4825,308,3892,89,536,844,2021-07-08
317201,JAKARTA UTARA,PENJARINGAN,13573,1057,11097,147,1272,2329,2021-07-08
317401,JAKARTA SELATAN,TEBET,12186,499,9742,182,1763,2262,2021-07-08
317502,JAKARTA TIMUR,PULO GADUNG,15514,791,12747,243,1733,2524,2021-07-08
317102,JAKARTA PUSAT,SAWAH BESAR,6390,426,5086,107,771,1197,2021-07-08
317104,JAKARTA PUSAT,SENEN,7087,430,5618,122,917,1347,2021-07-08
317402,JAKARTA SELATAN,SETIA BUDI,8709,328,6908,125,1348,1676,2021-07-08
317303,JAKARTA BARAT,TAMAN SARI,6347,434,4879,93,941,1375,2021-07-08
317304,JAKARTA BARAT,TAMBORA,10238,843,7963,165,1267,2110,2021-07-08
317107,JAKARTA PUSAT,TANAH ABANG,8679,448,7285,148,798,1246,2021-07-08
317202,JAKARTA UTARA,TANJUNG PRIOK,19515,824,15844,296,2551,3375,2021-07-08
317504,JAKARTA TIMUR,KRAMAT JATI,16037,677,13077,258,2025,2702,2021-07-08
317410,JAKARTA SELATAN,PESANGGRAHAN,11023,390,9349,164,1120,1510,2021-07-08
317203,JAKARTA UTARA,KOJA,13062,660,10463,217,1722,2382,2021-07-08
111111,Luar DKI & Proses Update,Luar DKI & Proses Update,143008,137,141294,1273,304,441,2021-07-08
310102,KAB.ADM.KEP.SERIBU,KEP. SERIBU SELATAN,469,1,244,6,218,219,2021-07-08
317105,JAKARTA PUSAT,CEMPAKA PUTIH,7522,557,6296,114,555,1112,2021-07-08
317301,JAKARTA BARAT,CENGKARENG,21798,1283,17856,409,2250,3533,2021-07-08
317406,JAKARTA SELATAN,CILANDAK,12125,481,10125,174,1345,1826,2021-07-08
317204,JAKARTA UTARA,CILINCING,12446,723,10102,225,1396,2119,2021-07-08
317510,JAKARTA TIMUR,CIPAYUNG,18004,507,13711,174,3612,4119,2021-07-08
317509,JAKARTA TIMUR,CIRACAS,16094,580,12560,238,2716,3296,2021-07-08
317507,JAKARTA TIMUR,DUREN SAWIT,20924,817,17472,394,2241,3058,2021-07-08
317101,JAKARTA PUSAT,GAMBIR,6351,312,5012,91,936,1248,2021-07-08
310101,KAB.ADM.KEP.SERIBU,KEP. SERIBU UTARA,434,12,365,5,52,64,2021-07-08
317302,JAKARTA BARAT,GROGOL PETAMBURAN,14082,893,10993,203,1993,2886,2021-07-08
317503,JAKARTA TIMUR,JATINEGARA,13880,526,11151,234,1969,2495,2021-07-08
317108,JAKARTA PUSAT,JOHAR BARU,6480,526,5170,116,668,1194,2021-07-08
317306,JAKARTA BARAT,KALI DERES,12963,632,10465,208,1658,2290,2021-07-08
317407,JAKARTA SELATAN,KEBAYORAN BARU,10298,437,8252,124,1485,1922,2021-07-08
317405,JAKARTA SELATAN,KEBAYORAN LAMA,14316,581,12046,244,1445,2026,2021-07-08
317305,JAKARTA BARAT,KEBON JERUK,16617,806,13582,237,1992,2798,2021-07-08
317206,JAKARTA UTARA,KELAPA GADING,9403,416,7661,126,1200,1616,2021-07-08
317103,JAKARTA PUSAT,KEMAYORAN,15024,661,12395,243,1725,2386,2021-07-08
317308,JAKARTA BARAT,KEMBANGAN,14977,700,11946,173,2158,2858,2021-07-08
317409,JAKARTA SELATAN,JAGAKARSA,16981,528,14599,262,1592,2120,2021-07-08
317506,JAKARTA TIMUR,CAKUNG,17209,810,14236,272,1891,2701,2021-07-08
317506,JAKARTA TIMUR,CAKUNG,17505,755,14583,276,1891,2646,2021-07-09
317105,JAKARTA PUSAT,CEMPAKA PUTIH,7656,494,6545,116,501,995,2021-07-09
317406,JAKARTA SELATAN,CILANDAK,12361,449,10471,175,1266,1715,2021-07-09
317205,JAKARTA UTARA,PADEMANGAN,9048,368,7283,114,1283,1651,2021-07-09
317307,JAKARTA BARAT,PALMERAH,12601,547,10359,232,1463,2010,2021-07-09
317408,JAKARTA SELATAN,PANCORAN,10637,317,8298,144,1878,2195,2021-07-09
317404,JAKARTA SELATAN,PASAR MINGGU,17096,575,14421,284,1816,2391,2021-07-09
317505,JAKARTA TIMUR,PASAR REBO,13079,560,10542,217,1760,2320,2021-07-09
317201,JAKARTA UTARA,PENJARINGAN,13989,909,11509,147,1424,2333,2021-07-09
317410,JAKARTA SELATAN,PESANGGRAHAN,11378,363,9623,167,1225,1588,2021-07-09
317502,JAKARTA TIMUR,PULO GADUNG,15925,699,13104,249,1873,2572,2021-07-09
317106,JAKARTA PUSAT,MENTENG,4888,289,4012,93,494,783,2021-07-09
317102,JAKARTA PUSAT,SAWAH BESAR,6595,402,5290,109,794,1196,2021-07-09
317402,JAKARTA SELATAN,SETIA BUDI,8867,265,7195,127,1280,1545,2021-07-09
317303,JAKARTA BARAT,TAMAN SARI,6545,408,5096,94,947,1355,2021-07-09
317304,JAKARTA BARAT,TAMBORA,10560,805,8313,169,1273,2078,2021-07-09
317107,JAKARTA PUSAT,TANAH ABANG,8864,425,7456,149,834,1259,2021-07-09
317202,JAKARTA UTARA,TANJUNG PRIOK,19772,725,16265,305,2477,3202,2021-07-09
317401,JAKARTA SELATAN,TEBET,12445,437,10179,186,1643,2080,2021-07-09
317301,JAKARTA BARAT,CENGKARENG,22278,1149,18518,420,2191,3340,2021-07-09
111111,Luar DKI & Proses Update,Luar DKI & Proses Update,143008,137,141294,1273,304,441,2021-07-09
317104,JAKARTA PUSAT,SENEN,7250,375,5862,126,887,1262,2021-07-09
317501,JAKARTA TIMUR,MATRAMAN,10374,366,7990,197,1821,2187,2021-07-09
317204,JAKARTA UTARA,CILINCING,12771,669,10385,230,1487,2156,2021-07-09
317508,JAKARTA TIMUR,MAKASAR,13814,653,11518,205,1438,2091,2021-07-09
317403,JAKARTA SELATAN,MAMPANG PRAPATAN,8835,247,7257,124,1207,1454,2021-07-09
317509,JAKARTA TIMUR,CIRACAS,16406,518,12762,243,2883,3401,2021-07-09
317510,JAKARTA TIMUR,CIPAYUNG,18464,467,14068,174,3755,4222,2021-07-09
317507,JAKARTA TIMUR,DUREN SAWIT,21320,744,17942,397,2237,2981,2021-07-09
317101,JAKARTA PUSAT,GAMBIR,6511,269,5232,92,918,1187,2021-07-09
317302,JAKARTA BARAT,GROGOL PETAMBURAN,14352,818,11480,210,1844,2662,2021-07-09
317503,JAKARTA TIMUR,JATINEGARA,14167,473,11453,243,1998,2471,2021-07-09
317108,JAKARTA PUSAT,JOHAR BARU,6626,598,5358,120,550,1148,2021-07-09
317306,JAKARTA BARAT,KALI DERES,13299,571,10824,211,1693,2264,2021-07-09
317409,JAKARTA SELATAN,JAGAKARSA,17537,521,14917,269,1830,2351,2021-07-09
317405,JAKARTA SELATAN,KEBAYORAN LAMA,14586,537,12407,249,1393,1930,2021-07-09
317305,JAKARTA BARAT,KEBON JERUK,16951,782,14087,247,1835,2617,2021-07-09
317206,JAKARTA UTARA,KELAPA GADING,9570,363,7898,127,1182,1545,2021-07-09
317103,JAKARTA PUSAT,KEMAYORAN,15173,577,12890,248,1458,2035,2021-07-09
317308,JAKARTA BARAT,KEMBANGAN,15308,628,12544,179,1957,2585,2021-07-09
310102,KAB.ADM.KEP.SERIBU,KEP. SERIBU SELATAN,499,3,252,6,238,241,2021-07-09
310101,KAB.ADM.KEP.SERIBU,KEP. SERIBU UTARA,448,13,374,5,56,69,2021-07-09
317504,JAKARTA TIMUR,KRAMAT JATI,16309,576,13285,270,2178,2754,2021-07-09
317407,JAKARTA SELATAN,KEBAYORAN BARU,10487,365,8517,126,1479,1844,2021-07-09
317203,JAKARTA UTARA,KOJA,13342,599,10798,220,1725,2324,2021-07-09
317505,JAKARTA TIMUR,PASAR REBO,13350,496,10899,219,1736,2232,2021-07-10
317404,JAKARTA SELATAN,PASAR MINGGU,17367,509,14833,285,1740,2249,2021-07-10
317408,JAKARTA SELATAN,PANCORAN,10791,282,8642,145,1722,2004,2021-07-10
317106,JAKARTA PUSAT,MENTENG,4993,124,4227,93,549,673,2021-07-10
317205,JAKARTA UTARA,PADEMANGAN,9316,316,7459,115,1426,1742,2021-07-10
317501,JAKARTA TIMUR,MATRAMAN,10862,322,8444,198,1898,2220,2021-07-10
317201,JAKARTA UTARA,PENJARINGAN,14267,835,11912,150,1370,2205,2021-07-10
317307,JAKARTA BARAT,PALMERAH,12825,516,10565,233,1511,2027,2021-07-10
317410,JAKARTA SELATAN,PESANGGRAHAN,11493,320,9918,168,1087,1407,2021-07-10
317401,JAKARTA SELATAN,TEBET,12924,377,10560,187,1800,2177,2021-07-10
317102,JAKARTA PUSAT,SAWAH BESAR,6698,361,5499,109,729,1090,2021-07-10
317104,JAKARTA PUSAT,SENEN,7413,321,6092,127,873,1194,2021-07-10
317402,JAKARTA SELATAN,SETIA BUDI,9043,254,7424,127,1238,1492,2021-07-10
317303,JAKARTA BARAT,TAMAN SARI,6722,382,5309,94,937,1319,2021-07-10
317304,JAKARTA BARAT,TAMBORA,10809,722,8770,170,1147,1869,2021-07-10
317107,JAKARTA PUSAT,TANAH ABANG,8990,276,7708,150,856,1132,2021-07-10
317202,JAKARTA UTARA,TANJUNG PRIOK,20293,682,16532,312,2767,3449,2021-07-10
317403,JAKARTA SELATAN,MAMPANG PRAPATAN,8919,201,7441,124,1153,1354,2021-07-10
111111,Luar DKI & Proses Update,Luar DKI & Proses Update,143008,137,141294,1273,304,441,2021-07-10
317502,JAKARTA TIMUR,PULO GADUNG,16375,647,13642,250,1836,2483,2021-07-10
317508,JAKARTA TIMUR,MAKASAR,14029,548,11997,205,1279,1827,2021-07-10
317405,JAKARTA SELATAN,KEBAYORAN LAMA,14834,485,12734,250,1365,1850,2021-07-10
317203,JAKARTA UTARA,KOJA,13598,554,11223,221,1600,2154,2021-07-10
317506,JAKARTA TIMUR,CAKUNG,17894,695,15168,278,1753,2448,2021-07-10
317105,JAKARTA PUSAT,CEMPAKA PUTIH,7757,392,6770,116,479,871,2021-07-10
317301,JAKARTA BARAT,CENGKARENG,22816,1095,19079,420,2222,3317,2021-07-10
317406,JAKARTA SELATAN,CILANDAK,12578,353,10785,176,1264,1617,2021-07-10
317510,JAKARTA TIMUR,CIPAYUNG,18688,396,14647,174,3471,3867,2021-07-10
317509,JAKARTA TIMUR,CIRACAS,16740,456,13205,243,2836,3292,2021-07-10
317507,JAKARTA TIMUR,DUREN SAWIT,21682,697,18517,402,2066,2763,2021-07-10
317101,JAKARTA PUSAT,GAMBIR,6751,225,5426,92,1008,1233,2021-07-10
317302,JAKARTA BARAT,GROGOL PETAMBURAN,14718,708,12033,211,1766,2474,2021-07-10
317504,JAKARTA TIMUR,KRAMAT JATI,16611,516,13734,274,2087,2603,2021-07-10
317409,JAKARTA SELATAN,JAGAKARSA,18011,472,15297,272,1970,2442,2021-07-10
317108,JAKARTA PUSAT,JOHAR BARU,6706,452,5683,120,451,903,2021-07-10
317306,JAKARTA BARAT,KALI DERES,13552,554,11303,211,1484,2038,2021-07-10
317407,JAKARTA SELATAN,KEBAYORAN BARU,10691,298,8801,127,1465,1763,2021-07-10
317305,JAKARTA BARAT,KEBON JERUK,17302,772,14462,247,1821,2593,2021-07-10
317206,JAKARTA UTARA,KELAPA GADING,9761,330,8196,129,1106,1436,2021-07-10
317103,JAKARTA PUSAT,KEMAYORAN,15405,519,13300,248,1338,1857,2021-07-10
317308,JAKARTA BARAT,KEMBANGAN,15641,597,12804,180,2060,2657,2021-07-10
310102,KAB.ADM.KEP.SERIBU,KEP. SERIBU SELATAN,509,3,259,6,241,244,2021-07-10
310101,KAB.ADM.KEP.SERIBU,KEP. SERIBU UTARA,457,12,383,5,57,69,2021-07-10
317503,JAKARTA TIMUR,JATINEGARA,14608,433,12022,245,1908,2341,2021-07-10
317204,JAKARTA UTARA,CILINCING,13030,661,10683,231,1455,2116,2021-07-10
111111,Luar DKI & Proses Update,Luar DKI & Proses Update,143008,137,141294,1273,304,441,2021-07-11
317307,JAKARTA BARAT,PALMERAH,13050,378,11314,235,1123,1501,2021-07-11
317503,JAKARTA TIMUR,JATINEGARA,14996,342,12539,250,1865,2207,2021-07-11
317103,JAKARTA PUSAT,KEMAYORAN,15665,372,13878,248,1167,1539,2021-07-11
317206,JAKARTA UTARA,KELAPA GADING,9871,289,8376,129,1077,1366,2021-07-11
317305,JAKARTA BARAT,KEBON JERUK,17583,597,15272,248,1466,2063,2021-07-11
317405,JAKARTA SELATAN,KEBAYORAN LAMA,15046,435,13157,251,1203,1638,2021-07-11
317407,JAKARTA SELATAN,KEBAYORAN BARU,10815,261,9266,127,1161,1422,2021-07-11
317306,JAKARTA BARAT,KALI DERES,13977,510,11739,213,1515,2025,2021-07-11
317108,JAKARTA PUSAT,JOHAR BARU,6904,412,6052,120,320,732,2021-07-11
317104,JAKARTA PUSAT,SENEN,7613,233,6416,127,837,1070,2021-07-11
317409,JAKARTA SELATAN,JAGAKARSA,18615,451,15593,274,2297,2748,2021-07-11
317302,JAKARTA BARAT,GROGOL PETAMBURAN,15164,588,12604,211,1761,2349,2021-07-11
317101,JAKARTA PUSAT,GAMBIR,6842,161,5783,92,806,967,2021-07-11
317507,JAKARTA TIMUR,DUREN SAWIT,22098,569,19061,404,2064,2633,2021-07-11
317509,JAKARTA TIMUR,CIRACAS,17161,355,13827,243,2736,3091,2021-07-11
317510,JAKARTA TIMUR,CIPAYUNG,19382,330,15198,174,3680,4010,2021-07-11
317204,JAKARTA UTARA,CILINCING,13227,547,10979,231,1470,2017,2021-07-11
317406,JAKARTA SELATAN,CILANDAK,12775,267,11270,177,1061,1328,2021-07-11
317301,JAKARTA BARAT,CENGKARENG,23222,910,19914,423,1975,2885,2021-07-11
317308,JAKARTA BARAT,KEMBANGAN,15936,492,13516,182,1746,2238,2021-07-11
310102,KAB.ADM.KEP.SERIBU,KEP. SERIBU SELATAN,540,6,317,6,211,217,2021-07-11
310101,KAB.ADM.KEP.SERIBU,KEP. SERIBU UTARA,464,8,402,5,49,57,2021-07-11
317203,JAKARTA UTARA,KOJA,13775,489,11504,222,1560,2049,2021-07-11
317402,JAKARTA SELATAN,SETIA BUDI,9145,198,7727,127,1093,1291,2021-07-11
317303,JAKARTA BARAT,TAMAN SARI,6854,305,5502,94,953,1258,2021-07-11
317304,JAKARTA BARAT,TAMBORA,11096,588,9209,170,1129,1717,2021-07-11
317107,JAKARTA PUSAT,TANAH ABANG,9116,224,8003,152,737,961,2021-07-11
317202,JAKARTA UTARA,TANJUNG PRIOK,20695,670,17242,314,2469,3139,2021-07-11
317401,JAKARTA SELATAN,TEBET,13205,292,10959,188,1766,2058,2021-07-11
317502,JAKARTA TIMUR,PULO GADUNG,16765,542,14023,251,1949,2491,2021-07-11
317410,JAKARTA SELATAN,PESANGGRAHAN,11895,260,10258,168,1209,1469,2021-07-11
317105,JAKARTA PUSAT,CEMPAKA PUTIH,7914,357,7007,117,433,790,2021-07-11
317201,JAKARTA UTARA,PENJARINGAN,14513,690,12440,150,1233,1923,2021-07-11
317404,JAKARTA SELATAN,PASAR MINGGU,17743,437,15372,285,1649,2086,2021-07-11
317408,JAKARTA SELATAN,PANCORAN,11039,231,9051,146,1611,1842,2021-07-11
317205,JAKARTA UTARA,PADEMANGAN,9483,306,7811,116,1250,1556,2021-07-11
317106,JAKARTA PUSAT,MENTENG,5096,91,4362,93,550,641,2021-07-11
317501,JAKARTA TIMUR,MATRAMAN,10985,283,8617,199,1886,2169,2021-07-11
317403,JAKARTA SELATAN,MAMPANG PRAPATAN,9199,171,7754,125,1149,1320,2021-07-11
317508,JAKARTA TIMUR,MAKASAR,14166,376,12336,205,1249,1625,2021-07-11
317504,JAKARTA TIMUR,KRAMAT JATI,16911,408,14400,274,1829,2237,2021-07-11
317505,JAKARTA TIMUR,PASAR REBO,13664,400,11329,220,1715,2115,2021-07-11
317506,JAKARTA TIMUR,CAKUNG,18178,597,15617,278,1686,2283,2021-07-11
317102,JAKARTA PUSAT,SAWAH BESAR,6904,415,5779,111,599,1014,2021-07-11
317106,JAKARTA PUSAT,MENTENG,5198,86,4522,94,496,582,2021-07-12
310101,KAB.ADM.KEP.SERIBU,KEP. SERIBU UTARA,486,10,408,5,63,73,2021-07-12
317203,JAKARTA UTARA,KOJA,14110,362,11982,224,1542,1904,2021-07-12
317504,JAKARTA TIMUR,KRAMAT JATI,17300,322,15160,275,1543,1865,2021-07-12
317508,JAKARTA TIMUR,MAKASAR,14332,256,12818,206,1052,1308,2021-07-12
317403,JAKARTA SELATAN,MAMPANG PRAPATAN,9326,100,8102,125,999,1099,2021-07-12
317501,JAKARTA TIMUR,MATRAMAN,11318,221,9152,199,1746,1967,2021-07-12
317205,JAKARTA UTARA,PADEMANGAN,9724,267,8238,117,1102,1369,2021-07-12
317307,JAKARTA BARAT,PALMERAH,13216,266,11626,235,1089,1355,2021-07-12
317408,JAKARTA SELATAN,PANCORAN,11253,161,9359,148,1585,1746,2021-07-12
317404,JAKARTA SELATAN,PASAR MINGGU,18190,348,15727,287,1828,2176,2021-07-12
317308,JAKARTA BARAT,KEMBANGAN,16300,348,13982,183,1787,2135,2021-07-12
317505,JAKARTA TIMUR,PASAR REBO,13966,286,11895,222,1563,1849,2021-07-12
317410,JAKARTA SELATAN,PESANGGRAHAN,12166,195,10515,171,1285,1480,2021-07-12
317502,JAKARTA TIMUR,PULO GADUNG,17145,412,14628,257,1848,2260,2021-07-12
317102,JAKARTA PUSAT,SAWAH BESAR,7017,362,5949,112,594,956,2021-07-12
317104,JAKARTA PUSAT,SENEN,7759,181,6604,128,846,1027,2021-07-12
317402,JAKARTA SELATAN,SETIA BUDI,9381,144,8103,128,1006,1150,2021-07-12
317303,JAKARTA BARAT,TAMAN SARI,6963,230,5694,94,945,1175,2021-07-12
317304,JAKARTA BARAT,TAMBORA,11382,453,9550,172,1207,1660,2021-07-12
317107,JAKARTA PUSAT,TANAH ABANG,9353,173,8192,154,834,1007,2021-07-12
317202,JAKARTA UTARA,TANJUNG PRIOK,21130,541,18302,317,1970,2511,2021-07-12
317401,JAKARTA SELATAN,TEBET,13415,205,11422,189,1599,1804,2021-07-12
317201,JAKARTA UTARA,PENJARINGAN,14799,548,12996,152,1103,1651,2021-07-12
317103,JAKARTA PUSAT,KEMAYORAN,15985,289,14206,249,1241,1530,2021-07-12
310102,KAB.ADM.KEP.SERIBU,KEP. SERIBU SELATAN,549,5,367,6,171,176,2021-07-12
317305,JAKARTA BARAT,KEBON JERUK,17959,448,15727,251,1533,1981,2021-07-12
111111,Luar DKI & Proses Update,Luar DKI & Proses Update,143008,137,141294,1273,304,441,2021-07-12
317506,JAKARTA TIMUR,CAKUNG,18447,481,16007,278,1681,2162,2021-07-12
317105,JAKARTA PUSAT,CEMPAKA PUTIH,8061,359,7158,117,427,786,2021-07-12
317301,JAKARTA BARAT,CENGKARENG,23648,706,20538,425,1979,2685,2021-07-12
317406,JAKARTA SELATAN,CILANDAK,13129,229,11448,179,1273,1502,2021-07-12
317206,JAKARTA UTARA,KELAPA GADING,10110,228,8775,130,977,1205,2021-07-12
317510,JAKARTA TIMUR,CIPAYUNG,19997,295,16286,175,3241,3536,2021-07-12
317509,JAKARTA TIMUR,CIRACAS,17546,290,14706,247,2303,2593,2021-07-12
317507,JAKARTA TIMUR,DUREN SAWIT,22632,469,19515,408,2240,2709,2021-07-12
317204,JAKARTA UTARA,CILINCING,13737,394,11469,232,1642,2036,2021-07-12
317302,JAKARTA BARAT,GROGOL PETAMBURAN,15600,457,13036,214,1893,2350,2021-07-12
317409,JAKARTA SELATAN,JAGAKARSA,18983,342,16235,275,2131,2473,2021-07-12
317503,JAKARTA TIMUR,JATINEGARA,15348,272,13024,252,1800,2072,2021-07-12
317108,JAKARTA PUSAT,JOHAR BARU,6976,367,6151,122,336,703,2021-07-12
317306,JAKARTA BARAT,KALI DERES,14418,427,12120,214,1657,2084,2021-07-12
317407,JAKARTA SELATAN,KEBAYORAN BARU,11090,189,9616,128,1157,1346,2021-07-12
317405,JAKARTA SELATAN,KEBAYORAN LAMA,15461,347,13514,252,1348,1695,2021-07-12
317101,JAKARTA PUSAT,GAMBIR,6995,116,5969,93,817,933,2021-07-12
317404,JAKARTA SELATAN,PASAR MINGGU,18673,408,15849,290,2126,2534,2021-07-13
317408,JAKARTA SELATAN,PANCORAN,11528,194,9407,148,1779,1973,2021-07-13
317307,JAKARTA BARAT,PALMERAH,13376,333,11682,233,1128,1461,2021-07-13
317505,JAKARTA TIMUR,PASAR REBO,14140,319,12060,227,1534,1853,2021-07-13
317403,JAKARTA SELATAN,MAMPANG PRAPATAN,9458,127,8130,124,1077,1204,2021-07-13
317504,JAKARTA TIMUR,KRAMAT JATI,17552,364,15332,276,1580,1944,2021-07-13
317508,JAKARTA TIMUR,MAKASAR,14485,321,13037,208,919,1240,2021-07-13
317501,JAKARTA TIMUR,MATRAMAN,11434,244,9198,196,1796,2040,2021-07-13
317106,JAKARTA PUSAT,MENTENG,5303,118,4547,93,545,663,2021-07-13
317203,JAKARTA UTARA,KOJA,14409,401,12040,230,1738,2139,2021-07-13
317201,JAKARTA UTARA,PENJARINGAN,15100,676,13096,155,1173,1849,2021-07-13
317205,JAKARTA UTARA,PADEMANGAN,9881,320,8345,117,1099,1419,2021-07-13
317502,JAKARTA TIMUR,PULO GADUNG,17398,508,14685,260,1945,2453,2021-07-13
317102,JAKARTA PUSAT,SAWAH BESAR,7206,441,5991,109,665,1106,2021-07-13
317104,JAKARTA PUSAT,SENEN,7940,193,6636,129,982,1175,2021-07-13
317402,JAKARTA SELATAN,SETIA BUDI,9531,179,8150,129,1073,1252,2021-07-13
317303,JAKARTA BARAT,TAMAN SARI,7165,278,5745,95,1047,1325,2021-07-13
310102,KAB.ADM.KEP.SERIBU,KEP. SERIBU SELATAN,558,4,368,6,180,184,2021-07-13
317304,JAKARTA BARAT,TAMBORA,11585,490,9660,167,1268,1758,2021-07-13
317107,JAKARTA PUSAT,TANAH ABANG,9430,195,8214,159,862,1057,2021-07-13
317202,JAKARTA UTARA,TANJUNG PRIOK,21357,642,18470,313,1932,2574,2021-07-13
317401,JAKARTA SELATAN,TEBET,13736,257,11497,185,1797,2054,2021-07-13
111111,Luar DKI & Proses Update,Luar DKI & Proses Update,143008,137,141294,1273,304,441,2021-07-13
317410,JAKARTA SELATAN,PESANGGRAHAN,12497,216,10563,173,1545,1761,2021-07-13
317308,JAKARTA BARAT,KEMBANGAN,16489,384,14063,188,1854,2238,2021-07-13
310101,KAB.ADM.KEP.SERIBU,KEP. SERIBU UTARA,505,5,416,5,79,84,2021-07-13
317206,JAKARTA UTARA,KELAPA GADING,10292,254,8830,128,1080,1334,2021-07-13
317103,JAKARTA PUSAT,KEMAYORAN,16326,313,14288,246,1479,1792,2021-07-13
317506,JAKARTA TIMUR,CAKUNG,18706,513,16132,279,1782,2295,2021-07-13
317105,JAKARTA PUSAT,CEMPAKA PUTIH,8310,463,7182,119,546,1009,2021-07-13
317301,JAKARTA BARAT,CENGKARENG,24053,779,20690,429,2155,2934,2021-07-13
317406,JAKARTA SELATAN,CILANDAK,13443,287,11505,176,1475,1762,2021-07-13
317204,JAKARTA UTARA,CILINCING,13921,433,11664,231,1593,2026,2021-07-13
317509,JAKARTA TIMUR,CIRACAS,17767,323,15001,251,2192,2515,2021-07-13
317507,JAKARTA TIMUR,DUREN SAWIT,23073,548,19660,419,2446,2994,2021-07-13
317101,JAKARTA PUSAT,GAMBIR,7119,157,5978,91,893,1050,2021-07-13
317510,JAKARTA TIMUR,CIPAYUNG,20164,325,16651,176,3012,3337,2021-07-13
317409,JAKARTA SELATAN,JAGAKARSA,19500,367,16392,282,2459,2826,2021-07-13
317503,JAKARTA TIMUR,JATINEGARA,15722,310,13120,258,2034,2344,2021-07-13
317108,JAKARTA PUSAT,JOHAR BARU,7145,474,6176,126,369,843,2021-07-13
317306,JAKARTA BARAT,KALI DERES,14670,515,12195,218,1742,2257,2021-07-13
317407,JAKARTA SELATAN,KEBAYORAN BARU,11240,217,9641,135,1247,1464,2021-07-13
317405,JAKARTA SELATAN,KEBAYORAN LAMA,15753,379,13572,255,1547,1926,2021-07-13
317305,JAKARTA BARAT,KEBON JERUK,18173,473,15851,247,1602,2075,2021-07-13
317302,JAKARTA BARAT,GROGOL PETAMBURAN,15853,547,13142,213,1951,2498,2021-07-13
317307,JAKARTA BARAT,PALMERAH,13606,383,11716,235,1272,1655,2021-07-14
317205,JAKARTA UTARA,PADEMANGAN,10066,354,8352,117,1243,1597,2021-07-14
317106,JAKARTA PUSAT,MENTENG,5401,135,4553,93,620,755,2021-07-14
111111,Luar DKI & Proses Update,Luar DKI & Proses Update,143008,137,141294,1273,304,441,2021-07-14
317508,JAKARTA TIMUR,MAKASAR,14736,391,13043,211,1091,1482,2021-07-14
317203,JAKARTA UTARA,KOJA,14549,469,12045,233,1802,2271,2021-07-14
317403,JAKARTA SELATAN,MAMPANG PRAPATAN,9595,142,8228,125,1100,1242,2021-07-14
317408,JAKARTA SELATAN,PANCORAN,11671,224,9534,149,1764,1988,2021-07-14
317504,JAKARTA TIMUR,KRAMAT JATI,17930,426,15341,276,1887,2313,2021-07-14
317501,JAKARTA TIMUR,MATRAMAN,11733,266,9212,197,2058,2324,2021-07-14
317404,JAKARTA SELATAN,PASAR MINGGU,19037,433,16062,292,2250,2683,2021-07-14
317304,JAKARTA BARAT,TAMBORA,11851,587,9674,168,1422,2009,2021-07-14
317201,JAKARTA UTARA,PENJARINGAN,15385,773,13107,156,1349,2122,2021-07-14
317410,JAKARTA SELATAN,PESANGGRAHAN,12842,246,10579,174,1843,2089,2021-07-14
317502,JAKARTA TIMUR,PULO GADUNG,17635,563,14727,261,2084,2647,2021-07-14
317102,JAKARTA PUSAT,SAWAH BESAR,7339,521,6057,110,651,1172,2021-07-14
317104,JAKARTA PUSAT,SENEN,8052,228,6698,129,997,1225,2021-07-14
317402,JAKARTA SELATAN,SETIA BUDI,9663,196,8163,129,1175,1371,2021-07-14
317303,JAKARTA BARAT,TAMAN SARI,7307,322,5922,95,968,1290,2021-07-14
310101,KAB.ADM.KEP.SERIBU,KEP. SERIBU UTARA,510,6,418,5,81,87,2021-07-14
317107,JAKARTA PUSAT,TANAH ABANG,9579,215,8318,162,884,1099,2021-07-14
317202,JAKARTA UTARA,TANJUNG PRIOK,21724,727,18479,315,2203,2930,2021-07-14
317401,JAKARTA SELATAN,TEBET,13866,285,11562,188,1831,2116,2021-07-14
317505,JAKARTA TIMUR,PASAR REBO,14358,350,12069,230,1709,2059,2021-07-14
310102,KAB.ADM.KEP.SERIBU,KEP. SERIBU SELATAN,564,5,394,6,159,164,2021-07-14
317306,JAKARTA BARAT,KALI DERES,14958,592,12218,220,1928,2520,2021-07-14
317103,JAKARTA PUSAT,KEMAYORAN,16480,379,14384,248,1469,1848,2021-07-14
317506,JAKARTA TIMUR,CAKUNG,18978,555,16433,280,1710,2265,2021-07-14
317105,JAKARTA PUSAT,CEMPAKA PUTIH,8537,622,7198,119,598,1220,2021-07-14
317301,JAKARTA BARAT,CENGKARENG,24442,886,20919,435,2202,3088,2021-07-14
317406,JAKARTA SELATAN,CILANDAK,13787,316,11604,177,1690,2006,2021-07-14
317204,JAKARTA UTARA,CILINCING,14065,495,11671,235,1664,2159,2021-07-14
317308,JAKARTA BARAT,KEMBANGAN,16821,456,14116,190,2059,2515,2021-07-14
317509,JAKARTA TIMUR,CIRACAS,17960,374,15021,252,2313,2687,2021-07-14
317507,JAKARTA TIMUR,DUREN SAWIT,23501,633,19722,420,2726,3359,2021-07-14
317101,JAKARTA PUSAT,GAMBIR,7256,184,6045,92,935,1119,2021-07-14
317510,JAKARTA TIMUR,CIPAYUNG,20313,379,16664,176,3094,3473,2021-07-14
317409,JAKARTA SELATAN,JAGAKARSA,20505,403,16645,282,3175,3578,2021-07-14
317503,JAKARTA TIMUR,JATINEGARA,16020,358,13129,260,2273,2631,2021-07-14
317108,JAKARTA PUSAT,JOHAR BARU,7306,590,6189,126,401,991,2021-07-14
317407,JAKARTA SELATAN,KEBAYORAN BARU,11473,266,9759,136,1312,1578,2021-07-14
317405,JAKARTA SELATAN,KEBAYORAN LAMA,16143,438,13694,257,1754,2192,2021-07-14
317305,JAKARTA BARAT,KEBON JERUK,18565,523,15903,248,1891,2414,2021-07-14
317206,JAKARTA UTARA,KELAPA GADING,10395,291,8835,129,1140,1431,2021-07-14
317302,JAKARTA BARAT,GROGOL PETAMBURAN,16082,668,13214,213,1987,2655,2021-07-14
317509,JAKARTA TIMUR,CIRACAS,18410,382,15141,255,2632,3014,2021-07-15
317507,JAKARTA TIMUR,DUREN SAWIT,23911,716,19883,426,2886,3602,2021-07-15
317510,JAKARTA TIMUR,CIPAYUNG,20830,395,16762,181,3492,3887,2021-07-15
317101,JAKARTA PUSAT,GAMBIR,7365,189,6059,95,1022,1211,2021-07-15
317108,JAKARTA PUSAT,JOHAR BARU,7438,607,6276,128,427,1034,2021-07-15
317409,JAKARTA SELATAN,JAGAKARSA,21422,428,16694,278,4022,4450,2021-07-15
317503,JAKARTA TIMUR,JATINEGARA,16442,372,13186,257,2627,2999,2021-07-15
317306,JAKARTA BARAT,KALI DERES,15224,695,12245,222,2062,2757,2021-07-15
317203,JAKARTA UTARA,KOJA,14808,507,12351,233,1717,2224,2021-07-15
317302,JAKARTA BARAT,GROGOL PETAMBURAN,16382,716,13259,218,2189,2905,2021-07-15
317204,JAKARTA UTARA,CILINCING,14347,538,11857,233,1719,2257,2021-07-15
317403,JAKARTA SELATAN,MAMPANG PRAPATAN,9679,159,8250,122,1148,1307,2021-07-15
317301,JAKARTA BARAT,CENGKARENG,24782,958,20981,434,2409,3367,2021-07-15
317105,JAKARTA PUSAT,CEMPAKA PUTIH,8660,648,7259,118,635,1283,2021-07-15
317506,JAKARTA TIMUR,CAKUNG,19201,633,16473,288,1807,2440,2021-07-15
317504,JAKARTA TIMUR,KRAMAT JATI,18097,460,15408,279,1950,2410,2021-07-15
310101,KAB.ADM.KEP.SERIBU,KEP. SERIBU UTARA,512,6,418,5,83,89,2021-07-15
310102,KAB.ADM.KEP.SERIBU,KEP. SERIBU SELATAN,573,5,394,6,168,173,2021-07-15
317308,JAKARTA BARAT,KEMBANGAN,17120,521,14145,191,2263,2784,2021-07-15
317103,JAKARTA PUSAT,KEMAYORAN,16856,387,14438,249,1782,2169,2021-07-15
317206,JAKARTA UTARA,KELAPA GADING,10567,326,8951,132,1158,1484,2021-07-15
317305,JAKARTA BARAT,KEBON JERUK,18771,566,15937,263,2005,2571,2021-07-15
317406,JAKARTA SELATAN,CILANDAK,14168,352,11620,188,2008,2360,2021-07-15
317508,JAKARTA TIMUR,MAKASAR,14872,428,13103,215,1126,1554,2021-07-15
317405,JAKARTA SELATAN,KEBAYORAN LAMA,16604,487,13730,260,2127,2614,2021-07-15
317407,JAKARTA SELATAN,KEBAYORAN BARU,11590,282,9776,134,1398,1680,2021-07-15
317401,JAKARTA SELATAN,TEBET,14143,322,11719,194,1908,2230,2021-07-15
317202,JAKARTA UTARA,TANJUNG PRIOK,22059,759,18576,329,2395,3154,2021-07-15
317107,JAKARTA PUSAT,TANAH ABANG,9720,223,8340,164,993,1216,2021-07-15
317303,JAKARTA BARAT,TAMAN SARI,7429,333,5954,96,1046,1379,2021-07-15
317402,JAKARTA SELATAN,SETIA BUDI,9772,243,8268,136,1125,1368,2021-07-15
317104,JAKARTA PUSAT,SENEN,8176,243,6713,128,1092,1335,2021-07-15
317102,JAKARTA PUSAT,SAWAH BESAR,7457,577,6071,116,693,1270,2021-07-15
317502,JAKARTA TIMUR,PULO GADUNG,17948,604,14819,268,2257,2861,2021-07-15
317410,JAKARTA SELATAN,PESANGGRAHAN,13263,272,10612,171,2208,2480,2021-07-15
317304,JAKARTA BARAT,TAMBORA,12030,612,9731,169,1518,2130,2021-07-15
317505,JAKARTA TIMUR,PASAR REBO,14523,371,12150,225,1777,2148,2021-07-15
317201,JAKARTA UTARA,PENJARINGAN,15625,805,13193,157,1470,2275,2021-07-15
317501,JAKARTA TIMUR,MATRAMAN,11862,302,9245,195,2120,2422,2021-07-15
317106,JAKARTA PUSAT,MENTENG,5463,139,4565,92,667,806,2021-07-15
111111,Luar DKI & Proses Update,Luar DKI & Proses Update,143008,137,141294,1273,304,441,2021-07-15
317307,JAKARTA BARAT,PALMERAH,13863,424,11745,239,1455,1879,2021-07-15
317408,JAKARTA SELATAN,PANCORAN,11808,259,9652,148,1749,2008,2021-07-15
317404,JAKARTA SELATAN,PASAR MINGGU,19506,462,16104,305,2635,3097,2021-07-15
317205,JAKARTA UTARA,PADEMANGAN,10160,355,8415,118,1272,1627,2021-07-15
317307,JAKARTA BARAT,PALMERAH,14046,409,11848,239,1550,1959,2021-07-16
317408,JAKARTA SELATAN,PANCORAN,12143,276,9895,146,1826,2102,2021-07-16
317404,JAKARTA SELATAN,PASAR MINGGU,19903,522,16222,307,2852,3374,2021-07-16
317505,JAKARTA TIMUR,PASAR REBO,14809,411,12238,226,1934,2345,2021-07-16
317201,JAKARTA UTARA,PENJARINGAN,15910,805,13390,163,1552,2357,2021-07-16
317410,JAKARTA SELATAN,PESANGGRAHAN,13649,343,10838,170,2298,2641,2021-07-16
317104,JAKARTA PUSAT,SENEN,8250,262,6813,129,1046,1308,2021-07-16
317102,JAKARTA PUSAT,SAWAH BESAR,7595,584,6221,116,674,1258,2021-07-16
317402,JAKARTA SELATAN,SETIA BUDI,9931,266,8353,138,1174,1440,2021-07-16
317304,JAKARTA BARAT,TAMBORA,12246,653,10043,170,1380,2033,2021-07-16
317107,JAKARTA PUSAT,TANAH ABANG,9832,240,8383,165,1044,1284,2021-07-16
317202,JAKARTA UTARA,TANJUNG PRIOK,22361,825,18714,334,2488,3313,2021-07-16
317502,JAKARTA TIMUR,PULO GADUNG,18286,691,15138,268,2189,2880,2021-07-16
317303,JAKARTA BARAT,TAMAN SARI,7540,355,6147,96,942,1297,2021-07-16
317306,JAKARTA BARAT,KALI DERES,15451,750,12677,223,1801,2551,2021-07-16
317106,JAKARTA PUSAT,MENTENG,5530,146,4610,94,680,826,2021-07-16
317501,JAKARTA TIMUR,MATRAMAN,12003,340,9630,197,1836,2176,2021-07-16
317403,JAKARTA SELATAN,MAMPANG PRAPATAN,9832,184,8300,123,1225,1409,2021-07-16
317508,JAKARTA TIMUR,MAKASAR,15117,481,13147,218,1271,1752,2021-07-16
317504,JAKARTA TIMUR,KRAMAT JATI,18521,507,15499,281,2234,2741,2021-07-16
317203,JAKARTA UTARA,KOJA,15011,557,12587,237,1630,2187,2021-07-16
310101,KAB.ADM.KEP.SERIBU,KEP. SERIBU UTARA,525,8,418,5,94,102,2021-07-16
317401,JAKARTA SELATAN,TEBET,14460,374,11813,195,2078,2452,2021-07-16
317308,JAKARTA BARAT,KEMBANGAN,17395,570,14250,192,2383,2953,2021-07-16
317103,JAKARTA PUSAT,KEMAYORAN,17094,442,14520,252,1880,2322,2021-07-16
317206,JAKARTA UTARA,KELAPA GADING,10718,364,9085,134,1135,1499,2021-07-16
317305,JAKARTA BARAT,KEBON JERUK,19139,650,16026,266,2197,2847,2021-07-16
317405,JAKARTA SELATAN,KEBAYORAN LAMA,16984,525,13951,258,2250,2775,2021-07-16
317205,JAKARTA UTARA,PADEMANGAN,10278,366,8475,119,1318,1684,2021-07-16
310102,KAB.ADM.KEP.SERIBU,KEP. SERIBU SELATAN,578,4,395,6,173,177,2021-07-16
317407,JAKARTA SELATAN,KEBAYORAN BARU,11801,311,9816,136,1538,1849,2021-07-16
317108,JAKARTA PUSAT,JOHAR BARU,7493,597,6326,129,441,1038,2021-07-16
111111,Luar DKI & Proses Update,Luar DKI & Proses Update,143008,137,141294,1273,304,441,2021-07-16
317503,JAKARTA TIMUR,JATINEGARA,16763,415,13593,255,2500,2915,2021-07-16
317409,JAKARTA SELATAN,JAGAKARSA,21810,476,16820,279,4235,4711,2021-07-16
317302,JAKARTA BARAT,GROGOL PETAMBURAN,16731,781,13685,222,2043,2824,2021-07-16
317507,JAKARTA TIMUR,DUREN SAWIT,24399,778,20302,423,2896,3674,2021-07-16
317509,JAKARTA TIMUR,CIRACAS,18785,416,15196,262,2911,3327,2021-07-16
317101,JAKARTA PUSAT,GAMBIR,7463,210,6116,97,1040,1250,2021-07-16
317204,JAKARTA UTARA,CILINCING,14661,597,12099,235,1730,2327,2021-07-16
317406,JAKARTA SELATAN,CILANDAK,14391,383,11896,189,1923,2306,2021-07-16
317301,JAKARTA BARAT,CENGKARENG,25106,1014,21357,442,2293,3307,2021-07-16
317105,JAKARTA PUSAT,CEMPAKA PUTIH,8885,675,7329,120,761,1436,2021-07-16
317506,JAKARTA TIMUR,CAKUNG,19559,685,16893,288,1693,2378,2021-07-16
317510,JAKARTA TIMUR,CIPAYUNG,21135,421,16825,184,3705,4126,2021-07-16
317203,JAKARTA UTARA,KOJA,15177,510,12861,229,1577,2087,2021-07-17
317308,JAKARTA BARAT,KEMBANGAN,17608,537,14566,189,2316,2853,2021-07-17
310102,KAB.ADM.KEP.SERIBU,KEP. SERIBU SELATAN,596,1,412,6,177,178,2021-07-17
317105,JAKARTA PUSAT,CEMPAKA PUTIH,9062,563,7612,120,767,1330,2021-07-17
317504,JAKARTA TIMUR,KRAMAT JATI,18755,487,15624,287,2357,2844,2021-07-17
310101,KAB.ADM.KEP.SERIBU,KEP. SERIBU UTARA,529,9,428,6,86,95,2021-07-17
317403,JAKARTA SELATAN,MAMPANG PRAPATAN,10027,168,8457,125,1277,1445,2021-07-17
317501,JAKARTA TIMUR,MATRAMAN,12301,321,9955,189,1836,2157,2021-07-17
317106,JAKARTA PUSAT,MENTENG,5614,149,4707,96,662,811,2021-07-17
317205,JAKARTA UTARA,PADEMANGAN,10380,326,8706,123,1225,1551,2021-07-17
317103,JAKARTA PUSAT,KEMAYORAN,17315,434,14733,265,1883,2317,2021-07-17
317508,JAKARTA TIMUR,MAKASAR,15285,485,13311,220,1269,1754,2021-07-17
317206,JAKARTA UTARA,KELAPA GADING,10841,304,9281,136,1120,1424,2021-07-17
317302,JAKARTA BARAT,GROGOL PETAMBURAN,16905,742,14033,231,1899,2641,2021-07-17
317405,JAKARTA SELATAN,KEBAYORAN LAMA,17151,515,14195,247,2194,2709,2021-07-17
317407,JAKARTA SELATAN,KEBAYORAN BARU,11922,267,10059,139,1457,1724,2021-07-17
317306,JAKARTA BARAT,KALI DERES,15683,647,13042,220,1774,2421,2021-07-17
317108,JAKARTA PUSAT,JOHAR BARU,7708,535,6570,119,484,1019,2021-07-17
317503,JAKARTA TIMUR,JATINEGARA,17061,395,13768,254,2644,3039,2021-07-17
317409,JAKARTA SELATAN,JAGAKARSA,22073,467,17250,289,4067,4534,2021-07-17
317307,JAKARTA BARAT,PALMERAH,14156,413,12066,237,1440,1853,2021-07-17
317101,JAKARTA PUSAT,GAMBIR,7554,195,6250,99,1010,1205,2021-07-17
317507,JAKARTA TIMUR,DUREN SAWIT,24816,789,20654,423,2950,3739,2021-07-17
317509,JAKARTA TIMUR,CIRACAS,19057,413,15533,265,2846,3259,2021-07-17
317510,JAKARTA TIMUR,CIPAYUNG,21596,403,17381,185,3627,4030,2021-07-17
317204,JAKARTA UTARA,CILINCING,14824,546,12436,230,1612,2158,2021-07-17
317305,JAKARTA BARAT,KEBON JERUK,19362,623,16279,268,2192,2815,2021-07-17
317408,JAKARTA SELATAN,PANCORAN,12359,280,10125,143,1811,2091,2021-07-17
317402,JAKARTA SELATAN,SETIA BUDI,10051,265,8435,135,1216,1481,2021-07-17
317505,JAKARTA TIMUR,PASAR REBO,15075,428,12494,225,1928,2356,2021-07-17
111111,Luar DKI & Proses Update,Luar DKI & Proses Update,143008,137,141294,1273,304,441,2021-07-17
317404,JAKARTA SELATAN,PASAR MINGGU,20124,516,16653,310,2645,3161,2021-07-17
317506,JAKARTA TIMUR,CAKUNG,19829,672,17072,289,1796,2468,2021-07-17
317401,JAKARTA SELATAN,TEBET,14667,336,12059,197,2075,2411,2021-07-17
317202,JAKARTA UTARA,TANJUNG PRIOK,22616,718,19109,336,2453,3171,2021-07-17
317107,JAKARTA PUSAT,TANAH ABANG,9904,212,8544,163,985,1197,2021-07-17
317304,JAKARTA BARAT,TAMBORA,12398,617,10235,175,1371,1988,2021-07-17
317301,JAKARTA BARAT,CENGKARENG,25373,930,21760,443,2240,3170,2021-07-17
317406,JAKARTA SELATAN,CILANDAK,14659,380,12030,189,2060,2440,2021-07-17
317104,JAKARTA PUSAT,SENEN,8331,251,6946,124,1010,1261,2021-07-17
317102,JAKARTA PUSAT,SAWAH BESAR,7750,537,6374,116,723,1260,2021-07-17
317502,JAKARTA TIMUR,PULO GADUNG,18658,650,15373,265,2370,3020,2021-07-17
317201,JAKARTA UTARA,PENJARINGAN,16099,766,13560,176,1597,2363,2021-07-17
317410,JAKARTA SELATAN,PESANGGRAHAN,13799,349,11140,167,2143,2492,2021-07-17
317303,JAKARTA BARAT,TAMAN SARI,7620,349,6268,100,903,1252,2021-07-17
111111,Luar DKI & Proses Update,Luar DKI & Proses Update,143008,137,141294,1273,304,441,2021-07-18
317401,JAKARTA SELATAN,TEBET,14851,324,12218,199,2110,2434,2021-07-18
317202,JAKARTA UTARA,TANJUNG PRIOK,22858,669,19345,339,2505,3174,2021-07-18
317107,JAKARTA PUSAT,TANAH ABANG,9988,190,8626,166,1006,1196,2021-07-18
317304,JAKARTA BARAT,TAMBORA,12555,579,10429,179,1368,1947,2021-07-18
317104,JAKARTA PUSAT,SENEN,8431,217,7064,127,1023,1240,2021-07-18
317402,JAKARTA SELATAN,SETIA BUDI,10156,255,8612,136,1153,1408,2021-07-18
317102,JAKARTA PUSAT,SAWAH BESAR,7837,455,6558,118,706,1161,2021-07-18
317502,JAKARTA TIMUR,PULO GADUNG,18903,631,15726,270,2276,2907,2021-07-18
317410,JAKARTA SELATAN,PESANGGRAHAN,14032,340,11708,170,1814,2154,2021-07-18
317505,JAKARTA TIMUR,PASAR REBO,15318,363,12696,233,2026,2389,2021-07-18
317303,JAKARTA BARAT,TAMAN SARI,7724,339,6389,100,896,1235,2021-07-18
317201,JAKARTA UTARA,PENJARINGAN,16282,708,13809,182,1583,2291,2021-07-18
317307,JAKARTA BARAT,PALMERAH,14316,380,12190,243,1503,1883,2021-07-18
317506,JAKARTA TIMUR,CAKUNG,20031,627,17326,291,1787,2414,2021-07-18
317205,JAKARTA UTARA,PADEMANGAN,10503,315,8838,127,1223,1538,2021-07-18
317106,JAKARTA PUSAT,MENTENG,5688,136,4773,96,683,819,2021-07-18
317501,JAKARTA TIMUR,MATRAMAN,12478,293,10148,196,1841,2134,2021-07-18
317403,JAKARTA SELATAN,MAMPANG PRAPATAN,10167,157,8539,129,1342,1499,2021-07-18
317508,JAKARTA TIMUR,MAKASAR,15472,471,13466,224,1311,1782,2021-07-18
317504,JAKARTA TIMUR,KRAMAT JATI,18984,434,15830,299,2421,2855,2021-07-18
317203,JAKARTA UTARA,KOJA,15349,482,13071,234,1562,2044,2021-07-18
310101,KAB.ADM.KEP.SERIBU,KEP. SERIBU UTARA,534,8,431,6,89,97,2021-07-18
310102,KAB.ADM.KEP.SERIBU,KEP. SERIBU SELATAN,598,1,438,6,153,154,2021-07-18
317308,JAKARTA BARAT,KEMBANGAN,17897,509,14852,193,2343,2852,2021-07-18
317103,JAKARTA PUSAT,KEMAYORAN,17509,432,14886,270,1921,2353,2021-07-18
317206,JAKARTA UTARA,KELAPA GADING,10990,281,9420,137,1152,1433,2021-07-18
317305,JAKARTA BARAT,KEBON JERUK,19486,599,16553,270,2064,2663,2021-07-18
317408,JAKARTA SELATAN,PANCORAN,12524,278,10268,145,1833,2111,2021-07-18
317405,JAKARTA SELATAN,KEBAYORAN LAMA,17405,486,14644,254,2021,2507,2021-07-18
317306,JAKARTA BARAT,KALI DERES,15865,565,13263,226,1811,2376,2021-07-18
317108,JAKARTA PUSAT,JOHAR BARU,7803,441,6722,121,519,960,2021-07-18
317503,JAKARTA TIMUR,JATINEGARA,17246,354,14080,264,2548,2902,2021-07-18
317409,JAKARTA SELATAN,JAGAKARSA,22373,426,18303,297,3347,3773,2021-07-18
317302,JAKARTA BARAT,GROGOL PETAMBURAN,17116,714,14226,238,1938,2652,2021-07-18
317101,JAKARTA PUSAT,GAMBIR,7645,191,6344,100,1010,1201,2021-07-18
317507,JAKARTA TIMUR,DUREN SAWIT,25152,740,20975,432,3005,3745,2021-07-18
317509,JAKARTA TIMUR,CIRACAS,19281,382,15727,273,2899,3281,2021-07-18
317510,JAKARTA TIMUR,CIPAYUNG,21843,377,17548,188,3730,4107,2021-07-18
317204,JAKARTA UTARA,CILINCING,15068,530,12586,240,1712,2242,2021-07-18
317404,JAKARTA SELATAN,PASAR MINGGU,20352,463,17297,321,2271,2734,2021-07-18
317301,JAKARTA BARAT,CENGKARENG,25615,860,22015,454,2286,3146,2021-07-18
317105,JAKARTA PUSAT,CEMPAKA PUTIH,9153,530,7749,121,753,1283,2021-07-18
317407,JAKARTA SELATAN,KEBAYORAN BARU,12080,283,10212,142,1443,1726,2021-07-18
317406,JAKARTA SELATAN,CILANDAK,14805,372,12445,189,1799,2171,2021-07-18
111111,Luar DKI & Proses Update,Luar DKI & Proses Update,143008,137,141294,1273,304,441,2021-07-19
317304,JAKARTA BARAT,TAMBORA,12647,515,10657,186,1289,1804,2021-07-19
317202,JAKARTA UTARA,TANJUNG PRIOK,22956,588,19847,343,2178,2766,2021-07-19
317206,JAKARTA UTARA,KELAPA GADING,11101,245,9601,139,1116,1361,2021-07-19
317305,JAKARTA BARAT,KEBON JERUK,19689,554,16900,277,1958,2512,2021-07-19
317405,JAKARTA SELATAN,KEBAYORAN LAMA,17579,413,14849,272,2045,2458,2021-07-19
317407,JAKARTA SELATAN,KEBAYORAN BARU,12156,248,10465,138,1305,1553,2021-07-19
317306,JAKARTA BARAT,KALI DERES,15975,537,13498,234,1706,2243,2021-07-19
317108,JAKARTA PUSAT,JOHAR BARU,7835,421,6767,136,511,932,2021-07-19
317503,JAKARTA TIMUR,JATINEGARA,17344,300,14288,279,2477,2777,2021-07-19
317409,JAKARTA SELATAN,JAGAKARSA,22567,379,18498,305,3385,3764,2021-07-19
317103,JAKARTA PUSAT,KEMAYORAN,17577,400,15143,266,1768,2168,2021-07-19
317302,JAKARTA BARAT,GROGOL PETAMBURAN,17229,647,14459,239,1884,2531,2021-07-19
317507,JAKARTA TIMUR,DUREN SAWIT,25319,615,21429,455,2820,3435,2021-07-19
317509,JAKARTA TIMUR,CIRACAS,19362,310,16272,275,2505,2815,2021-07-19
317510,JAKARTA TIMUR,CIPAYUNG,21911,305,18194,195,3217,3522,2021-07-19
317204,JAKARTA UTARA,CILINCING,15195,465,12771,254,1705,2170,2021-07-19
317406,JAKARTA SELATAN,CILANDAK,14967,317,12652,198,1800,2117,2021-07-19
317301,JAKARTA BARAT,CENGKARENG,25740,774,22378,455,2133,2907,2021-07-19
317105,JAKARTA PUSAT,CEMPAKA PUTIH,9198,498,7858,127,715,1213,2021-07-19
317506,JAKARTA TIMUR,CAKUNG,20116,530,17632,299,1655,2185,2021-07-19
317101,JAKARTA PUSAT,GAMBIR,7689,178,6451,106,954,1132,2021-07-19
317308,JAKARTA BARAT,KEMBANGAN,17978,469,15187,200,2122,2591,2021-07-19
310102,KAB.ADM.KEP.SERIBU,KEP. SERIBU SELATAN,605,1,471,4,129,130,2021-07-19
310101,KAB.ADM.KEP.SERIBU,KEP. SERIBU UTARA,536,6,439,5,86,92,2021-07-19
317107,JAKARTA PUSAT,TANAH ABANG,10045,168,8811,175,891,1059,2021-07-19
317303,JAKARTA BARAT,TAMAN SARI,7781,326,6540,101,814,1140,2021-07-19
317402,JAKARTA SELATAN,SETIA BUDI,10223,229,8792,141,1061,1290,2021-07-19
317104,JAKARTA PUSAT,SENEN,8472,183,7256,133,900,1083,2021-07-19
317102,JAKARTA PUSAT,SAWAH BESAR,7899,435,6735,124,605,1040,2021-07-19
317502,JAKARTA TIMUR,PULO GADUNG,18997,561,16039,282,2115,2676,2021-07-19
317410,JAKARTA SELATAN,PESANGGRAHAN,14211,283,11861,179,1888,2171,2021-07-19
317201,JAKARTA UTARA,PENJARINGAN,16411,645,14060,177,1529,2174,2021-07-19
317505,JAKARTA TIMUR,PASAR REBO,15400,315,13017,245,1823,2138,2021-07-19
317404,JAKARTA SELATAN,PASAR MINGGU,20641,396,17557,323,2365,2761,2021-07-19
317408,JAKARTA SELATAN,PANCORAN,12713,245,10587,158,1723,1968,2021-07-19
317307,JAKARTA BARAT,PALMERAH,14384,344,12427,253,1360,1704,2021-07-19
317205,JAKARTA UTARA,PADEMANGAN,10559,293,9101,130,1035,1328,2021-07-19
317106,JAKARTA PUSAT,MENTENG,5712,116,4867,99,630,746,2021-07-19
317501,JAKARTA TIMUR,MATRAMAN,12565,256,10395,203,1711,1967,2021-07-19
317403,JAKARTA SELATAN,MAMPANG PRAPATAN,10227,146,8725,132,1224,1370,2021-07-19
317508,JAKARTA TIMUR,MAKASAR,15534,415,13705,222,1192,1607,2021-07-19
317504,JAKARTA TIMUR,KRAMAT JATI,19076,362,16212,311,2191,2553,2021-07-19
317203,JAKARTA UTARA,KOJA,15503,419,13264,255,1565,1984,2021-07-19
317401,JAKARTA SELATAN,TEBET,14947,286,12372,205,2084,2370,2021-07-19
111111,Luar DKI & Proses Update,Luar DKI & Proses Update,143008,137,141294,1273,304,441,2021-07-20
317107,JAKARTA PUSAT,TANAH ABANG,10106,167,8944,180,815,982,2021-07-20
317404,JAKARTA SELATAN,PASAR MINGGU,20816,372,17763,330,2351,2723,2021-07-20
317504,JAKARTA TIMUR,KRAMAT JATI,19239,345,16501,320,2073,2418,2021-07-20
317508,JAKARTA TIMUR,MAKASAR,15665,413,13947,226,1079,1492,2021-07-20
317501,JAKARTA TIMUR,MATRAMAN,12645,245,10619,210,1571,1816,2021-07-20
317106,JAKARTA PUSAT,MENTENG,5758,99,4980,100,579,678,2021-07-20
317205,JAKARTA UTARA,PADEMANGAN,10666,252,9301,132,981,1233,2021-07-20
317307,JAKARTA BARAT,PALMERAH,14496,306,12717,258,1215,1521,2021-07-20
317408,JAKARTA SELATAN,PANCORAN,12807,226,10795,165,1621,1847,2021-07-20
317505,JAKARTA TIMUR,PASAR REBO,15524,307,13233,250,1734,2041,2021-07-20
317203,JAKARTA UTARA,KOJA,15631,420,13543,265,1403,1823,2021-07-20
317201,JAKARTA UTARA,PENJARINGAN,16583,602,14406,180,1395,1997,2021-07-20
317502,JAKARTA TIMUR,PULO GADUNG,19215,549,16453,292,1921,2470,2021-07-20
317102,JAKARTA PUSAT,SAWAH BESAR,8011,372,6894,130,615,987,2021-07-20
317104,JAKARTA PUSAT,SENEN,8571,184,7418,137,832,1016,2021-07-20
317402,JAKARTA SELATAN,SETIA BUDI,10317,241,8935,145,996,1237,2021-07-20
317303,JAKARTA BARAT,TAMAN SARI,7870,291,6743,104,732,1023,2021-07-20
317304,JAKARTA BARAT,TAMBORA,12812,507,10905,191,1209,1716,2021-07-20
317202,JAKARTA UTARA,TANJUNG PRIOK,23102,575,20198,347,1982,2557,2021-07-20
317401,JAKARTA SELATAN,TEBET,15078,277,12844,211,1746,2023,2021-07-20
317410,JAKARTA SELATAN,PESANGGRAHAN,14319,292,11961,184,1882,2174,2021-07-20
310101,KAB.ADM.KEP.SERIBU,KEP. SERIBU UTARA,537,4,449,5,79,83,2021-07-20
317403,JAKARTA SELATAN,MAMPANG PRAPATAN,10285,157,8888,135,1105,1262,2021-07-20
317308,JAKARTA BARAT,KEMBANGAN,18090,433,15521,211,1925,2358,2021-07-20
317506,JAKARTA TIMUR,CAKUNG,20241,518,17953,306,1464,1982,2021-07-20
317105,JAKARTA PUSAT,CEMPAKA PUTIH,9342,507,8024,133,678,1185,2021-07-20
317301,JAKARTA BARAT,CENGKARENG,25911,735,22790,465,1921,2656,2021-07-20
317406,JAKARTA SELATAN,CILANDAK,15095,326,12784,203,1782,2108,2021-07-20
317204,JAKARTA UTARA,CILINCING,15288,453,13078,262,1495,1948,2021-07-20
317510,JAKARTA TIMUR,CIPAYUNG,22042,286,18706,199,2851,3137,2021-07-20
310102,KAB.ADM.KEP.SERIBU,KEP. SERIBU SELATAN,608,1,501,4,102,103,2021-07-20
317507,JAKARTA TIMUR,DUREN SAWIT,25540,600,21792,464,2684,3284,2021-07-20
317101,JAKARTA PUSAT,GAMBIR,7753,168,6709,108,768,936,2021-07-20
317302,JAKARTA BARAT,GROGOL PETAMBURAN,17356,590,14949,248,1569,2159,2021-07-20
317509,JAKARTA TIMUR,CIRACAS,19496,328,16567,281,2320,2648,2021-07-20
317103,JAKARTA PUSAT,KEMAYORAN,17709,400,15373,272,1664,2064,2021-07-20
317503,JAKARTA TIMUR,JATINEGARA,17458,288,14689,292,2189,2477,2021-07-20
317108,JAKARTA PUSAT,JOHAR BARU,7914,312,6936,139,527,839,2021-07-20
317306,JAKARTA BARAT,KALI DERES,16098,512,13742,243,1601,2113,2021-07-20
317407,JAKARTA SELATAN,KEBAYORAN BARU,12253,258,10647,143,1205,1463,2021-07-20
317405,JAKARTA SELATAN,KEBAYORAN LAMA,17743,423,15016,275,2029,2452,2021-07-20
317305,JAKARTA BARAT,KEBON JERUK,19915,533,17217,287,1878,2411,2021-07-20
317206,JAKARTA UTARA,KELAPA GADING,11208,246,9779,142,1041,1287,2021-07-20
317409,JAKARTA SELATAN,JAGAKARSA,22923,582,18672,313,3356,3938,2021-07-20
317505,JAKARTA TIMUR,PASAR REBO,15612,331,13480,253,1548,1879,2021-07-21
317404,JAKARTA SELATAN,PASAR MINGGU,21014,370,18214,334,2096,2466,2021-07-21
317408,JAKARTA SELATAN,PANCORAN,12873,223,10900,165,1585,1808,2021-07-21
317307,JAKARTA BARAT,PALMERAH,14664,298,12915,259,1192,1490,2021-07-21
317403,JAKARTA SELATAN,MAMPANG PRAPATAN,10392,150,8964,137,1141,1291,2021-07-21
317106,JAKARTA PUSAT,MENTENG,5845,100,5042,101,602,702,2021-07-21
317501,JAKARTA TIMUR,MATRAMAN,12712,254,10939,213,1306,1560,2021-07-21
317201,JAKARTA UTARA,PENJARINGAN,16778,607,14606,182,1383,1990,2021-07-21
317205,JAKARTA UTARA,PADEMANGAN,10805,238,9436,134,997,1235,2021-07-21
317410,JAKARTA SELATAN,PESANGGRAHAN,14407,273,12393,186,1555,1828,2021-07-21
317409,JAKARTA SELATAN,JAGAKARSA,23044,513,19577,316,2638,3151,2021-07-21
317102,JAKARTA PUSAT,SAWAH BESAR,8112,325,7009,131,647,972,2021-07-21
317104,JAKARTA PUSAT,SENEN,8630,175,7501,137,817,992,2021-07-21
317402,JAKARTA SELATAN,SETIA BUDI,10379,220,9101,145,913,1133,2021-07-21
317303,JAKARTA BARAT,TAMAN SARI,7943,262,6870,105,706,968,2021-07-21
317304,JAKARTA BARAT,TAMBORA,12924,469,11136,192,1127,1596,2021-07-21
317107,JAKARTA PUSAT,TANAH ABANG,10170,165,9038,182,785,950,2021-07-21
317202,JAKARTA UTARA,TANJUNG PRIOK,23389,575,20450,347,2017,2592,2021-07-21
317401,JAKARTA SELATAN,TEBET,15250,280,13130,214,1626,1906,2021-07-21
111111,Luar DKI & Proses Update,Luar DKI & Proses Update,143008,137,141294,1273,304,441,2021-07-21
317508,JAKARTA TIMUR,MAKASAR,15807,394,14123,229,1061,1455,2021-07-21
317502,JAKARTA TIMUR,PULO GADUNG,19416,506,16762,294,1854,2360,2021-07-21
317504,JAKARTA TIMUR,KRAMAT JATI,19319,338,16748,321,1912,2250,2021-07-21
317204,JAKARTA UTARA,CILINCING,15356,444,13222,264,1426,1870,2021-07-21
310101,KAB.ADM.KEP.SERIBU,KEP. SERIBU UTARA,540,4,458,5,73,77,2021-07-21
317506,JAKARTA TIMUR,CAKUNG,20334,486,18155,307,1386,1872,2021-07-21
317105,JAKARTA PUSAT,CEMPAKA PUTIH,9404,402,8202,134,666,1068,2021-07-21
317301,JAKARTA BARAT,CENGKARENG,26116,763,22957,467,1929,2692,2021-07-21
317406,JAKARTA SELATAN,CILANDAK,15249,280,13142,205,1622,1902,2021-07-21
317510,JAKARTA TIMUR,CIPAYUNG,22133,292,18844,200,2797,3089,2021-07-21
317203,JAKARTA UTARA,KOJA,15724,413,13670,266,1375,1788,2021-07-21
317507,JAKARTA TIMUR,DUREN SAWIT,25858,581,22071,466,2740,3321,2021-07-21
317101,JAKARTA PUSAT,GAMBIR,7827,162,6802,109,754,916,2021-07-21
317302,JAKARTA BARAT,GROGOL PETAMBURAN,17487,573,15117,250,1547,2120,2021-07-21
317509,JAKARTA TIMUR,CIRACAS,19601,323,16844,287,2147,2470,2021-07-21
317308,JAKARTA BARAT,KEMBANGAN,18328,455,15743,212,1918,2373,2021-07-21
317108,JAKARTA PUSAT,JOHAR BARU,7981,223,7074,140,544,767,2021-07-21
317306,JAKARTA BARAT,KALI DERES,16209,520,13942,247,1500,2020,2021-07-21
317407,JAKARTA SELATAN,KEBAYORAN BARU,12368,263,10791,145,1169,1432,2021-07-21
317405,JAKARTA SELATAN,KEBAYORAN LAMA,17954,450,15327,276,1901,2351,2021-07-21
317305,JAKARTA BARAT,KEBON JERUK,20070,539,17460,291,1780,2319,2021-07-21
317206,JAKARTA UTARA,KELAPA GADING,11305,245,9887,146,1027,1272,2021-07-21
317103,JAKARTA PUSAT,KEMAYORAN,17834,390,15511,275,1658,2048,2021-07-21
317503,JAKARTA TIMUR,JATINEGARA,17617,274,14995,293,2055,2329,2021-07-21
310102,KAB.ADM.KEP.SERIBU,KEP. SERIBU SELATAN,613,1,506,4,102,103,2021-07-21
317505,JAKARTA TIMUR,PASAR REBO,15754,308,13741,256,1449,1757,2021-07-22
317404,JAKARTA SELATAN,PASAR MINGGU,21132,359,18428,340,2005,2364,2021-07-22
317408,JAKARTA SELATAN,PANCORAN,13023,220,11138,169,1496,1716,2021-07-22
317307,JAKARTA BARAT,PALMERAH,14738,293,13135,262,1048,1341,2021-07-22
317403,JAKARTA SELATAN,MAMPANG PRAPATAN,10467,152,9209,143,963,1115,2021-07-22
317106,JAKARTA PUSAT,MENTENG,5890,102,5150,101,537,639,2021-07-22
317501,JAKARTA TIMUR,MATRAMAN,12903,261,11029,216,1397,1658,2021-07-22
317201,JAKARTA UTARA,PENJARINGAN,16912,595,14833,186,1298,1893,2021-07-22
317205,JAKARTA UTARA,PADEMANGAN,10861,240,9516,137,968,1208,2021-07-22
317410,JAKARTA SELATAN,PESANGGRAHAN,14546,291,12574,188,1493,1784,2021-07-22
317304,JAKARTA BARAT,TAMBORA,13010,429,11331,192,1058,1487,2021-07-22
317102,JAKARTA PUSAT,SAWAH BESAR,8186,273,7128,137,648,921,2021-07-22
317104,JAKARTA PUSAT,SENEN,8709,185,7680,140,704,889,2021-07-22
317402,JAKARTA SELATAN,SETIA BUDI,10499,237,9171,148,943,1180,2021-07-22
317303,JAKARTA BARAT,TAMAN SARI,8005,242,6985,107,671,913,2021-07-22
317107,JAKARTA PUSAT,TANAH ABANG,10211,159,9127,183,742,901,2021-07-22
317202,JAKARTA UTARA,TANJUNG PRIOK,23552,555,20599,352,2046,2601,2021-07-22
317401,JAKARTA SELATAN,TEBET,15342,280,13352,218,1492,1772,2021-07-22
111111,Luar DKI & Proses Update,Luar DKI & Proses Update,143008,137,141294,1273,304,441,2021-07-22
317508,JAKARTA TIMUR,MAKASAR,15913,418,14227,235,1033,1451,2021-07-22
317502,JAKARTA TIMUR,PULO GADUNG,19589,517,17068,302,1702,2219,2021-07-22
317504,JAKARTA TIMUR,KRAMAT JATI,19605,325,17007,327,1946,2271,2021-07-22
317306,JAKARTA BARAT,KALI DERES,16378,480,14230,252,1416,1896,2021-07-22
310101,KAB.ADM.KEP.SERIBU,KEP. SERIBU UTARA,543,6,470,5,62,68,2021-07-22
317203,JAKARTA UTARA,KOJA,15842,386,13810,273,1373,1759,2021-07-22
317506,JAKARTA TIMUR,CAKUNG,20535,476,18380,311,1368,1844,2021-07-22
317301,JAKARTA BARAT,CENGKARENG,26330,694,23352,475,1809,2503,2021-07-22
317406,JAKARTA SELATAN,CILANDAK,15365,298,13312,208,1547,1845,2021-07-22
317204,JAKARTA UTARA,CILINCING,15548,405,13462,271,1410,1815,2021-07-22
317510,JAKARTA TIMUR,CIPAYUNG,22552,265,19488,210,2589,2854,2021-07-22
317509,JAKARTA TIMUR,CIRACAS,19829,313,17232,289,1995,2308,2021-07-22
317507,JAKARTA TIMUR,DUREN SAWIT,26023,570,22429,469,2555,3125,2021-07-22
317101,JAKARTA PUSAT,GAMBIR,7877,165,6871,108,733,898,2021-07-22
317302,JAKARTA BARAT,GROGOL PETAMBURAN,17650,507,15442,250,1451,1958,2021-07-22
317105,JAKARTA PUSAT,CEMPAKA PUTIH,9508,394,8365,136,613,1007,2021-07-22
317503,JAKARTA TIMUR,JATINEGARA,17776,256,15297,299,1924,2180,2021-07-22
317108,JAKARTA PUSAT,JOHAR BARU,8020,142,7206,141,531,673,2021-07-22
310102,KAB.ADM.KEP.SERIBU,KEP. SERIBU SELATAN,615,1,538,4,72,73,2021-07-22
317407,JAKARTA SELATAN,KEBAYORAN BARU,12428,234,10878,147,1169,1403,2021-07-22
317405,JAKARTA SELATAN,KEBAYORAN LAMA,18060,424,15570,278,1788,2212,2021-07-22
317305,JAKARTA BARAT,KEBON JERUK,20203,544,17719,293,1647,2191,2021-07-22
317206,JAKARTA UTARA,KELAPA GADING,11427,239,9980,151,1057,1296,2021-07-22
317103,JAKARTA PUSAT,KEMAYORAN,17982,377,15751,282,1572,1949,2021-07-22
317308,JAKARTA BARAT,KEMBANGAN,18464,441,16049,216,1758,2199,2021-07-22
317409,JAKARTA SELATAN,JAGAKARSA,23370,498,19966,323,2583,3081,2021-07-22
317505,JAKARTA TIMUR,PASAR REBO,15935,302,13899,260,1474,1776,2021-07-23
317404,JAKARTA SELATAN,PASAR MINGGU,21336,374,18815,345,1802,2176,2021-07-23
317408,JAKARTA SELATAN,PANCORAN,13116,217,11356,174,1369,1586,2021-07-23
317501,JAKARTA TIMUR,MATRAMAN,13089,279,11157,217,1436,1715,2021-07-23
317205,JAKARTA UTARA,PADEMANGAN,10970,251,9765,139,815,1066,2021-07-23
317106,JAKARTA PUSAT,MENTENG,5953,107,5247,102,497,604,2021-07-23
317201,JAKARTA UTARA,PENJARINGAN,17122,574,15183,189,1176,1750,2021-07-23
317307,JAKARTA BARAT,PALMERAH,14878,266,13316,265,1031,1297,2021-07-23
317410,JAKARTA SELATAN,PESANGGRAHAN,14627,286,12929,191,1221,1507,2021-07-23
317402,JAKARTA SELATAN,SETIA BUDI,10616,221,9425,156,814,1035,2021-07-23
317102,JAKARTA PUSAT,SAWAH BESAR,8282,295,7243,138,606,901,2021-07-23
317104,JAKARTA PUSAT,SENEN,8780,181,7835,141,623,804,2021-07-23
317303,JAKARTA BARAT,TAMAN SARI,8082,242,7106,107,627,869,2021-07-23
317304,JAKARTA BARAT,TAMBORA,13130,410,11602,196,922,1332,2021-07-23
317107,JAKARTA PUSAT,TANAH ABANG,10302,158,9347,186,611,769,2021-07-23
317202,JAKARTA UTARA,TANJUNG PRIOK,23774,513,21233,356,1672,2185,2021-07-23
317401,JAKARTA SELATAN,TEBET,15510,286,13576,222,1426,1712,2021-07-23
317508,JAKARTA TIMUR,MAKASAR,16097,399,14414,237,1047,1446,2021-07-23
111111,Luar DKI & Proses Update,Luar DKI & Proses Update,143008,137,141294,1273,304,441,2021-07-23
317502,JAKARTA TIMUR,PULO GADUNG,19852,540,17269,309,1734,2274,2021-07-23
317504,JAKARTA TIMUR,KRAMAT JATI,19855,296,17387,330,1842,2138,2021-07-23
317403,JAKARTA SELATAN,MAMPANG PRAPATAN,10566,141,9355,144,926,1067,2021-07-23
310101,KAB.ADM.KEP.SERIBU,KEP. SERIBU UTARA,554,7,486,5,56,63,2021-07-23
317203,JAKARTA UTARA,KOJA,15918,358,14119,277,1164,1522,2021-07-23
317105,JAKARTA PUSAT,CEMPAKA PUTIH,9565,399,8457,137,572,971,2021-07-23
317506,JAKARTA TIMUR,CAKUNG,20706,468,18658,316,1264,1732,2021-07-23
317301,JAKARTA BARAT,CENGKARENG,26536,643,23820,481,1592,2235,2021-07-23
317406,JAKARTA SELATAN,CILANDAK,15540,315,13684,209,1332,1647,2021-07-23
317204,JAKARTA UTARA,CILINCING,15718,403,13692,280,1343,1746,2021-07-23
317509,JAKARTA TIMUR,CIRACAS,20079,319,17618,297,1845,2164,2021-07-23
317507,JAKARTA TIMUR,DUREN SAWIT,26348,565,22927,477,2379,2944,2021-07-23
317101,JAKARTA PUSAT,GAMBIR,7947,170,7061,108,608,778,2021-07-23
317302,JAKARTA BARAT,GROGOL PETAMBURAN,17787,488,15897,253,1149,1637,2021-07-23
317510,JAKARTA TIMUR,CIPAYUNG,22833,277,20067,213,2276,2553,2021-07-23
317503,JAKARTA TIMUR,JATINEGARA,17949,264,15622,306,1757,2021,2021-07-23
310102,KAB.ADM.KEP.SERIBU,KEP. SERIBU SELATAN,622,0,547,4,71,71,2021-07-23
317409,JAKARTA SELATAN,JAGAKARSA,23540,502,20663,327,2048,2550,2021-07-23
317103,JAKARTA PUSAT,KEMAYORAN,18147,363,16064,291,1429,1792,2021-07-23
317206,JAKARTA UTARA,KELAPA GADING,11582,244,10157,152,1029,1273,2021-07-23
317305,JAKARTA BARAT,KEBON JERUK,20436,503,18039,297,1597,2100,2021-07-23
317308,JAKARTA BARAT,KEMBANGAN,18697,430,16361,220,1686,2116,2021-07-23
317407,JAKARTA SELATAN,KEBAYORAN BARU,12544,239,11145,148,1012,1251,2021-07-23
317306,JAKARTA BARAT,KALI DERES,16510,429,14703,255,1123,1552,2021-07-23
317108,JAKARTA PUSAT,JOHAR BARU,8103,139,7276,141,547,686,2021-07-23
317405,JAKARTA SELATAN,KEBAYORAN LAMA,18271,415,15984,281,1591,2006,2021-07-23
317405,JAKARTA SELATAN,KEBAYORAN LAMA,18444,397,16353,288,1406,1803,2021-07-24
111111,Luar DKI & Proses Update,Luar DKI & Proses Update,143008,137,141294,1273,304,441,2021-07-24
317203,JAKARTA UTARA,KOJA,16097,337,14500,284,976,1313,2021-07-24
310101,KAB.ADM.KEP.SERIBU,KEP. SERIBU UTARA,565,5,508,5,47,52,2021-07-24
310102,KAB.ADM.KEP.SERIBU,KEP. SERIBU SELATAN,636,0,563,4,69,69,2021-07-24
317308,JAKARTA BARAT,KEMBANGAN,18817,401,16729,227,1460,1861,2021-07-24
317103,JAKARTA PUSAT,KEMAYORAN,18321,336,16439,297,1249,1585,2021-07-24
317206,JAKARTA UTARA,KELAPA GADING,11691,236,10452,154,849,1085,2021-07-24
317305,JAKARTA BARAT,KEBON JERUK,20603,471,18437,299,1396,1867,2021-07-24
317407,JAKARTA SELATAN,KEBAYORAN BARU,12651,240,11348,150,913,1153,2021-07-24
317406,JAKARTA SELATAN,CILANDAK,15752,333,13968,215,1236,1569,2021-07-24
317108,JAKARTA PUSAT,JOHAR BARU,8197,146,7356,143,552,698,2021-07-24
317503,JAKARTA TIMUR,JATINEGARA,18145,247,15993,311,1594,1841,2021-07-24
317409,JAKARTA SELATAN,JAGAKARSA,23923,494,20980,332,2117,2611,2021-07-24
317302,JAKARTA BARAT,GROGOL PETAMBURAN,17955,480,16168,254,1053,1533,2021-07-24
317101,JAKARTA PUSAT,GAMBIR,8004,167,7197,108,532,699,2021-07-24
317507,JAKARTA TIMUR,DUREN SAWIT,26686,564,23372,484,2266,2830,2021-07-24
317509,JAKARTA TIMUR,CIRACAS,20332,325,17859,302,1846,2171,2021-07-24
317510,JAKARTA TIMUR,CIPAYUNG,23113,296,20271,214,2332,2628,2021-07-24
317204,JAKARTA UTARA,CILINCING,15893,362,14078,283,1170,1532,2021-07-24
317301,JAKARTA BARAT,CENGKARENG,26711,600,24230,484,1397,1997,2021-07-24
317105,JAKARTA PUSAT,CEMPAKA PUTIH,9728,500,8586,140,502,1002,2021-07-24
317506,JAKARTA TIMUR,CAKUNG,20940,448,18940,328,1224,1672,2021-07-24
317306,JAKARTA BARAT,KALI DERES,16689,407,14946,257,1079,1486,2021-07-24
317504,JAKARTA TIMUR,KRAMAT JATI,20056,293,17642,336,1785,2078,2021-07-24
317508,JAKARTA TIMUR,MAKASAR,16244,377,14614,239,1014,1391,2021-07-24
317401,JAKARTA SELATAN,TEBET,15679,272,13901,227,1279,1551,2021-07-24
317202,JAKARTA UTARA,TANJUNG PRIOK,24031,491,21747,357,1436,1927,2021-07-24
317107,JAKARTA PUSAT,TANAH ABANG,10382,180,9438,190,574,754,2021-07-24
317304,JAKARTA BARAT,TAMBORA,13245,369,11862,201,813,1182,2021-07-24
317303,JAKARTA BARAT,TAMAN SARI,8161,203,7322,109,527,730,2021-07-24
317402,JAKARTA SELATAN,SETIA BUDI,10708,217,9609,156,726,943,2021-07-24
317102,JAKARTA PUSAT,SAWAH BESAR,8376,281,7398,142,555,836,2021-07-24
317502,JAKARTA TIMUR,PULO GADUNG,20129,519,17761,315,1534,2053,2021-07-24
317410,JAKARTA SELATAN,PESANGGRAHAN,14778,265,13143,195,1175,1440,2021-07-24
317201,JAKARTA UTARA,PENJARINGAN,17273,525,15558,190,1000,1525,2021-07-24
317104,JAKARTA PUSAT,SENEN,8848,170,8034,144,500,670,2021-07-24
317404,JAKARTA SELATAN,PASAR MINGGU,21555,334,19286,352,1583,1917,2021-07-24
317505,JAKARTA TIMUR,PASAR REBO,16167,299,14278,261,1329,1628,2021-07-24
317501,JAKARTA TIMUR,MATRAMAN,13178,270,11550,219,1139,1409,2021-07-24
317106,JAKARTA PUSAT,MENTENG,6012,97,5352,103,460,557,2021-07-24
317403,JAKARTA SELATAN,MAMPANG PRAPATAN,10650,128,9481,148,893,1021,2021-07-24
317307,JAKARTA BARAT,PALMERAH,14978,301,13478,268,931,1232,2021-07-24
317408,JAKARTA SELATAN,PANCORAN,13239,210,11651,178,1200,1410,2021-07-24
317205,JAKARTA UTARA,PADEMANGAN,11068,229,10069,139,631,860,2021-07-24
317504,JAKARTA TIMUR,KRAMAT JATI,20195,257,18016,343,1579,1836,2021-07-25
317404,JAKARTA SELATAN,PASAR MINGGU,21723,330,19573,357,1463,1793,2021-07-25
317508,JAKARTA TIMUR,MAKASAR,16359,344,14829,243,943,1287,2021-07-25
317403,JAKARTA SELATAN,MAMPANG PRAPATAN,10714,118,9636,152,808,926,2021-07-25
317501,JAKARTA TIMUR,MATRAMAN,13295,246,11876,223,950,1196,2021-07-25
317106,JAKARTA PUSAT,MENTENG,6050,89,5481,106,374,463,2021-07-25
317205,JAKARTA UTARA,PADEMANGAN,11185,204,10191,140,650,854,2021-07-25
317307,JAKARTA BARAT,PALMERAH,15063,286,13757,272,748,1034,2021-07-25
317408,JAKARTA SELATAN,PANCORAN,13348,194,11893,183,1078,1272,2021-07-25
317505,JAKARTA TIMUR,PASAR REBO,16263,269,14500,265,1229,1498,2021-07-25
317401,JAKARTA SELATAN,TEBET,15769,251,14156,231,1131,1382,2021-07-25
317410,JAKARTA SELATAN,PESANGGRAHAN,14887,247,13411,200,1029,1276,2021-07-25
317502,JAKARTA TIMUR,PULO GADUNG,20310,491,18069,317,1433,1924,2021-07-25
317102,JAKARTA PUSAT,SAWAH BESAR,8402,250,7503,143,506,756,2021-07-25
317104,JAKARTA PUSAT,SENEN,8872,162,8149,146,415,577,2021-07-25
317402,JAKARTA SELATAN,SETIA BUDI,10759,202,9773,157,627,829,2021-07-25
317303,JAKARTA BARAT,TAMAN SARI,8217,200,7498,112,407,607,2021-07-25
317304,JAKARTA BARAT,TAMBORA,13322,345,12103,207,667,1012,2021-07-25
317107,JAKARTA PUSAT,TANAH ABANG,10434,174,9646,190,424,598,2021-07-25
317203,JAKARTA UTARA,KOJA,16175,317,14776,287,795,1112,2021-07-25
317202,JAKARTA UTARA,TANJUNG PRIOK,24151,457,22125,360,1209,1666,2021-07-25
317201,JAKARTA UTARA,PENJARINGAN,17378,492,15817,192,877,1369,2021-07-25
310101,KAB.ADM.KEP.SERIBU,KEP. SERIBU UTARA,565,2,526,5,32,34,2021-07-25
310102,KAB.ADM.KEP.SERIBU,KEP. SERIBU SELATAN,638,1,581,4,52,53,2021-07-25
317308,JAKARTA BARAT,KEMBANGAN,18985,383,17186,229,1187,1570,2021-07-25
111111,Luar DKI & Proses Update,Luar DKI & Proses Update,143008,137,141294,1273,304,441,2021-07-25
317105,JAKARTA PUSAT,CEMPAKA PUTIH,9794,470,8691,144,489,959,2021-07-25
317301,JAKARTA BARAT,CENGKARENG,26857,556,24730,487,1084,1640,2021-07-25
317406,JAKARTA SELATAN,CILANDAK,15919,328,14222,218,1151,1479,2021-07-25
317204,JAKARTA UTARA,CILINCING,15988,337,14371,285,995,1332,2021-07-25
317510,JAKARTA TIMUR,CIPAYUNG,23292,280,20818,215,1979,2259,2021-07-25
317509,JAKARTA TIMUR,CIRACAS,20474,295,18341,305,1533,1828,2021-07-25
317507,JAKARTA TIMUR,DUREN SAWIT,26960,495,23923,494,2048,2543,2021-07-25
317101,JAKARTA PUSAT,GAMBIR,8052,163,7368,111,410,573,2021-07-25
317506,JAKARTA TIMUR,CAKUNG,21108,417,19228,336,1127,1544,2021-07-25
317409,JAKARTA SELATAN,JAGAKARSA,24074,454,21533,342,1745,2199,2021-07-25
317503,JAKARTA TIMUR,JATINEGARA,18250,228,16458,313,1251,1479,2021-07-25
317108,JAKARTA PUSAT,JOHAR BARU,8226,132,7420,143,531,663,2021-07-25
317306,JAKARTA BARAT,KALI DERES,16782,372,15272,259,879,1251,2021-07-25
317407,JAKARTA SELATAN,KEBAYORAN BARU,12740,244,11550,153,793,1037,2021-07-25
317405,JAKARTA SELATAN,KEBAYORAN LAMA,18562,364,16607,296,1295,1659,2021-07-25
317305,JAKARTA BARAT,KEBON JERUK,20744,450,18870,303,1121,1571,2021-07-25
317206,JAKARTA UTARA,KELAPA GADING,11751,217,10654,156,724,941,2021-07-25
317103,JAKARTA PUSAT,KEMAYORAN,18425,313,16821,302,989,1302,2021-07-25
317302,JAKARTA BARAT,GROGOL PETAMBURAN,18064,470,16510,255,829,1299,2021-07-25
317503,JAKARTA TIMUR,JATINEGARA,18301,215,16839,315,932,1147,2021-07-26
317108,JAKARTA PUSAT,JOHAR BARU,8249,119,7633,143,354,473,2021-07-26
317206,JAKARTA UTARA,KELAPA GADING,11807,200,10812,159,636,836,2021-07-26
317407,JAKARTA SELATAN,KEBAYORAN BARU,12783,197,11859,153,574,771,2021-07-26
317305,JAKARTA BARAT,KEBON JERUK,20794,429,19154,306,905,1334,2021-07-26
317409,JAKARTA SELATAN,JAGAKARSA,24161,438,21996,343,1384,1822,2021-07-26
317306,JAKARTA BARAT,KALI DERES,16818,332,15579,262,645,977,2021-07-26
317302,JAKARTA BARAT,GROGOL PETAMBURAN,18118,424,16801,255,638,1062,2021-07-26
317204,JAKARTA UTARA,CILINCING,16032,292,14639,292,809,1101,2021-07-26
317507,JAKARTA TIMUR,DUREN SAWIT,27019,440,24495,504,1580,2020,2021-07-26
317509,JAKARTA TIMUR,CIRACAS,20519,259,18849,309,1102,1361,2021-07-26
317510,JAKARTA TIMUR,CIPAYUNG,23333,245,21493,221,1374,1619,2021-07-26
317406,JAKARTA SELATAN,CILANDAK,15970,308,14568,219,875,1183,2021-07-26
317301,JAKARTA BARAT,CENGKARENG,26927,511,25113,489,814,1325,2021-07-26
317105,JAKARTA PUSAT,CEMPAKA PUTIH,9814,424,9021,144,225,649,2021-07-26
317506,JAKARTA TIMUR,CAKUNG,21161,367,19647,339,808,1175,2021-07-26
317103,JAKARTA PUSAT,KEMAYORAN,18466,280,17150,305,731,1011,2021-07-26
317101,JAKARTA PUSAT,GAMBIR,8072,151,7498,112,311,462,2021-07-26
317308,JAKARTA BARAT,KEMBANGAN,19024,337,17515,232,940,1277,2021-07-26
317405,JAKARTA SELATAN,KEBAYORAN LAMA,18689,314,16980,299,1096,1410,2021-07-26
310101,KAB.ADM.KEP.SERIBU,KEP. SERIBU UTARA,567,3,530,5,29,32,2021-07-26
317401,JAKARTA SELATAN,TEBET,15819,236,14547,233,803,1039,2021-07-26
310102,KAB.ADM.KEP.SERIBU,KEP. SERIBU SELATAN,643,2,600,4,37,39,2021-07-26
317107,JAKARTA PUSAT,TANAH ABANG,10463,155,9782,192,334,489,2021-07-26
317304,JAKARTA BARAT,TAMBORA,13373,334,12305,208,526,860,2021-07-26
317303,JAKARTA BARAT,TAMAN SARI,8261,213,7591,114,343,556,2021-07-26
111111,Luar DKI & Proses Update,Luar DKI & Proses Update,143008,137,141294,1273,304,441,2021-07-26
317402,JAKARTA SELATAN,SETIA BUDI,10786,188,9984,161,453,641,2021-07-26
317104,JAKARTA PUSAT,SENEN,8888,147,8283,147,311,458,2021-07-26
317102,JAKARTA PUSAT,SAWAH BESAR,8441,250,7682,144,365,615,2021-07-26
317502,JAKARTA TIMUR,PULO GADUNG,20357,448,18450,322,1137,1585,2021-07-26
317410,JAKARTA SELATAN,PESANGGRAHAN,14993,225,13695,203,870,1095,2021-07-26
317201,JAKARTA UTARA,PENJARINGAN,17444,484,16019,192,749,1233,2021-07-26
317202,JAKARTA UTARA,TANJUNG PRIOK,24230,411,22394,363,1062,1473,2021-07-26
317404,JAKARTA SELATAN,PASAR MINGGU,21846,304,20060,357,1125,1429,2021-07-26
317505,JAKARTA TIMUR,PASAR REBO,16298,237,14849,267,945,1182,2021-07-26
317504,JAKARTA TIMUR,KRAMAT JATI,20232,223,18529,347,1133,1356,2021-07-26
317508,JAKARTA TIMUR,MAKASAR,16393,280,15136,245,732,1012,2021-07-26
317403,JAKARTA SELATAN,MAMPANG PRAPATAN,10728,105,9927,156,540,645,2021-07-26
317203,JAKARTA UTARA,KOJA,16243,277,15011,290,665,942,2021-07-26
317106,JAKARTA PUSAT,MENTENG,6071,86,5582,107,296,382,2021-07-26
317205,JAKARTA UTARA,PADEMANGAN,11278,201,10290,141,646,847,2021-07-26
317307,JAKARTA BARAT,PALMERAH,15086,263,13987,272,564,827,2021-07-26
317408,JAKARTA SELATAN,PANCORAN,13405,165,12282,185,773,938,2021-07-26
317501,JAKARTA TIMUR,MATRAMAN,13325,235,12151,225,714,949,2021-07-26
317508,JAKARTA TIMUR,MAKASAR,16446,303,15342,250,551,854,2021-07-27
317505,JAKARTA TIMUR,PASAR REBO,16362,261,15236,274,591,852,2021-07-27
317403,JAKARTA SELATAN,MAMPANG PRAPATAN,10772,106,10120,157,389,495,2021-07-27
317501,JAKARTA TIMUR,MATRAMAN,13370,228,12417,228,497,725,2021-07-27
317106,JAKARTA PUSAT,MENTENG,6091,89,5677,109,216,305,2021-07-27
317205,JAKARTA UTARA,PADEMANGAN,11348,211,10467,142,528,739,2021-07-27
317307,JAKARTA BARAT,PALMERAH,15138,258,14190,278,412,670,2021-07-27
317408,JAKARTA SELATAN,PANCORAN,13451,169,12605,189,488,657,2021-07-27
317404,JAKARTA SELATAN,PASAR MINGGU,21939,291,20450,361,837,1128,2021-07-27
317201,JAKARTA UTARA,PENJARINGAN,17518,483,16380,199,456,939,2021-07-27
317402,JAKARTA SELATAN,SETIA BUDI,10839,193,10183,164,299,492,2021-07-27
317502,JAKARTA TIMUR,PULO GADUNG,20438,436,18962,330,710,1146,2021-07-27
317102,JAKARTA PUSAT,SAWAH BESAR,8493,244,7819,146,284,528,2021-07-27
317104,JAKARTA PUSAT,SENEN,8937,151,8404,149,233,384,2021-07-27
317303,JAKARTA BARAT,TAMAN SARI,8299,217,7738,114,230,447,2021-07-27
317304,JAKARTA BARAT,TAMBORA,13432,333,12544,209,346,679,2021-07-27
317107,JAKARTA PUSAT,TANAH ABANG,10480,153,9900,197,230,383,2021-07-27
317202,JAKARTA UTARA,TANJUNG PRIOK,24283,411,22829,369,674,1085,2021-07-27
317401,JAKARTA SELATAN,TEBET,15877,240,14820,239,578,818,2021-07-27
111111,Luar DKI & Proses Update,Luar DKI & Proses Update,143008,137,141294,1273,304,441,2021-07-27
317410,JAKARTA SELATAN,PESANGGRAHAN,15110,237,14077,206,590,827,2021-07-27
317504,JAKARTA TIMUR,KRAMAT JATI,20288,227,18875,354,832,1059,2021-07-27
310102,KAB.ADM.KEP.SERIBU,KEP. SERIBU SELATAN,644,3,608,5,28,31,2021-07-27
317105,JAKARTA PUSAT,CEMPAKA PUTIH,9859,425,9111,145,178,603,2021-07-27
317506,JAKARTA TIMUR,CAKUNG,21220,374,19895,342,609,983,2021-07-27
317203,JAKARTA UTARA,KOJA,16304,301,15325,298,380,681,2021-07-27
317301,JAKARTA BARAT,CENGKARENG,26993,503,25448,492,550,1053,2021-07-27
317406,JAKARTA SELATAN,CILANDAK,16032,291,14846,221,674,965,2021-07-27
317204,JAKARTA UTARA,CILINCING,16081,305,14987,296,493,798,2021-07-27
317510,JAKARTA TIMUR,CIPAYUNG,23381,254,21883,224,1020,1274,2021-07-27
317509,JAKARTA TIMUR,CIRACAS,20568,267,19172,310,819,1086,2021-07-27
317101,JAKARTA PUSAT,GAMBIR,8089,156,7621,115,197,353,2021-07-27
317302,JAKARTA BARAT,GROGOL PETAMBURAN,18194,417,17096,259,422,839,2021-07-27
317409,JAKARTA SELATAN,JAGAKARSA,24309,356,22534,346,1073,1429,2021-07-27
317507,JAKARTA TIMUR,DUREN SAWIT,27163,456,24969,512,1226,1682,2021-07-27
317108,JAKARTA PUSAT,JOHAR BARU,8295,116,7754,144,281,397,2021-07-27
310101,KAB.ADM.KEP.SERIBU,KEP. SERIBU UTARA,566,1,543,6,16,17,2021-07-27
317503,JAKARTA TIMUR,JATINEGARA,18355,225,17125,321,684,909,2021-07-27
317103,JAKARTA PUSAT,KEMAYORAN,18522,292,17373,312,545,837,2021-07-27
317206,JAKARTA UTARA,KELAPA GADING,11854,196,11108,162,388,584,2021-07-27
317305,JAKARTA BARAT,KEBON JERUK,20905,418,19529,311,647,1065,2021-07-27
317308,JAKARTA BARAT,KEMBANGAN,19103,339,17898,236,630,969,2021-07-27
317405,JAKARTA SELATAN,KEBAYORAN LAMA,18754,320,17399,302,733,1053,2021-07-27
317407,JAKARTA SELATAN,KEBAYORAN BARU,12838,206,12054,155,423,629,2021-07-27
317306,JAKARTA BARAT,KALI DERES,16866,320,15829,264,453,773,2021-07-27
317403,JAKARTA SELATAN,MAMPANG PRAPATAN,10845,98,10274,161,312,410,2021-07-28
317106,JAKARTA PUSAT,MENTENG,6131,87,5786,109,149,236,2021-07-28
317205,JAKARTA UTARA,PADEMANGAN,11425,177,10686,143,419,596,2021-07-28
317307,JAKARTA BARAT,PALMERAH,15204,230,14408,282,284,514,2021-07-28
317408,JAKARTA SELATAN,PANCORAN,13535,161,12809,190,375,536,2021-07-28
317404,JAKARTA SELATAN,PASAR MINGGU,22066,271,20773,363,659,930,2021-07-28
111111,Luar DKI & Proses Update,Luar DKI & Proses Update,143008,137,141294,1273,304,441,2021-07-28
317501,JAKARTA TIMUR,MATRAMAN,13451,217,12619,234,381,598,2021-07-28
317201,JAKARTA UTARA,PENJARINGAN,17628,470,16628,199,331,801,2021-07-28
317505,JAKARTA TIMUR,PASAR REBO,16483,261,15428,276,518,779,2021-07-28
317202,JAKARTA UTARA,TANJUNG PRIOK,24387,361,23149,371,506,867,2021-07-28
317107,JAKARTA PUSAT,TANAH ABANG,10546,141,10004,199,202,343,2021-07-28
317304,JAKARTA BARAT,TAMBORA,13519,286,12762,210,261,547,2021-07-28
317303,JAKARTA BARAT,TAMAN SARI,8350,177,7873,116,184,361,2021-07-28
317402,JAKARTA SELATAN,SETIA BUDI,10908,174,10337,164,233,407,2021-07-28
317104,JAKARTA PUSAT,SENEN,8969,139,8525,149,156,295,2021-07-28
317102,JAKARTA PUSAT,SAWAH BESAR,8541,197,7995,147,202,399,2021-07-28
317502,JAKARTA TIMUR,PULO GADUNG,20593,420,19209,332,632,1052,2021-07-28
317410,JAKARTA SELATAN,PESANGGRAHAN,15203,221,14283,209,490,711,2021-07-28
317401,JAKARTA SELATAN,TEBET,16023,227,15063,242,491,718,2021-07-28
317508,JAKARTA TIMUR,MAKASAR,16570,299,15530,251,490,789,2021-07-28
317407,JAKARTA SELATAN,KEBAYORAN BARU,12946,202,12238,156,350,552,2021-07-28
317203,JAKARTA UTARA,KOJA,16368,275,15523,299,271,546,2021-07-28
317108,JAKARTA PUSAT,JOHAR BARU,8322,102,7867,145,208,310,2021-07-28
317503,JAKARTA TIMUR,JATINEGARA,18466,211,17408,322,525,736,2021-07-28
317409,JAKARTA SELATAN,JAGAKARSA,24521,314,22989,350,868,1182,2021-07-28
317302,JAKARTA BARAT,GROGOL PETAMBURAN,18302,387,17323,263,329,716,2021-07-28
317101,JAKARTA PUSAT,GAMBIR,8131,138,7742,115,136,274,2021-07-28
317507,JAKARTA TIMUR,DUREN SAWIT,27447,416,25418,515,1098,1514,2021-07-28
317509,JAKARTA TIMUR,CIRACAS,20768,261,19471,310,726,987,2021-07-28
317510,JAKARTA TIMUR,CIPAYUNG,23554,251,22273,227,803,1054,2021-07-28
317504,JAKARTA TIMUR,KRAMAT JATI,20445,210,19226,358,651,861,2021-07-28
317406,JAKARTA SELATAN,CILANDAK,16174,257,15111,222,584,841,2021-07-28
317301,JAKARTA BARAT,CENGKARENG,27162,451,25753,495,463,914,2021-07-28
317204,JAKARTA UTARA,CILINCING,16163,299,15204,300,360,659,2021-07-28
317506,JAKARTA TIMUR,CAKUNG,21388,368,20123,343,554,922,2021-07-28
310101,KAB.ADM.KEP.SERIBU,KEP. SERIBU UTARA,581,6,553,6,16,22,2021-07-28
310102,KAB.ADM.KEP.SERIBU,KEP. SERIBU SELATAN,643,2,615,5,21,23,2021-07-28
317308,JAKARTA BARAT,KEMBANGAN,19192,315,18141,239,497,812,2021-07-28
317103,JAKARTA PUSAT,KEMAYORAN,18638,247,17630,313,448,695,2021-07-28
317105,JAKARTA PUSAT,CEMPAKA PUTIH,9923,388,9217,145,173,561,2021-07-28
317306,JAKARTA BARAT,KALI DERES,16988,241,16096,266,385,626,2021-07-28
317305,JAKARTA BARAT,KEBON JERUK,21041,373,19813,314,541,914,2021-07-28
317405,JAKARTA SELATAN,KEBAYORAN LAMA,18885,310,17678,303,594,904,2021-07-28
317206,JAKARTA UTARA,KELAPA GADING,11922,176,11261,164,321,497,2021-07-28
317506,JAKARTA TIMUR,CAKUNG,21496,302,20382,349,463,765,2021-07-29
317105,JAKARTA PUSAT,CEMPAKA PUTIH,9968,295,9377,146,150,445,2021-07-29
317406,JAKARTA SELATAN,CILANDAK,16300,208,15432,226,434,642,2021-07-29
317204,JAKARTA UTARA,CILINCING,16304,249,15438,305,312,561,2021-07-29
317510,JAKARTA TIMUR,CIPAYUNG,23682,213,22599,232,638,851,2021-07-29
317509,JAKARTA TIMUR,CIRACAS,20875,229,19750,317,579,808,2021-07-29
111111,Luar DKI & Proses Update,Luar DKI & Proses Update,143008,137,141294,1273,304,441,2021-07-29
317507,JAKARTA TIMUR,DUREN SAWIT,27587,353,25818,526,890,1243,2021-07-29
317301,JAKARTA BARAT,CENGKARENG,27270,343,26111,499,317,660,2021-07-29
317101,JAKARTA PUSAT,GAMBIR,8160,114,7829,115,102,216,2021-07-29
317201,JAKARTA UTARA,PENJARINGAN,17705,380,16887,201,237,617,2021-07-29
317501,JAKARTA TIMUR,MATRAMAN,13475,150,12848,240,237,387,2021-07-29
317205,JAKARTA UTARA,PADEMANGAN,11460,150,10814,144,352,502,2021-07-29
317307,JAKARTA BARAT,PALMERAH,15253,189,14593,284,187,376,2021-07-29
317408,JAKARTA SELATAN,PANCORAN,13613,145,12952,191,325,470,2021-07-29
317404,JAKARTA SELATAN,PASAR MINGGU,22175,221,21048,370,536,757,2021-07-29
317505,JAKARTA TIMUR,PASAR REBO,16583,208,15632,285,458,666,2021-07-29
317410,JAKARTA SELATAN,PESANGGRAHAN,15279,170,14498,209,402,572,2021-07-29
317403,JAKARTA SELATAN,MAMPANG PRAPATAN,10899,80,10416,162,241,321,2021-07-29
317502,JAKARTA TIMUR,PULO GADUNG,20680,362,19481,339,498,860,2021-07-29
317104,JAKARTA PUSAT,SENEN,8995,117,8624,151,103,220,2021-07-29
317402,JAKARTA SELATAN,SETIA BUDI,10934,139,10478,165,152,291,2021-07-29
317303,JAKARTA BARAT,TAMAN SARI,8380,148,8008,117,107,255,2021-07-29
317304,JAKARTA BARAT,TAMBORA,13565,218,12966,211,170,388,2021-07-29
317107,JAKARTA PUSAT,TANAH ABANG,10584,117,10128,199,140,257,2021-07-29
317202,JAKARTA UTARA,TANJUNG PRIOK,24485,301,23442,375,367,668,2021-07-29
317401,JAKARTA SELATAN,TEBET,16065,182,15289,245,349,531,2021-07-29
317102,JAKARTA PUSAT,SAWAH BESAR,8565,166,8123,150,126,292,2021-07-29
317508,JAKARTA TIMUR,MAKASAR,16639,236,15775,254,374,610,2021-07-29
317106,JAKARTA PUSAT,MENTENG,6154,72,5888,111,83,155,2021-07-29
317203,JAKARTA UTARA,KOJA,16424,232,15665,301,226,458,2021-07-29
317302,JAKARTA BARAT,GROGOL PETAMBURAN,18382,315,17555,264,248,563,2021-07-29
317409,JAKARTA SELATAN,JAGAKARSA,24686,259,23388,359,680,939,2021-07-29
317503,JAKARTA TIMUR,JATINEGARA,18545,168,17633,328,416,584,2021-07-29
317504,JAKARTA TIMUR,KRAMAT JATI,20524,180,19508,360,476,656,2021-07-29
317306,JAKARTA BARAT,KALI DERES,17073,182,16372,268,251,433,2021-07-29
317407,JAKARTA SELATAN,KEBAYORAN BARU,12989,163,12391,161,274,437,2021-07-29
317405,JAKARTA SELATAN,KEBAYORAN LAMA,18961,239,17949,306,467,706,2021-07-29
317108,JAKARTA PUSAT,JOHAR BARU,8341,89,7989,147,116,205,2021-07-29
317305,JAKARTA BARAT,KEBON JERUK,21125,331,20138,314,342,673,2021-07-29
317206,JAKARTA UTARA,KELAPA GADING,11962,133,11437,168,224,357,2021-07-29
317103,JAKARTA PUSAT,KEMAYORAN,18725,212,17906,318,289,501,2021-07-29
317308,JAKARTA BARAT,KEMBANGAN,19264,242,18445,245,332,574,2021-07-29
310102,KAB.ADM.KEP.SERIBU,KEP. SERIBU SELATAN,654,2,638,7,7,9,2021-07-29
310101,KAB.ADM.KEP.SERIBU,KEP. SERIBU UTARA,581,5,569,6,1,6,2021-07-29
317205,JAKARTA UTARA,PADEMANGAN,11514,123,11025,146,220,343,2021-07-30
317106,JAKARTA PUSAT,MENTENG,6172,51,5949,111,61,112,2021-07-30
317501,JAKARTA TIMUR,MATRAMAN,13542,102,13038,240,162,264,2021-07-30
317410,JAKARTA SELATAN,PESANGGRAHAN,15368,127,14738,212,291,418,2021-07-30
317408,JAKARTA SELATAN,PANCORAN,13661,108,13164,195,194,302,2021-07-30
317404,JAKARTA SELATAN,PASAR MINGGU,22288,176,21381,370,361,537,2021-07-30
317505,JAKARTA TIMUR,PASAR REBO,16668,152,15933,289,294,446,2021-07-30
317201,JAKARTA UTARA,PENJARINGAN,17760,274,17145,203,138,412,2021-07-30
317307,JAKARTA BARAT,PALMERAH,15289,142,14725,288,134,276,2021-07-30
317502,JAKARTA TIMUR,PULO GADUNG,20760,259,19887,348,266,525,2021-07-30
317101,JAKARTA PUSAT,GAMBIR,8179,89,7917,116,57,146,2021-07-30
317104,JAKARTA PUSAT,SENEN,9032,89,8712,152,79,168,2021-07-30
317402,JAKARTA SELATAN,SETIA BUDI,11000,116,10599,165,120,236,2021-07-30
317303,JAKARTA BARAT,TAMAN SARI,8415,126,8098,117,74,200,2021-07-30
317304,JAKARTA BARAT,TAMBORA,13596,168,13114,214,100,268,2021-07-30
317107,JAKARTA PUSAT,TANAH ABANG,10609,87,10216,202,104,191,2021-07-30
317403,JAKARTA SELATAN,MAMPANG PRAPATAN,10919,72,10545,164,138,210,2021-07-30
317202,JAKARTA UTARA,TANJUNG PRIOK,24570,230,23716,381,243,473,2021-07-30
317401,JAKARTA SELATAN,TEBET,16151,132,15514,247,258,390,2021-07-30
317302,JAKARTA BARAT,GROGOL PETAMBURAN,18452,262,17750,265,175,437,2021-07-30
317102,JAKARTA PUSAT,SAWAH BESAR,8610,139,8228,150,93,232,2021-07-30
317508,JAKARTA TIMUR,MAKASAR,16685,150,16062,258,215,365,2021-07-30
317103,JAKARTA PUSAT,KEMAYORAN,18803,161,18094,324,224,385,2021-07-30
317203,JAKARTA UTARA,KOJA,16459,183,15846,303,127,310,2021-07-30
317409,JAKARTA SELATAN,JAGAKARSA,24760,203,23750,362,445,648,2021-07-30
317504,JAKARTA TIMUR,KRAMAT JATI,20587,139,19787,363,298,437,2021-07-30
317503,JAKARTA TIMUR,JATINEGARA,18606,126,17905,330,245,371,2021-07-30
111111,Luar DKI & Proses Update,Luar DKI & Proses Update,143008,137,141294,1273,304,441,2021-07-30
317506,JAKARTA TIMUR,CAKUNG,21588,226,20708,355,299,525,2021-07-30
317105,JAKARTA PUSAT,CEMPAKA PUTIH,9948,193,9519,145,91,284,2021-07-30
317301,JAKARTA BARAT,CENGKARENG,27335,264,26335,503,233,497,2021-07-30
317406,JAKARTA SELATAN,CILANDAK,16439,188,15645,227,379,567,2021-07-30
317204,JAKARTA UTARA,CILINCING,16360,196,15650,306,208,404,2021-07-30
317510,JAKARTA TIMUR,CIPAYUNG,23781,183,23003,235,360,543,2021-07-30
317507,JAKARTA TIMUR,DUREN SAWIT,27723,276,26355,529,563,839,2021-07-30
317108,JAKARTA PUSAT,JOHAR BARU,8364,65,8069,147,83,148,2021-07-30
317306,JAKARTA BARAT,KALI DERES,17146,133,16548,272,193,326,2021-07-30
317407,JAKARTA SELATAN,KEBAYORAN BARU,13098,146,12581,161,210,356,2021-07-30
317405,JAKARTA SELATAN,KEBAYORAN LAMA,19036,180,18228,310,318,498,2021-07-30
317305,JAKARTA BARAT,KEBON JERUK,21182,251,20378,315,238,489,2021-07-30
317206,JAKARTA UTARA,KELAPA GADING,11995,99,11583,170,143,242,2021-07-30
317308,JAKARTA BARAT,KEMBANGAN,19336,162,18706,250,218,380,2021-07-30
317509,JAKARTA TIMUR,CIRACAS,20974,179,20106,321,368,547,2021-07-30
310102,KAB.ADM.KEP.SERIBU,KEP. SERIBU SELATAN,667,1,640,7,19,20,2021-07-30
310101,KAB.ADM.KEP.SERIBU,KEP. SERIBU UTARA,584,4,570,6,4,8,2021-07-30
317405,JAKARTA SELATAN,KEBAYORAN LAMA,19119,162,18397,312,248,410,2021-07-31
317305,JAKARTA BARAT,KEBON JERUK,21259,246,20508,321,184,430,2021-07-31
317206,JAKARTA UTARA,KELAPA GADING,12049,87,11659,173,130,217,2021-07-31
317103,JAKARTA PUSAT,KEMAYORAN,18864,143,18214,333,174,317,2021-07-31
310101,KAB.ADM.KEP.SERIBU,KEP. SERIBU UTARA,586,4,570,6,6,10,2021-07-31
310102,KAB.ADM.KEP.SERIBU,KEP. SERIBU SELATAN,665,1,644,7,13,14,2021-07-31
317407,JAKARTA SELATAN,KEBAYORAN BARU,13149,128,12665,162,194,322,2021-07-31
317203,JAKARTA UTARA,KOJA,16508,165,15924,310,109,274,2021-07-31
317504,JAKARTA TIMUR,KRAMAT JATI,20663,128,19876,368,291,419,2021-07-31
317508,JAKARTA TIMUR,MAKASAR,16758,154,16114,265,225,379,2021-07-31
317308,JAKARTA BARAT,KEMBANGAN,19393,161,18798,255,179,340,2021-07-31
317306,JAKARTA BARAT,KALI DERES,17184,118,16647,277,142,260,2021-07-31
317101,JAKARTA PUSAT,GAMBIR,8201,83,7951,116,51,134,2021-07-31
317503,JAKARTA TIMUR,JATINEGARA,18651,103,17973,339,236,339,2021-07-31
317409,JAKARTA SELATAN,JAGAKARSA,24951,193,24027,366,365,558,2021-07-31
317302,JAKARTA BARAT,GROGOL PETAMBURAN,18514,234,17871,269,140,374,2021-07-31
317507,JAKARTA TIMUR,DUREN SAWIT,27866,257,26534,536,539,796,2021-07-31
317509,JAKARTA TIMUR,CIRACAS,21103,169,20179,325,430,599,2021-07-31
317510,JAKARTA TIMUR,CIPAYUNG,23888,169,23086,238,395,564,2021-07-31
317204,JAKARTA UTARA,CILINCING,16415,187,15709,315,204,391,2021-07-31
317301,JAKARTA BARAT,CENGKARENG,27419,250,26458,512,199,449,2021-07-31
317105,JAKARTA PUSAT,CEMPAKA PUTIH,9998,179,9618,147,54,233,2021-07-31
317506,JAKARTA TIMUR,CAKUNG,21671,215,20799,360,297,512,2021-07-31
317403,JAKARTA SELATAN,MAMPANG PRAPATAN,10981,79,10584,167,151,230,2021-07-31
317108,JAKARTA PUSAT,JOHAR BARU,8383,62,8125,148,48,110,2021-07-31
317406,JAKARTA SELATAN,CILANDAK,16541,166,15835,228,312,478,2021-07-31
317501,JAKARTA TIMUR,MATRAMAN,13573,87,13100,243,143,230,2021-07-31
317205,JAKARTA UTARA,PADEMANGAN,11607,115,11154,146,192,307,2021-07-31
317106,JAKARTA PUSAT,MENTENG,6187,52,5976,113,46,98,2021-07-31
111111,Luar DKI & Proses Update,Luar DKI & Proses Update,143008,137,141294,1273,304,441,2021-07-31
317401,JAKARTA SELATAN,TEBET,16218,121,15596,248,253,374,2021-07-31
317202,JAKARTA UTARA,TANJUNG PRIOK,24661,198,23831,385,247,445,2021-07-31
317304,JAKARTA BARAT,TAMBORA,13639,168,13188,217,66,234,2021-07-31
317303,JAKARTA BARAT,TAMAN SARI,8436,124,8148,118,46,170,2021-07-31
317402,JAKARTA SELATAN,SETIA BUDI,11041,103,10642,169,127,230,2021-07-31
317104,JAKARTA PUSAT,SENEN,9049,83,8762,154,50,133,2021-07-31
317107,JAKARTA PUSAT,TANAH ABANG,10634,67,10291,204,72,139,2021-07-31
317502,JAKARTA TIMUR,PULO GADUNG,20828,227,19991,353,257,484,2021-07-31
317410,JAKARTA SELATAN,PESANGGRAHAN,15423,128,14853,219,223,351,2021-07-31
317201,JAKARTA UTARA,PENJARINGAN,17805,246,17245,206,108,354,2021-07-31
317505,JAKARTA TIMUR,PASAR REBO,16758,117,16012,294,335,452,2021-07-31
317404,JAKARTA SELATAN,PASAR MINGGU,22377,168,21527,375,307,475,2021-07-31
317408,JAKARTA SELATAN,PANCORAN,13718,103,13233,200,182,285,2021-07-31
317102,JAKARTA PUSAT,SAWAH BESAR,8630,124,8299,151,56,180,2021-07-31
317307,JAKARTA BARAT,PALMERAH,15321,112,14813,293,103,215,2021-07-31
317505,JAKARTA TIMUR,PASAR REBO,16848,101,16137,296,314,415,2021-08-01
317404,JAKARTA SELATAN,PASAR MINGGU,22469,139,21645,376,309,448,2021-08-01
317408,JAKARTA SELATAN,PANCORAN,13767,85,13308,203,171,256,2021-08-01
317106,JAKARTA PUSAT,MENTENG,6209,45,6004,114,46,91,2021-08-01
317205,JAKARTA UTARA,PADEMANGAN,11676,96,11265,147,168,264,2021-08-01
317501,JAKARTA TIMUR,MATRAMAN,13631,77,13179,245,130,207,2021-08-01
317201,JAKARTA UTARA,PENJARINGAN,17849,218,17326,207,98,316,2021-08-01
317307,JAKARTA BARAT,PALMERAH,15345,90,14870,293,92,182,2021-08-01
317410,JAKARTA SELATAN,PESANGGRAHAN,15532,105,14927,221,279,384,2021-08-01
317202,JAKARTA UTARA,TANJUNG PRIOK,24724,174,23937,387,226,400,2021-08-01
317102,JAKARTA PUSAT,SAWAH BESAR,8654,103,8352,151,48,151,2021-08-01
317104,JAKARTA PUSAT,SENEN,9064,81,8779,154,50,131,2021-08-01
317402,JAKARTA SELATAN,SETIA BUDI,11074,88,10704,169,113,201,2021-08-01
317303,JAKARTA BARAT,TAMAN SARI,8456,96,8193,118,49,145,2021-08-01
317304,JAKARTA BARAT,TAMBORA,13669,133,13239,219,78,211,2021-08-01
317107,JAKARTA PUSAT,TANAH ABANG,10661,64,10320,205,72,136,2021-08-01
317403,JAKARTA SELATAN,MAMPANG PRAPATAN,11010,70,10652,169,119,189,2021-08-01
317401,JAKARTA SELATAN,TEBET,16260,104,15726,248,182,286,2021-08-01
111111,Luar DKI & Proses Update,Luar DKI & Proses Update,143008,137,141294,1273,304,441,2021-08-01
317502,JAKARTA TIMUR,PULO GADUNG,20881,187,20146,356,192,379,2021-08-01
317508,JAKARTA TIMUR,MAKASAR,16812,125,16239,266,182,307,2021-08-01
317305,JAKARTA BARAT,KEBON JERUK,21334,210,20615,322,187,397,2021-08-01
317203,JAKARTA UTARA,KOJA,16554,133,15999,313,109,242,2021-08-01
317506,JAKARTA TIMUR,CAKUNG,21755,175,20957,362,261,436,2021-08-01
317105,JAKARTA PUSAT,CEMPAKA PUTIH,10018,122,9703,148,45,167,2021-08-01
317301,JAKARTA BARAT,CENGKARENG,27450,198,26570,513,169,367,2021-08-01
317406,JAKARTA SELATAN,CILANDAK,16631,137,15892,229,373,510,2021-08-01
317204,JAKARTA UTARA,CILINCING,16444,150,15792,315,187,337,2021-08-01
317509,JAKARTA TIMUR,CIRACAS,21176,146,20380,330,320,466,2021-08-01
317507,JAKARTA TIMUR,DUREN SAWIT,27932,218,26806,539,369,587,2021-08-01
317101,JAKARTA PUSAT,GAMBIR,8225,68,7990,116,51,119,2021-08-01
317302,JAKARTA BARAT,GROGOL PETAMBURAN,18539,193,17937,271,138,331,2021-08-01
317504,JAKARTA TIMUR,KRAMAT JATI,20739,111,20034,368,226,337,2021-08-01
317409,JAKARTA SELATAN,JAGAKARSA,25085,155,24093,371,466,621,2021-08-01
317108,JAKARTA PUSAT,JOHAR BARU,8407,53,8157,149,48,101,2021-08-01
317306,JAKARTA BARAT,KALI DERES,17216,94,16715,279,128,222,2021-08-01
317407,JAKARTA SELATAN,KEBAYORAN BARU,13187,109,12764,162,152,261,2021-08-01
317405,JAKARTA SELATAN,KEBAYORAN LAMA,19196,147,18518,315,216,363,2021-08-01
317206,JAKARTA UTARA,KELAPA GADING,12093,70,11717,178,128,198,2021-08-01
317103,JAKARTA PUSAT,KEMAYORAN,18944,145,18266,336,197,342,2021-08-01
317308,JAKARTA BARAT,KEMBANGAN,19435,129,18883,256,167,296,2021-08-01
310102,KAB.ADM.KEP.SERIBU,KEP. SERIBU SELATAN,675,1,645,8,21,22,2021-08-01
310101,KAB.ADM.KEP.SERIBU,KEP. SERIBU UTARA,593,4,570,6,13,17,2021-08-01
317503,JAKARTA TIMUR,JATINEGARA,18710,89,18079,340,202,291,2021-08-01
317510,JAKARTA TIMUR,CIPAYUNG,23972,140,23266,241,325,465,2021-08-01
317107,JAKARTA PUSAT,TANAH ABANG,10670,52,10337,209,72,124,2021-08-02
317506,JAKARTA TIMUR,CAKUNG,21776,168,21001,370,237,405,2021-08-02
317508,JAKARTA TIMUR,MAKASAR,16831,124,16262,270,175,299,2021-08-02
317403,JAKARTA SELATAN,MAMPANG PRAPATAN,11025,63,10668,169,125,188,2021-08-02
317501,JAKARTA TIMUR,MATRAMAN,13641,67,13193,250,131,198,2021-08-02
317106,JAKARTA PUSAT,MENTENG,6214,35,6025,115,39,74,2021-08-02
317205,JAKARTA UTARA,PADEMANGAN,11728,77,11308,149,194,271,2021-08-02
317307,JAKARTA BARAT,PALMERAH,15363,86,14888,297,92,178,2021-08-02
317408,JAKARTA SELATAN,PANCORAN,13780,76,13324,210,170,246,2021-08-02
317404,JAKARTA SELATAN,PASAR MINGGU,22533,123,21692,381,337,460,2021-08-02
317504,JAKARTA TIMUR,KRAMAT JATI,20758,99,20064,371,224,323,2021-08-02
317505,JAKARTA TIMUR,PASAR REBO,16861,84,16164,298,315,399,2021-08-02
317410,JAKARTA SELATAN,PESANGGRAHAN,15561,89,14965,225,282,371,2021-08-02
317502,JAKARTA TIMUR,PULO GADUNG,20908,177,20186,360,185,362,2021-08-02
317102,JAKARTA PUSAT,SAWAH BESAR,8670,89,8377,152,52,141,2021-08-02
317104,JAKARTA PUSAT,SENEN,9058,76,8772,155,55,131,2021-08-02
317402,JAKARTA SELATAN,SETIA BUDI,11088,73,10730,171,114,187,2021-08-02
111111,Luar DKI & Proses Update,Luar DKI & Proses Update,143008,137,141294,1273,304,441,2021-08-02
317303,JAKARTA BARAT,TAMAN SARI,8469,79,8223,121,46,125,2021-08-02
317202,JAKARTA UTARA,TANJUNG PRIOK,24777,164,24030,389,194,358,2021-08-02
317201,JAKARTA UTARA,PENJARINGAN,17890,178,17398,210,104,282,2021-08-02
317203,JAKARTA UTARA,KOJA,16579,120,16027,316,116,236,2021-08-02
310101,KAB.ADM.KEP.SERIBU,KEP. SERIBU UTARA,591,4,570,6,11,15,2021-08-02
310102,KAB.ADM.KEP.SERIBU,KEP. SERIBU SELATAN,675,0,647,8,20,20,2021-08-02
317105,JAKARTA PUSAT,CEMPAKA PUTIH,10038,114,9726,152,46,160,2021-08-02
317301,JAKARTA BARAT,CENGKARENG,27482,164,26651,514,153,317,2021-08-02
317406,JAKARTA SELATAN,CILANDAK,16657,119,15938,236,364,483,2021-08-02
317204,JAKARTA UTARA,CILINCING,16494,133,15822,322,217,350,2021-08-02
317510,JAKARTA TIMUR,CIPAYUNG,23999,133,23298,243,325,458,2021-08-02
317509,JAKARTA TIMUR,CIRACAS,21201,129,20416,333,323,452,2021-08-02
317507,JAKARTA TIMUR,DUREN SAWIT,27985,205,26876,549,355,560,2021-08-02
317101,JAKARTA PUSAT,GAMBIR,8242,64,8003,117,58,122,2021-08-02
317302,JAKARTA BARAT,GROGOL PETAMBURAN,18563,156,18010,272,125,281,2021-08-02
317409,JAKARTA SELATAN,JAGAKARSA,25145,151,24144,374,476,627,2021-08-02
317503,JAKARTA TIMUR,JATINEGARA,18741,76,18114,346,205,281,2021-08-02
317108,JAKARTA PUSAT,JOHAR BARU,8417,44,8172,151,50,94,2021-08-02
317306,JAKARTA BARAT,KALI DERES,17241,78,16759,281,123,201,2021-08-02
317407,JAKARTA SELATAN,KEBAYORAN BARU,13200,96,12800,166,138,234,2021-08-02
317405,JAKARTA SELATAN,KEBAYORAN LAMA,19248,145,18550,316,237,382,2021-08-02
317305,JAKARTA BARAT,KEBON JERUK,21356,175,20677,329,175,350,2021-08-02
317206,JAKARTA UTARA,KELAPA GADING,12112,64,11748,180,120,184,2021-08-02
317103,JAKARTA PUSAT,KEMAYORAN,18966,131,18306,341,188,319,2021-08-02
317308,JAKARTA BARAT,KEMBANGAN,19481,119,18922,263,177,296,2021-08-02
317304,JAKARTA BARAT,TAMBORA,13694,108,13290,223,73,181,2021-08-02
317401,JAKARTA SELATAN,TEBET,16276,90,15753,249,184,274,2021-08-02
317203,JAKARTA UTARA,KOJA,16597,102,16055,320,120,222,2021-08-03
317202,JAKARTA UTARA,TANJUNG PRIOK,24816,160,24065,393,198,358,2021-08-03
317103,JAKARTA PUSAT,KEMAYORAN,18987,129,18373,343,142,271,2021-08-03
317206,JAKARTA UTARA,KELAPA GADING,12136,58,11762,181,135,193,2021-08-03
317305,JAKARTA BARAT,KEBON JERUK,21393,154,20728,329,182,336,2021-08-03
317405,JAKARTA SELATAN,KEBAYORAN LAMA,19275,120,18621,320,214,334,2021-08-03
317407,JAKARTA SELATAN,KEBAYORAN BARU,13228,85,12832,166,145,230,2021-08-03
317306,JAKARTA BARAT,KALI DERES,17261,77,16790,282,112,189,2021-08-03
317108,JAKARTA PUSAT,JOHAR BARU,8426,38,8186,151,51,89,2021-08-03
317503,JAKARTA TIMUR,JATINEGARA,18761,70,18172,348,171,241,2021-08-03
317409,JAKARTA SELATAN,JAGAKARSA,25186,140,24281,375,390,530,2021-08-03
317302,JAKARTA BARAT,GROGOL PETAMBURAN,18604,144,18063,275,122,266,2021-08-03
317101,JAKARTA PUSAT,GAMBIR,8251,53,8022,118,58,111,2021-08-03
317507,JAKARTA TIMUR,DUREN SAWIT,28039,182,26945,549,363,545,2021-08-03
317509,JAKARTA TIMUR,CIRACAS,21229,122,20511,335,261,383,2021-08-03
317510,JAKARTA TIMUR,CIPAYUNG,24035,125,23428,243,239,364,2021-08-03
317204,JAKARTA UTARA,CILINCING,16514,114,15899,322,179,293,2021-08-03
317406,JAKARTA SELATAN,CILANDAK,16706,120,16033,237,316,436,2021-08-03
317301,JAKARTA BARAT,CENGKARENG,27511,152,26694,517,148,300,2021-08-03
317105,JAKARTA PUSAT,CEMPAKA PUTIH,10048,114,9738,153,43,157,2021-08-03
317506,JAKARTA TIMUR,CAKUNG,21799,148,21096,371,184,332,2021-08-03
317308,JAKARTA BARAT,KEMBANGAN,19535,121,18951,264,199,320,2021-08-03
317401,JAKARTA SELATAN,TEBET,16295,85,15779,251,180,265,2021-08-03
310102,KAB.ADM.KEP.SERIBU,KEP. SERIBU SELATAN,675,0,647,8,20,20,2021-08-03
111111,Luar DKI & Proses Update,Luar DKI & Proses Update,143008,137,141294,1273,304,441,2021-08-03
317107,JAKARTA PUSAT,TANAH ABANG,10685,48,10363,210,64,112,2021-08-03
317304,JAKARTA BARAT,TAMBORA,13709,103,13320,224,62,165,2021-08-03
317303,JAKARTA BARAT,TAMAN SARI,8479,67,8257,122,33,100,2021-08-03
317402,JAKARTA SELATAN,SETIA BUDI,11111,67,10754,172,118,185,2021-08-03
317104,JAKARTA PUSAT,SENEN,9066,65,8792,157,52,117,2021-08-03
317102,JAKARTA PUSAT,SAWAH BESAR,8691,82,8398,154,57,139,2021-08-03
317502,JAKARTA TIMUR,PULO GADUNG,20938,160,20281,362,135,295,2021-08-03
317410,JAKARTA SELATAN,PESANGGRAHAN,15620,71,15039,227,283,354,2021-08-03
317201,JAKARTA UTARA,PENJARINGAN,17927,166,17431,213,117,283,2021-08-03
317505,JAKARTA TIMUR,PASAR REBO,16878,69,16265,305,239,308,2021-08-03
317404,JAKARTA SELATAN,PASAR MINGGU,22564,109,21771,383,301,410,2021-08-03
317408,JAKARTA SELATAN,PANCORAN,13805,73,13379,210,143,216,2021-08-03
317307,JAKARTA BARAT,PALMERAH,15388,77,14912,298,101,178,2021-08-03
317205,JAKARTA UTARA,PADEMANGAN,11696,75,11285,151,185,260,2021-08-03
317106,JAKARTA PUSAT,MENTENG,6225,32,6036,115,42,74,2021-08-03
317501,JAKARTA TIMUR,MATRAMAN,13662,74,13202,251,135,209,2021-08-03
317403,JAKARTA SELATAN,MAMPANG PRAPATAN,11041,58,10712,170,101,159,2021-08-03
317508,JAKARTA TIMUR,MAKASAR,16850,98,16334,272,146,244,2021-08-03
317504,JAKARTA TIMUR,KRAMAT JATI,20793,98,20136,372,187,285,2021-08-03
310101,KAB.ADM.KEP.SERIBU,KEP. SERIBU UTARA,591,0,574,6,11,11,2021-08-03
111111,Luar DKI & Proses Update,Luar DKI & Proses Update,143008,137,141294,1273,304,441,2021-08-04
317410,JAKARTA SELATAN,PESANGGRAHAN,15644,65,15083,232,264,329,2021-08-04
317404,JAKARTA SELATAN,PASAR MINGGU,22639,113,21842,385,299,412,2021-08-04
317504,JAKARTA TIMUR,KRAMAT JATI,20883,100,20163,372,248,348,2021-08-04
317508,JAKARTA TIMUR,MAKASAR,16919,98,16350,276,195,293,2021-08-04
317501,JAKARTA TIMUR,MATRAMAN,13736,75,13238,252,171,246,2021-08-04
317106,JAKARTA PUSAT,MENTENG,6243,31,6058,116,38,69,2021-08-04
317205,JAKARTA UTARA,PADEMANGAN,11741,62,11308,155,216,278,2021-08-04
317307,JAKARTA BARAT,PALMERAH,15412,72,14962,301,77,149,2021-08-04
317408,JAKARTA SELATAN,PANCORAN,13844,60,13426,212,146,206,2021-08-04
317505,JAKARTA TIMUR,PASAR REBO,16987,74,16287,307,319,393,2021-08-04
317203,JAKARTA UTARA,KOJA,16654,101,16103,321,129,230,2021-08-04
317201,JAKARTA UTARA,PENJARINGAN,17977,125,17504,215,133,258,2021-08-04
317102,JAKARTA PUSAT,SAWAH BESAR,8705,67,8428,154,56,123,2021-08-04
317104,JAKARTA PUSAT,SENEN,9094,58,8819,157,60,118,2021-08-04
317402,JAKARTA SELATAN,SETIA BUDI,11155,67,10783,175,130,197,2021-08-04
317303,JAKARTA BARAT,TAMAN SARI,8492,61,8273,124,34,95,2021-08-04
317304,JAKARTA BARAT,TAMBORA,13732,73,13364,225,70,143,2021-08-04
317107,JAKARTA PUSAT,TANAH ABANG,10717,48,10389,211,69,117,2021-08-04
317202,JAKARTA UTARA,TANJUNG PRIOK,24896,154,24107,395,240,394,2021-08-04
317401,JAKARTA SELATAN,TEBET,16358,73,15835,252,198,271,2021-08-04
317502,JAKARTA TIMUR,PULO GADUNG,21013,149,20318,364,182,331,2021-08-04
310101,KAB.ADM.KEP.SERIBU,KEP. SERIBU UTARA,598,2,575,6,15,17,2021-08-04
317403,JAKARTA SELATAN,MAMPANG PRAPATAN,11064,49,10733,172,110,159,2021-08-04
317308,JAKARTA BARAT,KEMBANGAN,19562,102,19026,266,168,270,2021-08-04
317506,JAKARTA TIMUR,CAKUNG,21865,132,21126,373,234,366,2021-08-04
317105,JAKARTA PUSAT,CEMPAKA PUTIH,10071,108,9756,153,54,162,2021-08-04
317301,JAKARTA BARAT,CENGKARENG,27610,132,26784,519,175,307,2021-08-04
317406,JAKARTA SELATAN,CILANDAK,16805,121,16115,239,330,451,2021-08-04
317204,JAKARTA UTARA,CILINCING,16594,111,15991,323,169,280,2021-08-04
317510,JAKARTA TIMUR,CIPAYUNG,24161,125,23444,245,347,472,2021-08-04
310102,KAB.ADM.KEP.SERIBU,KEP. SERIBU SELATAN,677,0,654,8,15,15,2021-08-04
317507,JAKARTA TIMUR,DUREN SAWIT,28206,183,27026,551,446,629,2021-08-04
317101,JAKARTA PUSAT,GAMBIR,8275,51,8044,119,61,112,2021-08-04
317302,JAKARTA BARAT,GROGOL PETAMBURAN,18628,116,18126,278,108,224,2021-08-04
317509,JAKARTA TIMUR,CIRACAS,21352,132,20545,336,339,471,2021-08-04
317103,JAKARTA PUSAT,KEMAYORAN,19046,121,18426,345,154,275,2021-08-04
317503,JAKARTA TIMUR,JATINEGARA,18817,65,18195,353,204,269,2021-08-04
317108,JAKARTA PUSAT,JOHAR BARU,8452,41,8203,151,57,98,2021-08-04
317306,JAKARTA BARAT,KALI DERES,17339,77,16844,284,134,211,2021-08-04
317407,JAKARTA SELATAN,KEBAYORAN BARU,13270,74,12903,169,124,198,2021-08-04
317405,JAKARTA SELATAN,KEBAYORAN LAMA,19333,119,18670,322,222,341,2021-08-04
317305,JAKARTA BARAT,KEBON JERUK,21435,132,20795,331,177,309,2021-08-04
317206,JAKARTA UTARA,KELAPA GADING,12173,56,11800,182,135,191,2021-08-04
317409,JAKARTA SELATAN,JAGAKARSA,25293,137,24379,376,401,538,2021-08-04
317505,JAKARTA TIMUR,PASAR REBO,17051,72,16355,308,316,388,2021-08-05
317404,JAKARTA SELATAN,PASAR MINGGU,22746,89,21938,389,330,419,2021-08-05
317408,JAKARTA SELATAN,PANCORAN,13896,56,13450,214,176,232,2021-08-05
317307,JAKARTA BARAT,PALMERAH,15438,69,14984,303,82,151,2021-08-05
317508,JAKARTA TIMUR,MAKASAR,16957,88,16396,278,195,283,2021-08-05
317501,JAKARTA TIMUR,MATRAMAN,13766,71,13302,255,138,209,2021-08-05
317403,JAKARTA SELATAN,MAMPANG PRAPATAN,11088,39,10767,174,108,147,2021-08-05
317201,JAKARTA UTARA,PENJARINGAN,18025,115,17552,216,142,257,2021-08-05
317205,JAKARTA UTARA,PADEMANGAN,11787,60,11335,157,235,295,2021-08-05
317502,JAKARTA TIMUR,PULO GADUNG,21063,142,20374,371,176,318,2021-08-05
317410,JAKARTA SELATAN,PESANGGRAHAN,15706,60,15130,235,281,341,2021-08-05
317104,JAKARTA PUSAT,SENEN,9122,49,8854,157,62,111,2021-08-05
317402,JAKARTA SELATAN,SETIA BUDI,11186,65,10834,176,111,176,2021-08-05
317303,JAKARTA BARAT,TAMAN SARI,8515,52,8293,125,45,97,2021-08-05
317304,JAKARTA BARAT,TAMBORA,13746,70,13374,228,74,144,2021-08-05
317107,JAKARTA PUSAT,TANAH ABANG,10732,43,10413,212,64,107,2021-08-05
317202,JAKARTA UTARA,TANJUNG PRIOK,24960,155,24175,402,228,383,2021-08-05
317401,JAKARTA SELATAN,TEBET,16381,60,15903,255,163,223,2021-08-05
111111,Luar DKI & Proses Update,Luar DKI & Proses Update,143008,137,141294,1273,304,441,2021-08-05
317504,JAKARTA TIMUR,KRAMAT JATI,20918,100,20221,377,220,320,2021-08-05
317102,JAKARTA PUSAT,SAWAH BESAR,8718,62,8445,156,55,117,2021-08-05
317203,JAKARTA UTARA,KOJA,16678,93,16144,322,119,212,2021-08-05
317106,JAKARTA PUSAT,MENTENG,6250,25,6071,116,38,63,2021-08-05
310102,KAB.ADM.KEP.SERIBU,KEP. SERIBU SELATAN,677,0,658,8,11,11,2021-08-05
310101,KAB.ADM.KEP.SERIBU,KEP. SERIBU UTARA,597,2,577,6,12,14,2021-08-05
317105,JAKARTA PUSAT,CEMPAKA PUTIH,10096,78,9788,159,71,149,2021-08-05
317301,JAKARTA BARAT,CENGKARENG,27679,119,26858,521,181,300,2021-08-05
317406,JAKARTA SELATAN,CILANDAK,16849,98,16240,240,271,369,2021-08-05
317204,JAKARTA UTARA,CILINCING,16632,102,16057,325,148,250,2021-08-05
317510,JAKARTA TIMUR,CIPAYUNG,24218,107,23544,248,319,426,2021-08-05
317509,JAKARTA TIMUR,CIRACAS,21446,115,20640,341,350,465,2021-08-05
317506,JAKARTA TIMUR,CAKUNG,21915,112,21210,379,214,326,2021-08-05
317101,JAKARTA PUSAT,GAMBIR,8288,47,8056,121,64,111,2021-08-05
317302,JAKARTA BARAT,GROGOL PETAMBURAN,18659,94,18172,281,112,206,2021-08-05
317507,JAKARTA TIMUR,DUREN SAWIT,28293,145,27105,558,485,630,2021-08-05
317103,JAKARTA PUSAT,KEMAYORAN,19104,114,18465,348,177,291,2021-08-05
317503,JAKARTA TIMUR,JATINEGARA,18840,65,18244,356,175,240,2021-08-05
317108,JAKARTA PUSAT,JOHAR BARU,8475,40,8210,151,74,114,2021-08-05
317306,JAKARTA BARAT,KALI DERES,17417,69,16926,284,138,207,2021-08-05
317407,JAKARTA SELATAN,KEBAYORAN BARU,13308,68,12927,171,142,210,2021-08-05
317405,JAKARTA SELATAN,KEBAYORAN LAMA,19384,95,18713,326,250,345,2021-08-05
317305,JAKARTA BARAT,KEBON JERUK,21463,106,20858,333,166,272,2021-08-05
317206,JAKARTA UTARA,KELAPA GADING,12189,57,11820,183,129,186,2021-08-05
317409,JAKARTA SELATAN,JAGAKARSA,25399,122,24475,379,423,545,2021-08-05
317308,JAKARTA BARAT,KEMBANGAN,19622,97,19077,268,180,277,2021-08-05
317408,JAKARTA SELATAN,PANCORAN,13916,47,13505,215,149,196,2021-08-06
317307,JAKARTA BARAT,PALMERAH,15448,65,15009,303,71,136,2021-08-06
317205,JAKARTA UTARA,PADEMANGAN,11815,43,11391,158,223,266,2021-08-06
317508,JAKARTA TIMUR,MAKASAR,16989,69,16470,280,170,239,2021-08-06
317501,JAKARTA TIMUR,MATRAMAN,13800,65,13328,256,151,216,2021-08-06
317403,JAKARTA SELATAN,MAMPANG PRAPATAN,11111,28,10808,175,100,128,2021-08-06
317504,JAKARTA TIMUR,KRAMAT JATI,20956,89,20285,378,204,293,2021-08-06
317106,JAKARTA PUSAT,MENTENG,6263,28,6081,116,38,66,2021-08-06
317404,JAKARTA SELATAN,PASAR MINGGU,22881,90,22087,390,314,404,2021-08-06
317107,JAKARTA PUSAT,TANAH ABANG,10749,45,10429,214,61,106,2021-08-06
317201,JAKARTA UTARA,PENJARINGAN,18044,98,17597,218,131,229,2021-08-06
317410,JAKARTA SELATAN,PESANGGRAHAN,15752,52,15187,235,278,330,2021-08-06
317502,JAKARTA TIMUR,PULO GADUNG,21100,110,20453,375,162,272,2021-08-06
317102,JAKARTA PUSAT,SAWAH BESAR,8735,40,8482,156,57,97,2021-08-06
317104,JAKARTA PUSAT,SENEN,9136,44,8876,160,56,100,2021-08-06
317402,JAKARTA SELATAN,SETIA BUDI,11223,69,10862,176,116,185,2021-08-06
317303,JAKARTA BARAT,TAMAN SARI,8534,45,8316,126,47,92,2021-08-06
317304,JAKARTA BARAT,TAMBORA,13775,53,13418,228,76,129,2021-08-06
317203,JAKARTA UTARA,KOJA,16707,75,16188,322,122,197,2021-08-06
317202,JAKARTA UTARA,TANJUNG PRIOK,24998,136,24277,403,182,318,2021-08-06
317401,JAKARTA SELATAN,TEBET,16413,60,15967,258,128,188,2021-08-06
317505,JAKARTA TIMUR,PASAR REBO,17101,67,16457,309,268,335,2021-08-06
310101,KAB.ADM.KEP.SERIBU,KEP. SERIBU UTARA,597,2,578,6,11,13,2021-08-06
317407,JAKARTA SELATAN,KEBAYORAN BARU,13338,59,12978,173,128,187,2021-08-06
317308,JAKARTA BARAT,KEMBANGAN,19653,86,19111,271,185,271,2021-08-06
317506,JAKARTA TIMUR,CAKUNG,21969,98,21285,381,205,303,2021-08-06
317105,JAKARTA PUSAT,CEMPAKA PUTIH,10134,79,9804,160,91,170,2021-08-06
317301,JAKARTA BARAT,CENGKARENG,27724,104,26936,523,161,265,2021-08-06
317406,JAKARTA SELATAN,CILANDAK,16918,90,16325,240,263,353,2021-08-06
310102,KAB.ADM.KEP.SERIBU,KEP. SERIBU SELATAN,678,0,658,8,12,12,2021-08-06
317510,JAKARTA TIMUR,CIPAYUNG,24291,93,23650,248,300,393,2021-08-06
317509,JAKARTA TIMUR,CIRACAS,21537,100,20768,342,327,427,2021-08-06
317507,JAKARTA TIMUR,DUREN SAWIT,28352,138,27253,561,400,538,2021-08-06
317101,JAKARTA PUSAT,GAMBIR,8300,40,8074,121,65,105,2021-08-06
317204,JAKARTA UTARA,CILINCING,16662,82,16112,326,142,224,2021-08-06
111111,Luar DKI & Proses Update,Luar DKI & Proses Update,143008,137,141294,1273,304,441,2021-08-06
317409,JAKARTA SELATAN,JAGAKARSA,25522,171,24633,380,338,509,2021-08-06
317503,JAKARTA TIMUR,JATINEGARA,18888,65,18306,357,160,225,2021-08-06
317108,JAKARTA PUSAT,JOHAR BARU,8491,37,8226,151,77,114,2021-08-06
317306,JAKARTA BARAT,KALI DERES,17458,54,16986,285,133,187,2021-08-06
317405,JAKARTA SELATAN,KEBAYORAN LAMA,19427,87,18790,329,221,308,2021-08-06
317305,JAKARTA BARAT,KEBON JERUK,21505,92,20908,335,170,262,2021-08-06
317206,JAKARTA UTARA,KELAPA GADING,12214,47,11871,183,113,160,2021-08-06
317103,JAKARTA PUSAT,KEMAYORAN,19153,104,18531,349,169,273,2021-08-06
317302,JAKARTA BARAT,GROGOL PETAMBURAN,18688,81,18221,283,103,184,2021-08-06
317306,JAKARTA BARAT,KALI DERES,17528,47,17058,289,134,181,2021-08-07
317407,JAKARTA SELATAN,KEBAYORAN BARU,13372,51,13033,174,114,165,2021-08-07
317405,JAKARTA SELATAN,KEBAYORAN LAMA,19462,69,18912,330,151,220,2021-08-07
317305,JAKARTA BARAT,KEBON JERUK,21540,75,21017,339,109,184,2021-08-07
317108,JAKARTA PUSAT,JOHAR BARU,8499,22,8268,153,56,78,2021-08-07
317103,JAKARTA PUSAT,KEMAYORAN,19185,64,18622,351,148,212,2021-08-07
317308,JAKARTA BARAT,KEMBANGAN,19693,83,19208,272,130,213,2021-08-07
310102,KAB.ADM.KEP.SERIBU,KEP. SERIBU SELATAN,683,0,667,8,8,8,2021-08-07
310101,KAB.ADM.KEP.SERIBU,KEP. SERIBU UTARA,604,2,585,6,11,13,2021-08-07
317206,JAKARTA UTARA,KELAPA GADING,12220,39,11920,184,77,116,2021-08-07
317503,JAKARTA TIMUR,JATINEGARA,18921,61,18375,359,126,187,2021-08-07
317403,JAKARTA SELATAN,MAMPANG PRAPATAN,11137,23,10853,175,86,109,2021-08-07
317302,JAKARTA BARAT,GROGOL PETAMBURAN,18709,73,18287,283,66,139,2021-08-07
317101,JAKARTA PUSAT,GAMBIR,8312,29,8126,121,36,65,2021-08-07
317507,JAKARTA TIMUR,DUREN SAWIT,28418,103,27414,566,335,438,2021-08-07
317509,JAKARTA TIMUR,CIRACAS,21589,93,20860,346,290,383,2021-08-07
317510,JAKARTA TIMUR,CIPAYUNG,24345,81,23759,249,256,337,2021-08-07
317406,JAKARTA SELATAN,CILANDAK,16980,77,16454,242,207,284,2021-08-07
317301,JAKARTA BARAT,CENGKARENG,27797,96,27027,525,149,245,2021-08-07
317105,JAKARTA PUSAT,CEMPAKA PUTIH,10152,33,9878,160,81,114,2021-08-07
317506,JAKARTA TIMUR,CAKUNG,22005,71,21398,382,154,225,2021-08-07
317203,JAKARTA UTARA,KOJA,16730,63,16253,325,89,152,2021-08-07
317409,JAKARTA SELATAN,JAGAKARSA,25600,147,24806,383,264,411,2021-08-07
317504,JAKARTA TIMUR,KRAMAT JATI,21000,65,20395,380,160,225,2021-08-07
317204,JAKARTA UTARA,CILINCING,16697,67,16184,328,118,185,2021-08-07
317303,JAKARTA BARAT,TAMAN SARI,8546,29,8353,126,38,67,2021-08-07
111111,Luar DKI & Proses Update,Luar DKI & Proses Update,143008,137,141294,1273,304,441,2021-08-07
317401,JAKARTA SELATAN,TEBET,16456,52,16027,262,115,167,2021-08-07
317202,JAKARTA UTARA,TANJUNG PRIOK,25028,96,24386,403,143,239,2021-08-07
317107,JAKARTA PUSAT,TANAH ABANG,10775,39,10463,214,59,98,2021-08-07
317304,JAKARTA BARAT,TAMBORA,13798,41,13474,228,55,96,2021-08-07
317402,JAKARTA SELATAN,SETIA BUDI,11246,56,10920,177,93,149,2021-08-07
317104,JAKARTA PUSAT,SENEN,9143,33,8905,160,45,78,2021-08-07
317502,JAKARTA TIMUR,PULO GADUNG,21150,97,20537,375,141,238,2021-08-07
317102,JAKARTA PUSAT,SAWAH BESAR,8757,32,8530,157,38,70,2021-08-07
317201,JAKARTA UTARA,PENJARINGAN,18074,85,17685,219,85,170,2021-08-07
317505,JAKARTA TIMUR,PASAR REBO,17144,58,16554,311,221,279,2021-08-07
317404,JAKARTA SELATAN,PASAR MINGGU,22987,67,22298,397,225,292,2021-08-07
317408,JAKARTA SELATAN,PANCORAN,13955,40,13577,215,123,163,2021-08-07
317307,JAKARTA BARAT,PALMERAH,15465,59,15053,305,48,107,2021-08-07
317205,JAKARTA UTARA,PADEMANGAN,11867,26,11492,158,191,217,2021-08-07
317106,JAKARTA PUSAT,MENTENG,6276,22,6098,117,39,61,2021-08-07
317501,JAKARTA TIMUR,MATRAMAN,13834,53,13408,258,115,168,2021-08-07
317410,JAKARTA SELATAN,PESANGGRAHAN,15781,41,15373,235,132,173,2021-08-07
317508,JAKARTA TIMUR,MAKASAR,17021,62,16541,282,136,198,2021-08-07
317307,JAKARTA BARAT,PALMERAH,15484,52,15069,305,58,110,2021-08-08
317404,JAKARTA SELATAN,PASAR MINGGU,23027,71,22330,398,228,299,2021-08-08
317408,JAKARTA SELATAN,PANCORAN,13970,37,13590,215,128,165,2021-08-08
317402,JAKARTA SELATAN,SETIA BUDI,11271,53,10943,177,98,151,2021-08-08
317106,JAKARTA PUSAT,MENTENG,6284,23,6106,117,38,61,2021-08-08
317501,JAKARTA TIMUR,MATRAMAN,13881,47,13423,258,153,200,2021-08-08
317403,JAKARTA SELATAN,MAMPANG PRAPATAN,11150,23,10866,175,86,109,2021-08-08
317505,JAKARTA TIMUR,PASAR REBO,17179,62,16566,312,239,301,2021-08-08
317205,JAKARTA UTARA,PADEMANGAN,11928,25,11596,158,149,174,2021-08-08
317201,JAKARTA UTARA,PENJARINGAN,18096,76,17710,219,91,167,2021-08-08
317107,JAKARTA PUSAT,TANAH ABANG,10787,39,10474,214,60,99,2021-08-08
317502,JAKARTA TIMUR,PULO GADUNG,21179,87,20558,375,159,246,2021-08-08
317102,JAKARTA PUSAT,SAWAH BESAR,8761,26,8542,157,36,62,2021-08-08
317104,JAKARTA PUSAT,SENEN,9149,32,8910,160,47,79,2021-08-08
111111,Luar DKI & Proses Update,Luar DKI & Proses Update,143008,137,141294,1273,304,441,2021-08-08
317401,JAKARTA SELATAN,TEBET,16502,55,16036,262,149,204,2021-08-08
317202,JAKARTA UTARA,TANJUNG PRIOK,25065,88,24419,403,155,243,2021-08-08
317508,JAKARTA TIMUR,MAKASAR,17049,60,16560,282,147,207,2021-08-08
317304,JAKARTA BARAT,TAMBORA,13810,39,13485,228,58,97,2021-08-08
317410,JAKARTA SELATAN,PESANGGRAHAN,15822,43,15382,235,162,205,2021-08-08
317504,JAKARTA TIMUR,KRAMAT JATI,21034,57,20414,381,182,239,2021-08-08
317303,JAKARTA BARAT,TAMAN SARI,8555,27,8361,126,41,68,2021-08-08
310101,KAB.ADM.KEP.SERIBU,KEP. SERIBU UTARA,608,2,585,6,15,17,2021-08-08
317204,JAKARTA UTARA,CILINCING,16741,59,16206,328,148,207,2021-08-08
317203,JAKARTA UTARA,KOJA,16760,56,16275,325,104,160,2021-08-08
317301,JAKARTA BARAT,CENGKARENG,27845,103,27042,527,173,276,2021-08-08
317105,JAKARTA PUSAT,CEMPAKA PUTIH,10168,29,9888,160,91,120,2021-08-08
317506,JAKARTA TIMUR,CAKUNG,22038,62,21415,383,178,240,2021-08-08
317510,JAKARTA TIMUR,CIPAYUNG,24407,72,23783,249,303,375,2021-08-08
317509,JAKARTA TIMUR,CIRACAS,21665,89,20878,347,351,440,2021-08-08
317507,JAKARTA TIMUR,DUREN SAWIT,28475,92,27463,566,354,446,2021-08-08
317101,JAKARTA PUSAT,GAMBIR,8319,29,8132,121,37,66,2021-08-08
317302,JAKARTA BARAT,GROGOL PETAMBURAN,18737,68,18319,283,67,135,2021-08-08
317406,JAKARTA SELATAN,CILANDAK,17030,68,16473,242,247,315,2021-08-08
317503,JAKARTA TIMUR,JATINEGARA,18972,60,18398,359,155,215,2021-08-08
317108,JAKARTA PUSAT,JOHAR BARU,8501,17,8273,153,58,75,2021-08-08
317306,JAKARTA BARAT,KALI DERES,17547,50,17070,289,138,188,2021-08-08
317407,JAKARTA SELATAN,KEBAYORAN BARU,13393,47,13047,175,124,171,2021-08-08
317405,JAKARTA SELATAN,KEBAYORAN LAMA,19507,65,18936,332,174,239,2021-08-08
317305,JAKARTA BARAT,KEBON JERUK,21573,68,21040,339,126,194,2021-08-08
317206,JAKARTA UTARA,KELAPA GADING,12250,40,11953,184,73,113,2021-08-08
317103,JAKARTA PUSAT,KEMAYORAN,19208,62,18635,351,160,222,2021-08-08
317308,JAKARTA BARAT,KEMBANGAN,19717,79,19228,272,138,217,2021-08-08
317409,JAKARTA SELATAN,JAGAKARSA,25679,148,24846,384,301,449,2021-08-08
310102,KAB.ADM.KEP.SERIBU,KEP. SERIBU SELATAN,685,0,666,9,10,10,2021-08-08
317408,JAKARTA SELATAN,PANCORAN,13980,35,13625,215,105,140,2021-08-09
317307,JAKARTA BARAT,PALMERAH,15490,46,15092,305,47,93,2021-08-09
317508,JAKARTA TIMUR,MAKASAR,17059,58,16569,282,150,208,2021-08-09
317106,JAKARTA PUSAT,MENTENG,6288,24,6112,117,35,59,2021-08-09
317501,JAKARTA TIMUR,MATRAMAN,13887,43,13435,258,151,194,2021-08-09
317403,JAKARTA SELATAN,MAMPANG PRAPATAN,11166,23,10879,175,89,112,2021-08-09
317504,JAKARTA TIMUR,KRAMAT JATI,21043,54,20425,381,183,237,2021-08-09
317205,JAKARTA UTARA,PADEMANGAN,11955,26,11601,158,170,196,2021-08-09
317404,JAKARTA SELATAN,PASAR MINGGU,23062,74,22345,398,245,319,2021-08-09
317502,JAKARTA TIMUR,PULO GADUNG,21192,79,20571,375,167,246,2021-08-09
317201,JAKARTA UTARA,PENJARINGAN,18109,67,17730,219,93,160,2021-08-09
317410,JAKARTA SELATAN,PESANGGRAHAN,15834,47,15391,236,160,207,2021-08-09
317102,JAKARTA PUSAT,SAWAH BESAR,8769,26,8554,157,32,58,2021-08-09
317104,JAKARTA PUSAT,SENEN,9155,31,8924,160,40,71,2021-08-09
317402,JAKARTA SELATAN,SETIA BUDI,11277,51,10948,177,101,152,2021-08-09
317303,JAKARTA BARAT,TAMAN SARI,8566,31,8368,126,41,72,2021-08-09
317401,JAKARTA SELATAN,TEBET,16511,48,16045,263,155,203,2021-08-09
317203,JAKARTA UTARA,KOJA,16771,54,16282,325,110,164,2021-08-09
317202,JAKARTA UTARA,TANJUNG PRIOK,25080,83,24435,403,159,242,2021-08-09
317505,JAKARTA TIMUR,PASAR REBO,17190,54,16580,313,243,297,2021-08-09
310101,KAB.ADM.KEP.SERIBU,KEP. SERIBU UTARA,608,0,587,6,15,15,2021-08-09
317503,JAKARTA TIMUR,JATINEGARA,18982,51,18413,359,159,210,2021-08-09
317308,JAKARTA BARAT,KEMBANGAN,19732,79,19263,272,118,197,2021-08-09
111111,Luar DKI & Proses Update,Luar DKI & Proses Update,143008,137,141294,1273,304,441,2021-08-09
317506,JAKARTA TIMUR,CAKUNG,22054,65,21421,384,184,249,2021-08-09
317105,JAKARTA PUSAT,CEMPAKA PUTIH,10177,29,9907,160,81,110,2021-08-09
317301,JAKARTA BARAT,CENGKARENG,27860,103,27093,527,137,240,2021-08-09
317406,JAKARTA SELATAN,CILANDAK,17045,70,16536,242,197,267,2021-08-09
317204,JAKARTA UTARA,CILINCING,16748,56,16212,329,151,207,2021-08-09
317510,JAKARTA TIMUR,CIPAYUNG,24418,72,23793,250,303,375,2021-08-09
317509,JAKARTA TIMUR,CIRACAS,21680,77,20896,347,360,437,2021-08-09
317507,JAKARTA TIMUR,DUREN SAWIT,28496,85,27500,567,344,429,2021-08-09
310102,KAB.ADM.KEP.SERIBU,KEP. SERIBU SELATAN,687,1,667,8,11,12,2021-08-09
317101,JAKARTA PUSAT,GAMBIR,8325,28,8147,121,29,57,2021-08-09
317409,JAKARTA SELATAN,JAGAKARSA,25700,140,24902,384,274,414,2021-08-09
317107,JAKARTA PUSAT,TANAH ABANG,10791,37,10489,214,51,88,2021-08-09
317108,JAKARTA PUSAT,JOHAR BARU,8504,14,8296,153,41,55,2021-08-09
317306,JAKARTA BARAT,KALI DERES,17556,48,17114,289,105,153,2021-08-09
317407,JAKARTA SELATAN,KEBAYORAN BARU,13407,50,13081,175,101,151,2021-08-09
317405,JAKARTA SELATAN,KEBAYORAN LAMA,19514,62,18965,333,154,216,2021-08-09
317305,JAKARTA BARAT,KEBON JERUK,21588,70,21061,341,116,186,2021-08-09
317206,JAKARTA UTARA,KELAPA GADING,12254,36,11959,184,75,111,2021-08-09
317103,JAKARTA PUSAT,KEMAYORAN,19224,54,18684,353,133,187,2021-08-09
317302,JAKARTA BARAT,GROGOL PETAMBURAN,18750,58,18341,283,68,126,2021-08-09
317304,JAKARTA BARAT,TAMBORA,13818,41,13499,228,50,91,2021-08-09
317507,JAKARTA TIMUR,DUREN SAWIT,28526,79,27589,569,289,368,2021-08-10
317105,JAKARTA PUSAT,CEMPAKA PUTIH,10211,30,9934,160,87,117,2021-08-10
317501,JAKARTA TIMUR,MATRAMAN,13902,39,13485,259,119,158,2021-08-10
317106,JAKARTA PUSAT,MENTENG,6295,24,6117,117,37,61,2021-08-10
317307,JAKARTA BARAT,PALMERAH,15500,42,15105,305,48,90,2021-08-10
317408,JAKARTA SELATAN,PANCORAN,13991,34,13628,216,113,147,2021-08-10
317404,JAKARTA SELATAN,PASAR MINGGU,23099,78,22389,403,229,307,2021-08-10
317505,JAKARTA TIMUR,PASAR REBO,17206,57,16664,313,172,229,2021-08-10
317201,JAKARTA UTARA,PENJARINGAN,18126,65,17739,220,102,167,2021-08-10
317410,JAKARTA SELATAN,PESANGGRAHAN,15850,49,15409,237,155,204,2021-08-10
317403,JAKARTA SELATAN,MAMPANG PRAPATAN,11179,27,10880,175,97,124,2021-08-10
317502,JAKARTA TIMUR,PULO GADUNG,21231,87,20591,375,178,265,2021-08-10
317104,JAKARTA PUSAT,SENEN,9186,33,8928,161,64,97,2021-08-10
317402,JAKARTA SELATAN,SETIA BUDI,11308,68,10967,177,96,164,2021-08-10
317303,JAKARTA BARAT,TAMAN SARI,8582,34,8377,126,45,79,2021-08-10
317304,JAKARTA BARAT,TAMBORA,13836,39,13510,230,57,96,2021-08-10
317107,JAKARTA PUSAT,TANAH ABANG,10802,37,10495,214,56,93,2021-08-10
317202,JAKARTA UTARA,TANJUNG PRIOK,25106,75,24459,404,168,243,2021-08-10
317401,JAKARTA SELATAN,TEBET,16527,55,16091,264,117,172,2021-08-10
111111,Luar DKI & Proses Update,Luar DKI & Proses Update,143008,137,141294,1273,304,441,2021-08-10
317102,JAKARTA PUSAT,SAWAH BESAR,8803,32,8558,158,55,87,2021-08-10
317506,JAKARTA TIMUR,CAKUNG,22074,57,21484,386,147,204,2021-08-10
317508,JAKARTA TIMUR,MAKASAR,17081,66,16623,283,109,175,2021-08-10
317203,JAKARTA UTARA,KOJA,16785,52,16293,326,114,166,2021-08-10
317301,JAKARTA BARAT,CENGKARENG,27930,105,27143,529,153,258,2021-08-10
317406,JAKARTA SELATAN,CILANDAK,17072,75,16542,243,212,287,2021-08-10
317204,JAKARTA UTARA,CILINCING,16762,52,16224,329,157,209,2021-08-10
317510,JAKARTA TIMUR,CIPAYUNG,24433,72,23901,251,209,281,2021-08-10
317509,JAKARTA TIMUR,CIRACAS,21709,81,20985,349,294,375,2021-08-10
317101,JAKARTA PUSAT,GAMBIR,8333,31,8149,122,31,62,2021-08-10
317302,JAKARTA BARAT,GROGOL PETAMBURAN,18770,61,18351,285,73,134,2021-08-10
317409,JAKARTA SELATAN,JAGAKARSA,25733,146,24914,385,288,434,2021-08-10
317504,JAKARTA TIMUR,KRAMAT JATI,21064,50,20492,381,141,191,2021-08-10
317503,JAKARTA TIMUR,JATINEGARA,19017,63,18462,360,132,195,2021-08-10
317306,JAKARTA BARAT,KALI DERES,17593,56,17134,291,112,168,2021-08-10
317407,JAKARTA SELATAN,KEBAYORAN BARU,13411,52,13074,175,110,162,2021-08-10
317405,JAKARTA SELATAN,KEBAYORAN LAMA,19546,70,18981,334,161,231,2021-08-10
317305,JAKARTA BARAT,KEBON JERUK,21630,76,21074,342,138,214,2021-08-10
317206,JAKARTA UTARA,KELAPA GADING,12263,36,11965,184,78,114,2021-08-10
317103,JAKARTA PUSAT,KEMAYORAN,19266,51,18713,353,149,200,2021-08-10
317308,JAKARTA BARAT,KEMBANGAN,19773,74,19281,275,143,217,2021-08-10
310102,KAB.ADM.KEP.SERIBU,KEP. SERIBU SELATAN,687,1,667,8,11,12,2021-08-10
310101,KAB.ADM.KEP.SERIBU,KEP. SERIBU UTARA,610,0,588,6,16,16,2021-08-10
317108,JAKARTA PUSAT,JOHAR BARU,8516,14,8300,154,48,62,2021-08-10
317205,JAKARTA UTARA,PADEMANGAN,11991,26,11607,158,200,226,2021-08-10
111111,Luar DKI & Proses Update,Luar DKI & Proses Update,143008,137,141294,1273,304,441,2021-08-11
317402,JAKARTA SELATAN,SETIA BUDI,11332,69,10982,177,104,173,2021-08-11
317107,JAKARTA PUSAT,TANAH ABANG,10818,37,10508,214,59,96,2021-08-11
317308,JAKARTA BARAT,KEMBANGAN,19804,79,19295,278,152,231,2021-08-11
310102,KAB.ADM.KEP.SERIBU,KEP. SERIBU SELATAN,689,1,669,8,11,12,2021-08-11
310101,KAB.ADM.KEP.SERIBU,KEP. SERIBU UTARA,614,0,593,6,15,15,2021-08-11
317203,JAKARTA UTARA,KOJA,16809,55,16337,326,91,146,2021-08-11
317504,JAKARTA TIMUR,KRAMAT JATI,21114,55,20520,382,157,212,2021-08-11
317508,JAKARTA TIMUR,MAKASAR,17126,76,16635,283,132,208,2021-08-11
317403,JAKARTA SELATAN,MAMPANG PRAPATAN,11202,25,10891,175,111,136,2021-08-11
317106,JAKARTA PUSAT,MENTENG,6303,26,6121,117,39,65,2021-08-11
317205,JAKARTA UTARA,PADEMANGAN,12024,31,11627,158,208,239,2021-08-11
317307,JAKARTA BARAT,PALMERAH,15523,50,15113,307,53,103,2021-08-11
317408,JAKARTA SELATAN,PANCORAN,14011,34,13640,216,121,155,2021-08-11
317404,JAKARTA SELATAN,PASAR MINGGU,23135,83,22406,405,241,324,2021-08-11
317505,JAKARTA TIMUR,PASAR REBO,17254,58,16680,314,202,260,2021-08-11
317201,JAKARTA UTARA,PENJARINGAN,18156,62,17779,220,95,157,2021-08-11
317410,JAKARTA SELATAN,PESANGGRAHAN,15892,52,15418,241,181,233,2021-08-11
317502,JAKARTA TIMUR,PULO GADUNG,21277,95,20663,376,143,238,2021-08-11
317102,JAKARTA PUSAT,SAWAH BESAR,8824,32,8575,158,59,91,2021-08-11
317104,JAKARTA PUSAT,SENEN,9201,32,8947,161,61,93,2021-08-11
317303,JAKARTA BARAT,TAMAN SARI,8591,31,8391,127,42,73,2021-08-11
317103,JAKARTA PUSAT,KEMAYORAN,19305,50,18748,354,153,203,2021-08-11
317206,JAKARTA UTARA,KELAPA GADING,12293,43,11999,186,65,108,2021-08-11
317501,JAKARTA TIMUR,MATRAMAN,13947,39,13505,260,143,182,2021-08-11
317405,JAKARTA SELATAN,KEBAYORAN LAMA,19586,67,18999,335,185,252,2021-08-11
317305,JAKARTA BARAT,KEBON JERUK,21666,81,21090,345,150,231,2021-08-11
317304,JAKARTA BARAT,TAMBORA,13858,37,13532,230,59,96,2021-08-11
317202,JAKARTA UTARA,TANJUNG PRIOK,25153,81,24517,407,148,229,2021-08-11
317506,JAKARTA TIMUR,CAKUNG,22111,65,21497,386,163,228,2021-08-11
317105,JAKARTA PUSAT,CEMPAKA PUTIH,10230,30,9941,160,99,129,2021-08-11
317301,JAKARTA BARAT,CENGKARENG,27982,108,27189,531,154,262,2021-08-11
317406,JAKARTA SELATAN,CILANDAK,17127,86,16551,243,247,333,2021-08-11
317204,JAKARTA UTARA,CILINCING,16805,53,16274,330,148,201,2021-08-11
317510,JAKARTA TIMUR,CIPAYUNG,24509,71,23915,252,271,342,2021-08-11
317401,JAKARTA SELATAN,TEBET,16565,46,16114,264,141,187,2021-08-11
317507,JAKARTA TIMUR,DUREN SAWIT,28599,92,27611,571,325,417,2021-08-11
317509,JAKARTA TIMUR,CIRACAS,21790,79,21003,351,357,436,2021-08-11
317407,JAKARTA SELATAN,KEBAYORAN BARU,13447,48,13094,176,129,177,2021-08-11
317108,JAKARTA PUSAT,JOHAR BARU,8527,13,8308,154,52,65,2021-08-11
317503,JAKARTA TIMUR,JATINEGARA,19078,62,18502,361,153,215,2021-08-11
317306,JAKARTA BARAT,KALI DERES,17636,62,17164,292,118,180,2021-08-11
317302,JAKARTA BARAT,GROGOL PETAMBURAN,18792,66,18364,286,76,142,2021-08-11
317101,JAKARTA PUSAT,GAMBIR,8346,28,8157,123,38,66,2021-08-11
317409,JAKARTA SELATAN,JAGAKARSA,25820,170,24964,385,301,471,2021-08-11
317501,JAKARTA TIMUR,MATRAMAN,13956,41,13528,261,126,167,2021-08-12
317505,JAKARTA TIMUR,PASAR REBO,17263,46,16747,315,155,201,2021-08-12
317106,JAKARTA PUSAT,MENTENG,6305,23,6136,117,29,52,2021-08-12
317205,JAKARTA UTARA,PADEMANGAN,12026,27,11649,159,191,218,2021-08-12
317307,JAKARTA BARAT,PALMERAH,15538,48,15139,307,44,92,2021-08-12
317408,JAKARTA SELATAN,PANCORAN,14028,28,13676,217,107,135,2021-08-12
317403,JAKARTA SELATAN,MAMPANG PRAPATAN,11214,23,10912,175,104,127,2021-08-12
317404,JAKARTA SELATAN,PASAR MINGGU,23170,76,22486,406,202,278,2021-08-12
317201,JAKARTA UTARA,PENJARINGAN,18177,61,17814,223,79,140,2021-08-12
317402,JAKARTA SELATAN,SETIA BUDI,11350,67,11013,177,93,160,2021-08-12
317502,JAKARTA TIMUR,PULO GADUNG,21297,86,20706,380,125,211,2021-08-12
317102,JAKARTA PUSAT,SAWAH BESAR,8840,29,8591,161,59,88,2021-08-12
317104,JAKARTA PUSAT,SENEN,9205,25,8972,161,47,72,2021-08-12
317303,JAKARTA BARAT,TAMAN SARI,8605,33,8417,129,26,59,2021-08-12
317304,JAKARTA BARAT,TAMBORA,13885,39,13551,231,64,103,2021-08-12
317107,JAKARTA PUSAT,TANAH ABANG,10822,36,10519,214,53,89,2021-08-12
317202,JAKARTA UTARA,TANJUNG PRIOK,25167,62,24575,410,120,182,2021-08-12
317401,JAKARTA SELATAN,TEBET,16594,41,16141,265,147,188,2021-08-12
317508,JAKARTA TIMUR,MAKASAR,17138,60,16685,283,110,170,2021-08-12
317410,JAKARTA SELATAN,PESANGGRAHAN,15926,58,15476,241,151,209,2021-08-12
317504,JAKARTA TIMUR,KRAMAT JATI,21130,53,20557,382,138,191,2021-08-12
317108,JAKARTA PUSAT,JOHAR BARU,8531,13,8327,155,36,49,2021-08-12
310101,KAB.ADM.KEP.SERIBU,KEP. SERIBU UTARA,618,0,593,6,19,19,2021-08-12
317105,JAKARTA PUSAT,CEMPAKA PUTIH,10243,31,9965,160,87,118,2021-08-12
317203,JAKARTA UTARA,KOJA,16821,54,16361,326,80,134,2021-08-12
111111,Luar DKI & Proses Update,Luar DKI & Proses Update,143008,137,141294,1273,304,441,2021-08-12
317301,JAKARTA BARAT,CENGKARENG,28006,91,27250,532,133,224,2021-08-12
317406,JAKARTA SELATAN,CILANDAK,17165,72,16614,245,234,306,2021-08-12
317204,JAKARTA UTARA,CILINCING,16816,49,16303,330,134,183,2021-08-12
317510,JAKARTA TIMUR,CIPAYUNG,24517,59,23974,252,232,291,2021-08-12
317507,JAKARTA TIMUR,DUREN SAWIT,28649,88,27705,573,283,371,2021-08-12
317101,JAKARTA PUSAT,GAMBIR,8353,26,8169,125,33,59,2021-08-12
317302,JAKARTA BARAT,GROGOL PETAMBURAN,18812,62,18389,288,73,135,2021-08-12
317509,JAKARTA TIMUR,CIRACAS,21807,70,21103,351,283,353,2021-08-12
317503,JAKARTA TIMUR,JATINEGARA,19097,53,18534,363,147,200,2021-08-12
310102,KAB.ADM.KEP.SERIBU,KEP. SERIBU SELATAN,689,1,669,8,11,12,2021-08-12
317409,JAKARTA SELATAN,JAGAKARSA,25887,127,25067,385,308,435,2021-08-12
317103,JAKARTA PUSAT,KEMAYORAN,19342,56,18801,357,128,184,2021-08-12
317206,JAKARTA UTARA,KELAPA GADING,12308,42,12014,186,66,108,2021-08-12
317305,JAKARTA BARAT,KEBON JERUK,21674,67,21131,345,131,198,2021-08-12
317308,JAKARTA BARAT,KEMBANGAN,19817,73,19354,280,110,183,2021-08-12
317407,JAKARTA SELATAN,KEBAYORAN BARU,13459,43,13135,176,105,148,2021-08-12
317306,JAKARTA BARAT,KALI DERES,17649,50,17213,292,94,144,2021-08-12
317506,JAKARTA TIMUR,CAKUNG,22127,59,21548,386,134,193,2021-08-12
317405,JAKARTA SELATAN,KEBAYORAN LAMA,19616,67,19053,337,159,226,2021-08-12
317503,JAKARTA TIMUR,JATINEGARA,19106,52,18564,370,120,172,2021-08-13
317103,JAKARTA PUSAT,KEMAYORAN,19363,62,18845,358,98,160,2021-08-13
317206,JAKARTA UTARA,KELAPA GADING,12318,38,12038,186,56,94,2021-08-13
317305,JAKARTA BARAT,KEBON JERUK,21691,65,21157,345,124,189,2021-08-13
317405,JAKARTA SELATAN,KEBAYORAN LAMA,19637,72,19088,340,137,209,2021-08-13
317407,JAKARTA SELATAN,KEBAYORAN BARU,13461,36,13158,177,90,126,2021-08-13
317306,JAKARTA BARAT,KALI DERES,17675,53,17221,296,105,158,2021-08-13
317108,JAKARTA PUSAT,JOHAR BARU,8541,10,8337,155,39,49,2021-08-13
317409,JAKARTA SELATAN,JAGAKARSA,25904,92,25140,385,287,379,2021-08-13
317506,JAKARTA TIMUR,CAKUNG,22162,58,21598,388,118,176,2021-08-13
317101,JAKARTA PUSAT,GAMBIR,8363,25,8177,125,36,61,2021-08-13
317507,JAKARTA TIMUR,DUREN SAWIT,28690,75,27798,577,240,315,2021-08-13
317509,JAKARTA TIMUR,CIRACAS,21852,69,21190,352,241,310,2021-08-13
317510,JAKARTA TIMUR,CIPAYUNG,24563,44,24023,252,244,288,2021-08-13
317204,JAKARTA UTARA,CILINCING,16833,45,16340,330,118,163,2021-08-13
317406,JAKARTA SELATAN,CILANDAK,17188,70,16671,245,202,272,2021-08-13
317301,JAKARTA BARAT,CENGKARENG,28030,77,27293,537,123,200,2021-08-13
317105,JAKARTA PUSAT,CEMPAKA PUTIH,10253,25,9998,160,70,95,2021-08-13
310102,KAB.ADM.KEP.SERIBU,KEP. SERIBU SELATAN,694,1,670,9,14,15,2021-08-13
317302,JAKARTA BARAT,GROGOL PETAMBURAN,18820,57,18412,289,62,119,2021-08-13
310101,KAB.ADM.KEP.SERIBU,KEP. SERIBU UTARA,618,0,594,6,18,18,2021-08-13
317308,JAKARTA BARAT,KEMBANGAN,19842,68,19370,281,123,191,2021-08-13
317504,JAKARTA TIMUR,KRAMAT JATI,21161,52,20580,382,147,199,2021-08-13
111111,Luar DKI & Proses Update,Luar DKI & Proses Update,143008,137,141294,1273,304,441,2021-08-13
317203,JAKARTA UTARA,KOJA,16826,47,16389,330,60,107,2021-08-13
317401,JAKARTA SELATAN,TEBET,16610,41,16163,267,139,180,2021-08-13
317107,JAKARTA PUSAT,TANAH ABANG,10832,32,10534,215,51,83,2021-08-13
317304,JAKARTA BARAT,TAMBORA,13892,43,13570,231,48,91,2021-08-13
317303,JAKARTA BARAT,TAMAN SARI,8611,26,8429,131,25,51,2021-08-13
317402,JAKARTA SELATAN,SETIA BUDI,11366,66,11041,178,81,147,2021-08-13
317104,JAKARTA PUSAT,SENEN,9216,26,8979,162,49,75,2021-08-13
317102,JAKARTA PUSAT,SAWAH BESAR,8855,32,8605,162,56,88,2021-08-13
317502,JAKARTA TIMUR,PULO GADUNG,21325,79,20733,383,130,209,2021-08-13
317202,JAKARTA UTARA,TANJUNG PRIOK,25184,51,24597,412,124,175,2021-08-13
317201,JAKARTA UTARA,PENJARINGAN,18198,59,17826,224,89,148,2021-08-13
317403,JAKARTA SELATAN,MAMPANG PRAPATAN,11228,22,10932,176,98,120,2021-08-13
317410,JAKARTA SELATAN,PESANGGRAHAN,15942,57,15508,243,134,191,2021-08-13
317501,JAKARTA TIMUR,MATRAMAN,13987,42,13556,264,125,167,2021-08-13
317106,JAKARTA PUSAT,MENTENG,6317,24,6149,118,26,50,2021-08-13
317508,JAKARTA TIMUR,MAKASAR,17167,65,16707,285,110,175,2021-08-13
317307,JAKARTA BARAT,PALMERAH,15553,48,15151,309,45,93,2021-08-13
317408,JAKARTA SELATAN,PANCORAN,14042,22,13697,220,103,125,2021-08-13
317404,JAKARTA SELATAN,PASAR MINGGU,23184,69,22535,408,172,241,2021-08-13
317505,JAKARTA TIMUR,PASAR REBO,17299,46,16784,315,154,200,2021-08-13
317205,JAKARTA UTARA,PADEMANGAN,12056,23,11666,159,208,231,2021-08-13
317501,JAKARTA TIMUR,MATRAMAN,13994,41,13564,264,125,166,2021-08-14
317505,JAKARTA TIMUR,PASAR REBO,17323,51,16797,315,160,211,2021-08-14
317106,JAKARTA PUSAT,MENTENG,6331,23,6161,118,29,52,2021-08-14
317205,JAKARTA UTARA,PADEMANGAN,12072,24,11682,159,207,231,2021-08-14
317307,JAKARTA BARAT,PALMERAH,15565,49,15162,310,44,93,2021-08-14
317408,JAKARTA SELATAN,PANCORAN,14066,22,13730,220,94,116,2021-08-14
317404,JAKARTA SELATAN,PASAR MINGGU,23221,74,22578,409,160,234,2021-08-14
317201,JAKARTA UTARA,PENJARINGAN,18213,56,17840,225,92,148,2021-08-14
317402,JAKARTA SELATAN,SETIA BUDI,11378,70,11063,178,67,137,2021-08-14
317502,JAKARTA TIMUR,PULO GADUNG,21362,77,20755,385,145,222,2021-08-14
317102,JAKARTA PUSAT,SAWAH BESAR,8862,34,8608,163,57,91,2021-08-14
317104,JAKARTA PUSAT,SENEN,9228,28,8987,162,51,79,2021-08-14
317403,JAKARTA SELATAN,MAMPANG PRAPATAN,11238,24,10954,176,84,108,2021-08-14
317303,JAKARTA BARAT,TAMAN SARI,8618,28,8431,132,27,55,2021-08-14
317304,JAKARTA BARAT,TAMBORA,13907,38,13583,232,54,92,2021-08-14
317107,JAKARTA PUSAT,TANAH ABANG,10841,33,10550,215,43,76,2021-08-14
317202,JAKARTA UTARA,TANJUNG PRIOK,25212,59,24612,412,129,188,2021-08-14
317401,JAKARTA SELATAN,TEBET,16630,42,16193,269,126,168,2021-08-14
111111,Luar DKI & Proses Update,Luar DKI & Proses Update,143008,137,141294,1273,304,441,2021-08-14
317410,JAKARTA SELATAN,PESANGGRAHAN,15972,60,15537,243,132,192,2021-08-14
317508,JAKARTA TIMUR,MAKASAR,17190,62,16725,285,118,180,2021-08-14
310102,KAB.ADM.KEP.SERIBU,KEP. SERIBU SELATAN,695,1,670,9,15,16,2021-08-14
317203,JAKARTA UTARA,KOJA,16845,50,16391,330,74,124,2021-08-14
317506,JAKARTA TIMUR,CAKUNG,22184,55,21619,389,121,176,2021-08-14
317105,JAKARTA PUSAT,CEMPAKA PUTIH,10282,21,10019,160,82,103,2021-08-14
317301,JAKARTA BARAT,CENGKARENG,28044,74,27326,539,105,179,2021-08-14
317406,JAKARTA SELATAN,CILANDAK,17233,66,16725,245,197,263,2021-08-14
317204,JAKARTA UTARA,CILINCING,16848,49,16345,330,124,173,2021-08-14
317510,JAKARTA TIMUR,CIPAYUNG,24609,49,24053,253,254,303,2021-08-14
317509,JAKARTA TIMUR,CIRACAS,21901,70,21202,352,277,347,2021-08-14
317507,JAKARTA TIMUR,DUREN SAWIT,28751,87,27839,578,247,334,2021-08-14
317101,JAKARTA PUSAT,GAMBIR,8374,24,8187,126,37,61,2021-08-14
317504,JAKARTA TIMUR,KRAMAT JATI,21210,54,20599,383,174,228,2021-08-14
317302,JAKARTA BARAT,GROGOL PETAMBURAN,18835,59,18422,291,63,122,2021-08-14
317503,JAKARTA TIMUR,JATINEGARA,19144,59,18574,371,140,199,2021-08-14
317108,JAKARTA PUSAT,JOHAR BARU,8550,13,8346,155,36,49,2021-08-14
317306,JAKARTA BARAT,KALI DERES,17694,54,17239,297,104,158,2021-08-14
317405,JAKARTA SELATAN,KEBAYORAN LAMA,19661,69,19121,340,131,200,2021-08-14
317305,JAKARTA BARAT,KEBON JERUK,21711,73,21187,346,105,178,2021-08-14
317206,JAKARTA UTARA,KELAPA GADING,12334,41,12041,186,66,107,2021-08-14
317103,JAKARTA PUSAT,KEMAYORAN,19382,62,18861,361,98,160,2021-08-14
317308,JAKARTA BARAT,KEMBANGAN,19853,63,19396,283,111,174,2021-08-14
310101,KAB.ADM.KEP.SERIBU,KEP. SERIBU UTARA,620,0,601,6,13,13,2021-08-14
317409,JAKARTA SELATAN,JAGAKARSA,25966,139,25205,385,237,376,2021-08-14
317407,JAKARTA SELATAN,KEBAYORAN BARU,13492,39,13182,178,93,132,2021-08-14
111111,Luar DKI & Proses Update,Luar DKI & Proses Update,143008,137,141294,1273,304,441,2021-08-15
317401,JAKARTA SELATAN,TEBET,16644,39,16205,269,131,170,2021-08-15
317506,JAKARTA TIMUR,CAKUNG,22212,58,21639,389,126,184,2021-08-15
317403,JAKARTA SELATAN,MAMPANG PRAPATAN,11257,31,10965,176,85,116,2021-08-15
317501,JAKARTA TIMUR,MATRAMAN,14012,39,13596,265,112,151,2021-08-15
317106,JAKARTA PUSAT,MENTENG,6334,23,6167,118,26,49,2021-08-15
317205,JAKARTA UTARA,PADEMANGAN,12176,27,11726,159,264,291,2021-08-15
317307,JAKARTA BARAT,PALMERAH,15586,48,15185,310,43,91,2021-08-15
317408,JAKARTA SELATAN,PANCORAN,14080,22,13743,221,94,116,2021-08-15
317404,JAKARTA SELATAN,PASAR MINGGU,23260,79,22590,410,181,260,2021-08-15
317505,JAKARTA TIMUR,PASAR REBO,17356,51,16845,315,145,196,2021-08-15
317508,JAKARTA TIMUR,MAKASAR,17220,63,16761,285,111,174,2021-08-15
317201,JAKARTA UTARA,PENJARINGAN,18227,53,17866,225,83,136,2021-08-15
317502,JAKARTA TIMUR,PULO GADUNG,21382,74,20789,386,133,207,2021-08-15
317102,JAKARTA PUSAT,SAWAH BESAR,8871,29,8619,164,59,88,2021-08-15
317104,JAKARTA PUSAT,SENEN,9236,29,8993,162,52,81,2021-08-15
317402,JAKARTA SELATAN,SETIA BUDI,11395,72,11073,178,72,144,2021-08-15
317303,JAKARTA BARAT,TAMAN SARI,8630,31,8439,132,28,59,2021-08-15
317304,JAKARTA BARAT,TAMBORA,13921,40,13593,232,56,96,2021-08-15
317107,JAKARTA PUSAT,TANAH ABANG,10844,31,10563,215,35,66,2021-08-15
317202,JAKARTA UTARA,TANJUNG PRIOK,25245,60,24638,412,135,195,2021-08-15
317410,JAKARTA SELATAN,PESANGGRAHAN,15990,57,15550,243,140,197,2021-08-15
317504,JAKARTA TIMUR,KRAMAT JATI,21292,54,20688,385,165,219,2021-08-15
317203,JAKARTA UTARA,KOJA,16858,52,16412,331,63,115,2021-08-15
317409,JAKARTA SELATAN,JAGAKARSA,26020,146,25223,385,266,412,2021-08-15
317406,JAKARTA SELATAN,CILANDAK,17246,67,16737,245,197,264,2021-08-15
317204,JAKARTA UTARA,CILINCING,16884,49,16379,330,126,175,2021-08-15
317510,JAKARTA TIMUR,CIPAYUNG,24644,49,24099,254,242,291,2021-08-15
317509,JAKARTA TIMUR,CIRACAS,21937,71,21247,352,267,338,2021-08-15
317507,JAKARTA TIMUR,DUREN SAWIT,28776,83,27866,579,248,331,2021-08-15
317101,JAKARTA PUSAT,GAMBIR,8382,23,8191,126,42,65,2021-08-15
317302,JAKARTA BARAT,GROGOL PETAMBURAN,18854,55,18437,292,70,125,2021-08-15
310101,KAB.ADM.KEP.SERIBU,KEP. SERIBU UTARA,620,0,600,6,14,14,2021-08-15
317301,JAKARTA BARAT,CENGKARENG,28084,83,27345,539,117,200,2021-08-15
317503,JAKARTA TIMUR,JATINEGARA,19171,60,18603,371,137,197,2021-08-15
317306,JAKARTA BARAT,KALI DERES,17707,53,17272,297,85,138,2021-08-15
317407,JAKARTA SELATAN,KEBAYORAN BARU,13511,39,13197,178,97,136,2021-08-15
317405,JAKARTA SELATAN,KEBAYORAN LAMA,19689,73,19132,342,142,215,2021-08-15
317305,JAKARTA BARAT,KEBON JERUK,21733,73,21206,346,108,181,2021-08-15
317206,JAKARTA UTARA,KELAPA GADING,12349,43,12050,186,70,113,2021-08-15
317103,JAKARTA PUSAT,KEMAYORAN,19388,61,18870,362,95,156,2021-08-15
317308,JAKARTA BARAT,KEMBANGAN,19895,66,19431,284,114,180,2021-08-15
310102,KAB.ADM.KEP.SERIBU,KEP. SERIBU SELATAN,696,1,675,9,11,12,2021-08-15
317108,JAKARTA PUSAT,JOHAR BARU,8559,16,8353,156,34,50,2021-08-15
317105,JAKARTA PUSAT,CEMPAKA PUTIH,10286,23,10022,160,81,104,2021-08-15
317105,JAKARTA PUSAT,CEMPAKA PUTIH,10292,25,10028,161,78,103,2021-08-16
111111,Luar DKI & Proses Update,Luar DKI & Proses Update,143008,137,141294,1273,304,441,2021-08-16
317301,JAKARTA BARAT,CENGKARENG,28094,85,27373,539,97,182,2021-08-16
317506,JAKARTA TIMUR,CAKUNG,22216,58,21660,391,107,165,2021-08-16
317406,JAKARTA SELATAN,CILANDAK,17256,69,16779,245,163,232,2021-08-16
317501,JAKARTA TIMUR,MATRAMAN,14014,41,13602,265,106,147,2021-08-16
317106,JAKARTA PUSAT,MENTENG,6333,23,6168,118,24,47,2021-08-16
317205,JAKARTA UTARA,PADEMANGAN,12204,29,11740,159,276,305,2021-08-16
317307,JAKARTA BARAT,PALMERAH,15584,51,15176,311,46,97,2021-08-16
317408,JAKARTA SELATAN,PANCORAN,14082,23,13751,221,87,110,2021-08-16
317404,JAKARTA SELATAN,PASAR MINGGU,23281,80,22606,410,185,265,2021-08-16
317505,JAKARTA TIMUR,PASAR REBO,17363,51,16846,316,150,201,2021-08-16
317201,JAKARTA UTARA,PENJARINGAN,18231,51,17872,225,83,134,2021-08-16
317403,JAKARTA SELATAN,MAMPANG PRAPATAN,11262,31,10972,176,83,114,2021-08-16
317410,JAKARTA SELATAN,PESANGGRAHAN,15999,58,15574,244,123,181,2021-08-16
317102,JAKARTA PUSAT,SAWAH BESAR,8876,34,8621,164,57,91,2021-08-16
317104,JAKARTA PUSAT,SENEN,9238,29,8995,162,52,81,2021-08-16
317402,JAKARTA SELATAN,SETIA BUDI,11407,80,11089,178,60,140,2021-08-16
317303,JAKARTA BARAT,TAMAN SARI,8628,30,8438,133,27,57,2021-08-16
317304,JAKARTA BARAT,TAMBORA,13922,40,13597,233,52,92,2021-08-16
317107,JAKARTA PUSAT,TANAH ABANG,10847,32,10565,215,35,67,2021-08-16
317202,JAKARTA UTARA,TANJUNG PRIOK,25254,62,24648,412,132,194,2021-08-16
317401,JAKARTA SELATAN,TEBET,16650,42,16234,269,105,147,2021-08-16
317502,JAKARTA TIMUR,PULO GADUNG,21391,73,20797,386,135,208,2021-08-16
317508,JAKARTA TIMUR,MAKASAR,17212,65,16759,285,103,168,2021-08-16
317204,JAKARTA UTARA,CILINCING,16889,50,16409,330,100,150,2021-08-16
317203,JAKARTA UTARA,KOJA,16869,51,16435,331,52,103,2021-08-16
317504,JAKARTA TIMUR,KRAMAT JATI,21243,52,20649,387,155,207,2021-08-16
317510,JAKARTA TIMUR,CIPAYUNG,24651,50,24124,255,222,272,2021-08-16
317509,JAKARTA TIMUR,CIRACAS,21943,69,21306,352,216,285,2021-08-16
317507,JAKARTA TIMUR,DUREN SAWIT,28782,80,27904,581,217,297,2021-08-16
317101,JAKARTA PUSAT,GAMBIR,8387,27,8194,126,40,67,2021-08-16
317409,JAKARTA SELATAN,JAGAKARSA,26030,146,25271,388,225,371,2021-08-16
317503,JAKARTA TIMUR,JATINEGARA,19175,58,18633,373,111,169,2021-08-16
317108,JAKARTA PUSAT,JOHAR BARU,8561,17,8353,156,35,52,2021-08-16
317302,JAKARTA BARAT,GROGOL PETAMBURAN,18862,58,18447,293,64,122,2021-08-16
317407,JAKARTA SELATAN,KEBAYORAN BARU,13520,43,13207,178,92,135,2021-08-16
310101,KAB.ADM.KEP.SERIBU,KEP. SERIBU UTARA,619,0,601,6,12,12,2021-08-16
317306,JAKARTA BARAT,KALI DERES,17709,52,17277,298,82,134,2021-08-16
317308,JAKARTA BARAT,KEMBANGAN,19892,63,19428,284,117,180,2021-08-16
317103,JAKARTA PUSAT,KEMAYORAN,19398,64,18885,365,84,148,2021-08-16
310102,KAB.ADM.KEP.SERIBU,KEP. SERIBU SELATAN,696,1,675,10,10,11,2021-08-16
317305,JAKARTA BARAT,KEBON JERUK,21739,76,21222,346,95,171,2021-08-16
317405,JAKARTA SELATAN,KEBAYORAN LAMA,19694,76,19157,342,119,195,2021-08-16
317206,JAKARTA UTARA,KELAPA GADING,12355,44,12063,186,62,106,2021-08-16
317508,JAKARTA TIMUR,MAKASAR,17227,68,16783,286,90,158,2021-08-17
317505,JAKARTA TIMUR,PASAR REBO,17371,53,16871,316,131,184,2021-08-17
317403,JAKARTA SELATAN,MAMPANG PRAPATAN,11265,33,10986,177,69,102,2021-08-17
317501,JAKARTA TIMUR,MATRAMAN,14020,38,13641,266,75,113,2021-08-17
317205,JAKARTA UTARA,PADEMANGAN,12226,27,11782,159,258,285,2021-08-17
317307,JAKARTA BARAT,PALMERAH,15590,45,15193,311,41,86,2021-08-17
317408,JAKARTA SELATAN,PANCORAN,14085,19,13765,221,80,99,2021-08-17
317404,JAKARTA SELATAN,PASAR MINGGU,23290,75,22644,410,161,236,2021-08-17
317201,JAKARTA UTARA,PENJARINGAN,18241,53,17888,225,75,128,2021-08-17
317202,JAKARTA UTARA,TANJUNG PRIOK,25272,61,24671,413,127,188,2021-08-17
317502,JAKARTA TIMUR,PULO GADUNG,21403,79,20822,386,116,195,2021-08-17
317102,JAKARTA PUSAT,SAWAH BESAR,8884,36,8628,164,56,92,2021-08-17
317104,JAKARTA PUSAT,SENEN,9241,29,9002,163,47,76,2021-08-17
317402,JAKARTA SELATAN,SETIA BUDI,11422,87,11099,178,58,145,2021-08-17
317303,JAKARTA BARAT,TAMAN SARI,8631,31,8446,133,21,52,2021-08-17
317304,JAKARTA BARAT,TAMBORA,13925,37,13603,233,52,89,2021-08-17
317107,JAKARTA PUSAT,TANAH ABANG,10854,33,10574,215,32,65,2021-08-17
317504,JAKARTA TIMUR,KRAMAT JATI,21255,57,20671,389,138,195,2021-08-17
317401,JAKARTA SELATAN,TEBET,16656,37,16250,270,99,136,2021-08-17
317410,JAKARTA SELATAN,PESANGGRAHAN,16010,59,15587,244,120,179,2021-08-17
317203,JAKARTA UTARA,KOJA,16874,52,16438,331,53,105,2021-08-17
317106,JAKARTA PUSAT,MENTENG,6337,23,6172,118,24,47,2021-08-17
310102,KAB.ADM.KEP.SERIBU,KEP. SERIBU SELATAN,696,0,677,10,9,9,2021-08-17
310101,KAB.ADM.KEP.SERIBU,KEP. SERIBU UTARA,620,0,602,6,12,12,2021-08-17
111111,Luar DKI & Proses Update,Luar DKI & Proses Update,143008,137,141294,1273,304,441,2021-08-17
317506,JAKARTA TIMUR,CAKUNG,22236,62,21672,393,109,171,2021-08-17
317105,JAKARTA PUSAT,CEMPAKA PUTIH,10296,26,10041,161,68,94,2021-08-17
317301,JAKARTA BARAT,CENGKARENG,28118,94,27384,539,101,195,2021-08-17
317406,JAKARTA SELATAN,CILANDAK,17275,71,16793,246,165,236,2021-08-17
317204,JAKARTA UTARA,CILINCING,16897,48,16418,331,100,148,2021-08-17
317510,JAKARTA TIMUR,CIPAYUNG,24664,53,24163,255,193,246,2021-08-17
317509,JAKARTA TIMUR,CIRACAS,21957,68,21326,354,209,277,2021-08-17
317507,JAKARTA TIMUR,DUREN SAWIT,28797,78,27924,583,212,290,2021-08-17
317101,JAKARTA PUSAT,GAMBIR,8393,24,8199,126,44,68,2021-08-17
317305,JAKARTA BARAT,KEBON JERUK,21746,77,21234,347,88,165,2021-08-17
317409,JAKARTA SELATAN,JAGAKARSA,26044,149,25302,389,204,353,2021-08-17
317503,JAKARTA TIMUR,JATINEGARA,19188,55,18652,374,107,162,2021-08-17
317108,JAKARTA PUSAT,JOHAR BARU,8566,17,8359,156,34,51,2021-08-17
317306,JAKARTA BARAT,KALI DERES,17729,57,17286,300,86,143,2021-08-17
317407,JAKARTA SELATAN,KEBAYORAN BARU,13533,44,13218,179,92,136,2021-08-17
317405,JAKARTA SELATAN,KEBAYORAN LAMA,19701,72,19178,342,109,181,2021-08-17
317206,JAKARTA UTARA,KELAPA GADING,12363,42,12072,186,63,105,2021-08-17
317103,JAKARTA PUSAT,KEMAYORAN,19409,68,18894,365,82,150,2021-08-17
317302,JAKARTA BARAT,GROGOL PETAMBURAN,18874,58,18460,294,62,120,2021-08-17
317308,JAKARTA BARAT,KEMBANGAN,19906,60,19447,285,114,174,2021-08-17
317206,JAKARTA UTARA,KELAPA GADING,12374,38,12077,186,73,111,2021-08-18
317103,JAKARTA PUSAT,KEMAYORAN,19441,83,18912,365,81,164,2021-08-18
317308,JAKARTA BARAT,KEMBANGAN,19917,62,19461,286,108,170,2021-08-18
310102,KAB.ADM.KEP.SERIBU,KEP. SERIBU SELATAN,696,0,677,10,9,9,2021-08-18
310101,KAB.ADM.KEP.SERIBU,KEP. SERIBU UTARA,620,1,603,6,10,11,2021-08-18
317508,JAKARTA TIMUR,MAKASAR,17250,70,16790,286,104,174,2021-08-18
317504,JAKARTA TIMUR,KRAMAT JATI,21269,61,20681,389,138,199,2021-08-18
317305,JAKARTA BARAT,KEBON JERUK,21766,84,21245,348,89,173,2021-08-18
317403,JAKARTA SELATAN,MAMPANG PRAPATAN,11279,35,10996,177,71,106,2021-08-18
317501,JAKARTA TIMUR,MATRAMAN,14038,39,13644,266,89,128,2021-08-18
317106,JAKARTA PUSAT,MENTENG,6348,21,6178,118,31,52,2021-08-18
317203,JAKARTA UTARA,KOJA,16884,51,16448,331,54,105,2021-08-18
317405,JAKARTA SELATAN,KEBAYORAN LAMA,19717,71,19194,342,110,181,2021-08-18
317409,JAKARTA SELATAN,JAGAKARSA,26076,155,25319,391,211,366,2021-08-18
317306,JAKARTA BARAT,KALI DERES,17734,53,17296,300,85,138,2021-08-18
317108,JAKARTA PUSAT,JOHAR BARU,8566,17,8360,156,33,50,2021-08-18
317503,JAKARTA TIMUR,JATINEGARA,19212,52,18670,374,116,168,2021-08-18
317302,JAKARTA BARAT,GROGOL PETAMBURAN,18883,58,18474,295,56,114,2021-08-18
317101,JAKARTA PUSAT,GAMBIR,8401,24,8203,127,47,71,2021-08-18
317507,JAKARTA TIMUR,DUREN SAWIT,28831,77,27952,583,219,296,2021-08-18
317509,JAKARTA TIMUR,CIRACAS,22005,73,21343,354,235,308,2021-08-18
317510,JAKARTA TIMUR,CIPAYUNG,24710,58,24170,255,227,285,2021-08-18
317204,JAKARTA UTARA,CILINCING,16913,51,16425,331,106,157,2021-08-18
317301,JAKARTA BARAT,CENGKARENG,28150,90,27397,540,123,213,2021-08-18
317105,JAKARTA PUSAT,CEMPAKA PUTIH,10301,28,10047,161,65,93,2021-08-18
317506,JAKARTA TIMUR,CAKUNG,22262,63,21690,393,116,179,2021-08-18
317205,JAKARTA UTARA,PADEMANGAN,12090,29,11784,159,118,147,2021-08-18
317407,JAKARTA SELATAN,KEBAYORAN BARU,13549,43,13238,179,89,132,2021-08-18
317406,JAKARTA SELATAN,CILANDAK,17307,80,16801,248,178,258,2021-08-18
317307,JAKARTA BARAT,PALMERAH,15603,47,15195,311,50,97,2021-08-18
317404,JAKARTA SELATAN,PASAR MINGGU,23314,75,22676,410,153,228,2021-08-18
317408,JAKARTA SELATAN,PANCORAN,14099,23,13769,221,86,109,2021-08-18
111111,Luar DKI & Proses Update,Luar DKI & Proses Update,143008,137,141294,1273,304,441,2021-08-18
317401,JAKARTA SELATAN,TEBET,16678,35,16264,270,109,144,2021-08-18
317107,JAKARTA PUSAT,TANAH ABANG,10867,39,10583,215,30,69,2021-08-18
317304,JAKARTA BARAT,TAMBORA,13937,42,13610,234,51,93,2021-08-18
317303,JAKARTA BARAT,TAMAN SARI,8638,32,8449,134,23,55,2021-08-18
317202,JAKARTA UTARA,TANJUNG PRIOK,25295,68,24690,413,124,192,2021-08-18
317104,JAKARTA PUSAT,SENEN,9243,32,9003,163,45,77,2021-08-18
317102,JAKARTA PUSAT,SAWAH BESAR,8897,39,8632,164,62,101,2021-08-18
317502,JAKARTA TIMUR,PULO GADUNG,21422,79,20840,387,116,195,2021-08-18
317410,JAKARTA SELATAN,PESANGGRAHAN,16037,57,15597,244,139,196,2021-08-18
317201,JAKARTA UTARA,PENJARINGAN,18250,50,17900,226,74,124,2021-08-18
317505,JAKARTA TIMUR,PASAR REBO,17409,52,16885,316,156,208,2021-08-18
317402,JAKARTA SELATAN,SETIA BUDI,11434,96,11110,178,50,146,2021-08-18
317505,JAKARTA TIMUR,PASAR REBO,17415,53,16891,316,155,208,2021-08-19
317403,JAKARTA SELATAN,MAMPANG PRAPATAN,11282,33,11002,177,70,103,2021-08-19
317501,JAKARTA TIMUR,MATRAMAN,14044,40,13645,268,91,131,2021-08-19
317106,JAKARTA PUSAT,MENTENG,6350,17,6186,118,29,46,2021-08-19
317205,JAKARTA UTARA,PADEMANGAN,12097,22,11803,159,113,135,2021-08-19
317307,JAKARTA BARAT,PALMERAH,15620,48,15205,312,55,103,2021-08-19
317408,JAKARTA SELATAN,PANCORAN,14102,21,13786,221,74,95,2021-08-19
317404,JAKARTA SELATAN,PASAR MINGGU,23311,75,22691,410,135,210,2021-08-19
317201,JAKARTA UTARA,PENJARINGAN,18263,49,17912,226,76,125,2021-08-19
317107,JAKARTA PUSAT,TANAH ABANG,10873,40,10592,215,26,66,2021-08-19
317502,JAKARTA TIMUR,PULO GADUNG,21436,81,20849,387,119,200,2021-08-19
317102,JAKARTA PUSAT,SAWAH BESAR,8920,38,8670,164,48,86,2021-08-19
317104,JAKARTA PUSAT,SENEN,9248,28,9033,164,23,51,2021-08-19
317402,JAKARTA SELATAN,SETIA BUDI,11450,99,11126,178,47,146,2021-08-19
317303,JAKARTA BARAT,TAMAN SARI,8642,25,8462,135,20,45,2021-08-19
317304,JAKARTA BARAT,TAMBORA,13942,33,13631,234,44,77,2021-08-19
317508,JAKARTA TIMUR,MAKASAR,17265,73,16796,287,109,182,2021-08-19
317202,JAKARTA UTARA,TANJUNG PRIOK,25302,63,24697,414,128,191,2021-08-19
111111,Luar DKI & Proses Update,Luar DKI & Proses Update,143008,137,141294,1273,304,441,2021-08-19
317410,JAKARTA SELATAN,PESANGGRAHAN,16050,52,15630,245,123,175,2021-08-19
317504,JAKARTA TIMUR,KRAMAT JATI,21286,62,20693,390,141,203,2021-08-19
317401,JAKARTA SELATAN,TEBET,16687,38,16286,271,92,130,2021-08-19
310101,KAB.ADM.KEP.SERIBU,KEP. SERIBU UTARA,623,1,606,6,10,11,2021-08-19
317203,JAKARTA UTARA,KOJA,16890,51,16457,331,51,102,2021-08-19
317506,JAKARTA TIMUR,CAKUNG,22274,64,21716,394,100,164,2021-08-19
317301,JAKARTA BARAT,CENGKARENG,28176,93,27424,540,119,212,2021-08-19
317406,JAKARTA SELATAN,CILANDAK,17333,80,16851,249,153,233,2021-08-19
317204,JAKARTA UTARA,CILINCING,16924,54,16429,331,110,164,2021-08-19
317510,JAKARTA TIMUR,CIPAYUNG,24716,57,24224,256,179,236,2021-08-19
317509,JAKARTA TIMUR,CIRACAS,22012,72,21351,358,231,303,2021-08-19
317507,JAKARTA TIMUR,DUREN SAWIT,28843,79,27958,586,220,299,2021-08-19
317101,JAKARTA PUSAT,GAMBIR,8407,23,8214,128,42,65,2021-08-19
317302,JAKARTA BARAT,GROGOL PETAMBURAN,18888,55,18487,297,49,104,2021-08-19
317409,JAKARTA SELATAN,JAGAKARSA,26132,153,25375,391,213,366,2021-08-19
317105,JAKARTA PUSAT,CEMPAKA PUTIH,10315,27,10063,162,63,90,2021-08-19
317108,JAKARTA PUSAT,JOHAR BARU,8569,17,8370,156,26,43,2021-08-19
317306,JAKARTA BARAT,KALI DERES,17746,55,17307,301,83,138,2021-08-19
317407,JAKARTA SELATAN,KEBAYORAN BARU,13559,39,13262,179,79,118,2021-08-19
317405,JAKARTA SELATAN,KEBAYORAN LAMA,19733,75,19210,346,102,177,2021-08-19
317305,JAKARTA BARAT,KEBON JERUK,21782,78,21281,349,74,152,2021-08-19
317206,JAKARTA UTARA,KELAPA GADING,12381,36,12082,187,76,112,2021-08-19
317103,JAKARTA PUSAT,KEMAYORAN,19452,79,18933,365,75,154,2021-08-19
317308,JAKARTA BARAT,KEMBANGAN,19927,58,19491,286,92,150,2021-08-19
317503,JAKARTA TIMUR,JATINEGARA,19227,52,18676,375,124,176,2021-08-19
310102,KAB.ADM.KEP.SERIBU,KEP. SERIBU SELATAN,699,0,681,10,8,8,2021-08-19
317404,JAKARTA SELATAN,PASAR MINGGU,23348,78,22716,410,144,222,2021-08-20
317408,JAKARTA SELATAN,PANCORAN,14111,21,13790,221,79,100,2021-08-20
317307,JAKARTA BARAT,PALMERAH,15635,47,15221,312,55,102,2021-08-20
317501,JAKARTA TIMUR,MATRAMAN,14053,38,13676,269,70,108,2021-08-20
317106,JAKARTA PUSAT,MENTENG,6353,18,6186,118,31,49,2021-08-20
317505,JAKARTA TIMUR,PASAR REBO,17435,55,16932,316,132,187,2021-08-20
317403,JAKARTA SELATAN,MAMPANG PRAPATAN,11308,32,11018,177,81,113,2021-08-20
317205,JAKARTA UTARA,PADEMANGAN,12128,27,11819,159,123,150,2021-08-20
317201,JAKARTA UTARA,PENJARINGAN,18271,51,17932,227,61,112,2021-08-20
317402,JAKARTA SELATAN,SETIA BUDI,11465,91,11141,178,55,146,2021-08-20
317502,JAKARTA TIMUR,PULO GADUNG,21456,84,20871,387,114,198,2021-08-20
317102,JAKARTA PUSAT,SAWAH BESAR,8932,42,8675,164,51,93,2021-08-20
317104,JAKARTA PUSAT,SENEN,9262,29,9036,164,33,62,2021-08-20
317303,JAKARTA BARAT,TAMAN SARI,8647,27,8464,135,21,48,2021-08-20
317304,JAKARTA BARAT,TAMBORA,13952,41,13633,234,44,85,2021-08-20
317107,JAKARTA PUSAT,TANAH ABANG,10881,42,10596,215,28,70,2021-08-20
317202,JAKARTA UTARA,TANJUNG PRIOK,25327,70,24726,414,117,187,2021-08-20
317401,JAKARTA SELATAN,TEBET,16706,42,16294,271,99,141,2021-08-20
317508,JAKARTA TIMUR,MAKASAR,17275,69,16823,287,96,165,2021-08-20
111111,Luar DKI & Proses Update,Luar DKI & Proses Update,143008,137,141294,1273,304,441,2021-08-20
317410,JAKARTA SELATAN,PESANGGRAHAN,16058,48,15642,246,122,170,2021-08-20
317504,JAKARTA TIMUR,KRAMAT JATI,21303,65,20721,390,127,192,2021-08-20
317206,JAKARTA UTARA,KELAPA GADING,12390,35,12095,187,73,108,2021-08-20
310101,KAB.ADM.KEP.SERIBU,KEP. SERIBU UTARA,625,2,613,6,4,6,2021-08-20
317506,JAKARTA TIMUR,CAKUNG,22302,68,21722,395,117,185,2021-08-20
317105,JAKARTA PUSAT,CEMPAKA PUTIH,10316,27,10067,163,59,86,2021-08-20
317301,JAKARTA BARAT,CENGKARENG,28189,94,27437,541,117,211,2021-08-20
317406,JAKARTA SELATAN,CILANDAK,17347,79,16868,249,151,230,2021-08-20
317204,JAKARTA UTARA,CILINCING,16941,52,16466,331,92,144,2021-08-20
317510,JAKARTA TIMUR,CIPAYUNG,24752,65,24245,256,186,251,2021-08-20
317203,JAKARTA UTARA,KOJA,16909,52,16470,331,56,108,2021-08-20
317507,JAKARTA TIMUR,DUREN SAWIT,28903,82,28004,587,230,312,2021-08-20
317101,JAKARTA PUSAT,GAMBIR,8418,27,8219,128,44,71,2021-08-20
317302,JAKARTA BARAT,GROGOL PETAMBURAN,18898,56,18491,297,54,110,2021-08-20
317509,JAKARTA TIMUR,CIRACAS,22045,71,21423,360,191,262,2021-08-20
317503,JAKARTA TIMUR,JATINEGARA,19239,55,18704,376,104,159,2021-08-20
317108,JAKARTA PUSAT,JOHAR BARU,8575,20,8372,156,27,47,2021-08-20
317306,JAKARTA BARAT,KALI DERES,17764,56,17315,301,92,148,2021-08-20
317407,JAKARTA SELATAN,KEBAYORAN BARU,13581,44,13265,179,93,137,2021-08-20
317405,JAKARTA SELATAN,KEBAYORAN LAMA,19743,75,19227,347,94,169,2021-08-20
317305,JAKARTA BARAT,KEBON JERUK,21791,77,21291,349,74,151,2021-08-20
317103,JAKARTA PUSAT,KEMAYORAN,19487,93,18940,365,89,182,2021-08-20
317308,JAKARTA BARAT,KEMBANGAN,19958,55,19502,286,115,170,2021-08-20
317409,JAKARTA SELATAN,JAGAKARSA,26148,154,25400,391,203,357,2021-08-20
310102,KAB.ADM.KEP.SERIBU,KEP. SERIBU SELATAN,699,0,685,10,4,4,2021-08-20
111111,Luar DKI & Proses Update,Luar DKI & Proses Update,143008,137,141294,1273,304,441,2021-08-21
317101,JAKARTA PUSAT,GAMBIR,8430,34,8224,128,44,78,2021-08-21
317507,JAKARTA TIMUR,DUREN SAWIT,28931,85,28046,590,210,295,2021-08-21
317105,JAKARTA PUSAT,CEMPAKA PUTIH,10335,25,10082,163,65,90,2021-08-21
317204,JAKARTA UTARA,CILINCING,16957,58,16476,332,91,149,2021-08-21
317406,JAKARTA SELATAN,CILANDAK,17380,82,16900,249,149,231,2021-08-21
317301,JAKARTA BARAT,CENGKARENG,28203,99,27458,543,103,202,2021-08-21
317506,JAKARTA TIMUR,CAKUNG,22325,72,21748,396,109,181,2021-08-21
317510,JAKARTA TIMUR,CIPAYUNG,24787,68,24275,257,187,255,2021-08-21
317302,JAKARTA BARAT,GROGOL PETAMBURAN,18906,55,18505,297,49,104,2021-08-21
317509,JAKARTA TIMUR,CIRACAS,22074,72,21437,361,204,276,2021-08-21
317501,JAKARTA TIMUR,MATRAMAN,14060,37,13683,269,71,108,2021-08-21
317404,JAKARTA SELATAN,PASAR MINGGU,23364,80,22746,411,127,207,2021-08-21
317505,JAKARTA TIMUR,PASAR REBO,17443,55,16940,316,132,187,2021-08-21
317201,JAKARTA UTARA,PENJARINGAN,18284,52,17941,227,64,116,2021-08-21
317410,JAKARTA SELATAN,PESANGGRAHAN,16075,49,15671,247,108,157,2021-08-21
317502,JAKARTA TIMUR,PULO GADUNG,21475,85,20885,387,118,203,2021-08-21
317102,JAKARTA PUSAT,SAWAH BESAR,8946,50,8684,164,48,98,2021-08-21
317504,JAKARTA TIMUR,KRAMAT JATI,21334,73,20729,390,142,215,2021-08-21
317104,JAKARTA PUSAT,SENEN,9267,28,9040,165,34,62,2021-08-21
317304,JAKARTA BARAT,TAMBORA,13955,42,13642,236,35,77,2021-08-21
317107,JAKARTA PUSAT,TANAH ABANG,10892,44,10599,215,34,78,2021-08-21
317202,JAKARTA UTARA,TANJUNG PRIOK,25345,69,24741,415,120,189,2021-08-21
317401,JAKARTA SELATAN,TEBET,16721,44,16325,271,81,125,2021-08-21
317106,JAKARTA PUSAT,MENTENG,6354,16,6189,118,31,47,2021-08-21
317403,JAKARTA SELATAN,MAMPANG PRAPATAN,11330,35,11038,177,80,115,2021-08-21
317303,JAKARTA BARAT,TAMAN SARI,8651,26,8468,136,21,47,2021-08-21
317203,JAKARTA UTARA,KOJA,16930,57,16480,331,62,119,2021-08-21
317402,JAKARTA SELATAN,SETIA BUDI,11487,92,11162,178,55,147,2021-08-21
310102,KAB.ADM.KEP.SERIBU,KEP. SERIBU SELATAN,700,1,685,10,4,5,2021-08-21
310101,KAB.ADM.KEP.SERIBU,KEP. SERIBU UTARA,626,3,613,6,4,7,2021-08-21
317205,JAKARTA UTARA,PADEMANGAN,12139,29,11820,159,131,160,2021-08-21
317307,JAKARTA BARAT,PALMERAH,15643,51,15225,312,55,106,2021-08-21
317408,JAKARTA SELATAN,PANCORAN,14140,23,13807,221,89,112,2021-08-21
317409,JAKARTA SELATAN,JAGAKARSA,26183,157,25457,393,176,333,2021-08-21
317503,JAKARTA TIMUR,JATINEGARA,19256,54,18721,376,105,159,2021-08-21
317108,JAKARTA PUSAT,JOHAR BARU,8589,25,8377,156,31,56,2021-08-21
317508,JAKARTA TIMUR,MAKASAR,17288,71,16832,287,98,169,2021-08-21
317306,JAKARTA BARAT,KALI DERES,17771,56,17338,301,76,132,2021-08-21
317407,JAKARTA SELATAN,KEBAYORAN BARU,13599,47,13276,179,97,144,2021-08-21
317405,JAKARTA SELATAN,KEBAYORAN LAMA,19761,83,19250,347,81,164,2021-08-21
317305,JAKARTA BARAT,KEBON JERUK,21814,82,21308,349,75,157,2021-08-21
317206,JAKARTA UTARA,KELAPA GADING,12402,33,12108,188,73,106,2021-08-21
317103,JAKARTA PUSAT,KEMAYORAN,19498,92,18967,365,74,166,2021-08-21
317308,JAKARTA BARAT,KEMBANGAN,19996,62,19517,286,131,193,2021-08-21
317201,JAKARTA UTARA,PENJARINGAN,18289,44,17965,227,53,97,2021-08-22
317106,JAKARTA PUSAT,MENTENG,6360,14,6196,118,32,46,2021-08-22
317205,JAKARTA UTARA,PADEMANGAN,12188,26,11830,159,173,199,2021-08-22
317307,JAKARTA BARAT,PALMERAH,15647,49,15230,312,56,105,2021-08-22
317408,JAKARTA SELATAN,PANCORAN,14144,20,13820,221,83,103,2021-08-22
317404,JAKARTA SELATAN,PASAR MINGGU,23383,69,22763,412,139,208,2021-08-22
317505,JAKARTA TIMUR,PASAR REBO,17462,48,16976,317,121,169,2021-08-22
317501,JAKARTA TIMUR,MATRAMAN,14076,37,13712,270,57,94,2021-08-22
317410,JAKARTA SELATAN,PESANGGRAHAN,16097,46,15682,247,122,168,2021-08-22
317202,JAKARTA UTARA,TANJUNG PRIOK,25355,65,24762,416,112,177,2021-08-22
317102,JAKARTA PUSAT,SAWAH BESAR,8947,46,8690,164,47,93,2021-08-22
317104,JAKARTA PUSAT,SENEN,9269,26,9043,165,35,61,2021-08-22
317402,JAKARTA SELATAN,SETIA BUDI,11500,91,11168,178,63,154,2021-08-22
317303,JAKARTA BARAT,TAMAN SARI,8654,24,8473,136,21,45,2021-08-22
317304,JAKARTA BARAT,TAMBORA,13959,43,13645,237,34,77,2021-08-22
317107,JAKARTA PUSAT,TANAH ABANG,10898,43,10606,215,34,77,2021-08-22
317401,JAKARTA SELATAN,TEBET,16733,43,16330,272,88,131,2021-08-22
317403,JAKARTA SELATAN,MAMPANG PRAPATAN,11339,36,11045,177,81,117,2021-08-22
317502,JAKARTA TIMUR,PULO GADUNG,21488,65,20921,388,114,179,2021-08-22
317504,JAKARTA TIMUR,KRAMAT JATI,21348,67,20761,390,130,197,2021-08-22
317508,JAKARTA TIMUR,MAKASAR,17304,59,16865,287,93,152,2021-08-22
310101,KAB.ADM.KEP.SERIBU,KEP. SERIBU UTARA,626,2,616,6,2,4,2021-08-22
317105,JAKARTA PUSAT,CEMPAKA PUTIH,10349,24,10086,163,76,100,2021-08-22
317203,JAKARTA UTARA,KOJA,16946,51,16494,331,70,121,2021-08-22
317506,JAKARTA TIMUR,CAKUNG,22335,65,21763,396,111,176,2021-08-22
317301,JAKARTA BARAT,CENGKARENG,28212,93,27469,544,106,199,2021-08-22
317204,JAKARTA UTARA,CILINCING,16963,47,16490,334,92,139,2021-08-22
317510,JAKARTA TIMUR,CIPAYUNG,24803,63,24298,257,185,248,2021-08-22
317509,JAKARTA TIMUR,CIRACAS,22107,61,21479,362,205,266,2021-08-22
317507,JAKARTA TIMUR,DUREN SAWIT,28956,81,28067,591,217,298,2021-08-22
317101,JAKARTA PUSAT,GAMBIR,8433,34,8228,129,42,76,2021-08-22
317302,JAKARTA BARAT,GROGOL PETAMBURAN,18912,54,18512,297,49,103,2021-08-22
317409,JAKARTA SELATAN,JAGAKARSA,26206,141,25481,394,190,331,2021-08-22
317406,JAKARTA SELATAN,CILANDAK,17392,75,16920,251,146,221,2021-08-22
317108,JAKARTA PUSAT,JOHAR BARU,8592,26,8378,156,32,58,2021-08-22
111111,Luar DKI & Proses Update,Luar DKI & Proses Update,143008,137,141294,1273,304,441,2021-08-22
310102,KAB.ADM.KEP.SERIBU,KEP. SERIBU SELATAN,699,0,687,10,2,2,2021-08-22
317503,JAKARTA TIMUR,JATINEGARA,19269,47,18730,376,116,163,2021-08-22
317103,JAKARTA PUSAT,KEMAYORAN,19518,90,18975,365,88,178,2021-08-22
317308,JAKARTA BARAT,KEMBANGAN,20007,58,19532,286,131,189,2021-08-22
317305,JAKARTA BARAT,KEBON JERUK,21832,78,21317,351,86,164,2021-08-22
317306,JAKARTA BARAT,KALI DERES,17780,50,17352,303,75,125,2021-08-22
317405,JAKARTA SELATAN,KEBAYORAN LAMA,19770,76,19265,348,81,157,2021-08-22
317206,JAKARTA UTARA,KELAPA GADING,12412,27,12123,188,74,101,2021-08-22
317407,JAKARTA SELATAN,KEBAYORAN BARU,13608,44,13283,179,102,146,2021-08-22
317308,JAKARTA BARAT,KEMBANGAN,20019,54,19554,286,125,179,2021-08-23
310102,KAB.ADM.KEP.SERIBU,KEP. SERIBU SELATAN,699,0,687,10,2,2,2021-08-23
310101,KAB.ADM.KEP.SERIBU,KEP. SERIBU UTARA,626,1,616,6,3,4,2021-08-23
317203,JAKARTA UTARA,KOJA,16954,55,16493,331,75,130,2021-08-23
317504,JAKARTA TIMUR,KRAMAT JATI,21351,60,20767,391,133,193,2021-08-23
317508,JAKARTA TIMUR,MAKASAR,17310,59,16872,288,91,150,2021-08-23
317501,JAKARTA TIMUR,MATRAMAN,14078,30,13721,271,56,86,2021-08-23
317106,JAKARTA PUSAT,MENTENG,6363,14,6205,118,26,40,2021-08-23
317205,JAKARTA UTARA,PADEMANGAN,12191,25,11839,159,168,193,2021-08-23
317307,JAKARTA BARAT,PALMERAH,15651,46,15245,313,47,93,2021-08-23
317408,JAKARTA SELATAN,PANCORAN,14152,21,13826,221,84,105,2021-08-23
317404,JAKARTA SELATAN,PASAR MINGGU,23399,70,22779,412,138,208,2021-08-23
317505,JAKARTA TIMUR,PASAR REBO,17471,48,16983,319,121,169,2021-08-23
317403,JAKARTA SELATAN,MAMPANG PRAPATAN,11342,35,11054,177,76,111,2021-08-23
317103,JAKARTA PUSAT,KEMAYORAN,19533,83,18990,365,95,178,2021-08-23
317101,JAKARTA PUSAT,GAMBIR,8438,32,8237,129,40,72,2021-08-23
317305,JAKARTA BARAT,KEBON JERUK,21837,68,21335,354,80,148,2021-08-23
317410,JAKARTA SELATAN,PESANGGRAHAN,16101,42,15696,247,116,158,2021-08-23
317506,JAKARTA TIMUR,CAKUNG,22338,61,21772,396,109,170,2021-08-23
317105,JAKARTA PUSAT,CEMPAKA PUTIH,10351,20,10092,164,75,95,2021-08-23
317301,JAKARTA BARAT,CENGKARENG,28217,87,27491,544,95,182,2021-08-23
317406,JAKARTA SELATAN,CILANDAK,17398,67,16947,252,132,199,2021-08-23
317204,JAKARTA UTARA,CILINCING,16970,46,16497,334,93,139,2021-08-23
317510,JAKARTA TIMUR,CIPAYUNG,24810,63,24306,257,184,247,2021-08-23
317206,JAKARTA UTARA,KELAPA GADING,12415,25,12129,188,73,98,2021-08-23
317509,JAKARTA TIMUR,CIRACAS,22114,63,21485,362,204,267,2021-08-23
317302,JAKARTA BARAT,GROGOL PETAMBURAN,18918,45,18526,297,50,95,2021-08-23
317409,JAKARTA SELATAN,JAGAKARSA,26219,123,25506,396,194,317,2021-08-23
317503,JAKARTA TIMUR,JATINEGARA,19271,41,18737,376,117,158,2021-08-23
317108,JAKARTA PUSAT,JOHAR BARU,8592,23,8389,156,24,47,2021-08-23
317306,JAKARTA BARAT,KALI DERES,17786,46,17374,303,63,109,2021-08-23
317407,JAKARTA SELATAN,KEBAYORAN BARU,13614,46,13290,179,99,145,2021-08-23
317405,JAKARTA SELATAN,KEBAYORAN LAMA,19782,70,19283,348,81,151,2021-08-23
317507,JAKARTA TIMUR,DUREN SAWIT,28971,76,28101,593,201,277,2021-08-23
317502,JAKARTA TIMUR,PULO GADUNG,21496,59,20943,388,106,165,2021-08-23
317201,JAKARTA UTARA,PENJARINGAN,18292,35,17983,227,47,82,2021-08-23
317104,JAKARTA PUSAT,SENEN,9275,25,9053,165,32,57,2021-08-23
317102,JAKARTA PUSAT,SAWAH BESAR,8951,42,8699,166,44,86,2021-08-23
317401,JAKARTA SELATAN,TEBET,16740,42,16338,273,87,129,2021-08-23
317202,JAKARTA UTARA,TANJUNG PRIOK,25364,62,24779,416,107,169,2021-08-23
111111,Luar DKI & Proses Update,Luar DKI & Proses Update,143008,137,141294,1273,304,441,2021-08-23
317304,JAKARTA BARAT,TAMBORA,13961,35,13656,237,33,68,2021-08-23
317303,JAKARTA BARAT,TAMAN SARI,8658,24,8479,137,18,42,2021-08-23
317402,JAKARTA SELATAN,SETIA BUDI,11506,83,11179,178,66,149,2021-08-23
317107,JAKARTA PUSAT,TANAH ABANG,10903,41,10618,215,29,70,2021-08-23
317501,JAKARTA TIMUR,MATRAMAN,14086,31,13728,271,56,87,2021-08-24
317201,JAKARTA UTARA,PENJARINGAN,18297,37,17987,227,46,83,2021-08-24
317106,JAKARTA PUSAT,MENTENG,6368,16,6206,118,28,44,2021-08-24
317205,JAKARTA UTARA,PADEMANGAN,12231,31,11843,160,197,228,2021-08-24
317307,JAKARTA BARAT,PALMERAH,15662,49,15247,313,53,102,2021-08-24
317408,JAKARTA SELATAN,PANCORAN,14154,20,13845,222,67,87,2021-08-24
317404,JAKARTA SELATAN,PASAR MINGGU,23414,70,22798,412,134,204,2021-08-24
317505,JAKARTA TIMUR,PASAR REBO,17478,49,16999,319,111,160,2021-08-24
317410,JAKARTA SELATAN,PESANGGRAHAN,16109,38,15722,247,102,140,2021-08-24
317402,JAKARTA SELATAN,SETIA BUDI,11532,104,11183,178,67,171,2021-08-24
317102,JAKARTA PUSAT,SAWAH BESAR,8955,44,8701,166,44,88,2021-08-24
317104,JAKARTA PUSAT,SENEN,9277,26,9053,166,32,58,2021-08-24
317403,JAKARTA SELATAN,MAMPANG PRAPATAN,11348,39,11058,177,74,113,2021-08-24
317303,JAKARTA BARAT,TAMAN SARI,8660,26,8482,137,15,41,2021-08-24
317304,JAKARTA BARAT,TAMBORA,13963,34,13669,237,23,57,2021-08-24
317107,JAKARTA PUSAT,TANAH ABANG,10913,44,10618,216,35,79,2021-08-24
317202,JAKARTA UTARA,TANJUNG PRIOK,25378,60,24787,417,114,174,2021-08-24
111111,Luar DKI & Proses Update,Luar DKI & Proses Update,143008,137,141294,1273,304,441,2021-08-24
317502,JAKARTA TIMUR,PULO GADUNG,21504,61,20970,388,85,146,2021-08-24
317508,JAKARTA TIMUR,MAKASAR,17314,61,16887,288,78,139,2021-08-24
317401,JAKARTA SELATAN,TEBET,16743,41,16351,273,78,119,2021-08-24
317203,JAKARTA UTARA,KOJA,16956,56,16508,331,61,117,2021-08-24
317105,JAKARTA PUSAT,CEMPAKA PUTIH,10355,23,10108,164,60,83,2021-08-24
317301,JAKARTA BARAT,CENGKARENG,28226,93,27494,544,95,188,2021-08-24
317504,JAKARTA TIMUR,KRAMAT JATI,21363,54,20810,391,108,162,2021-08-24
317406,JAKARTA SELATAN,CILANDAK,17407,63,16968,252,124,187,2021-08-24
317204,JAKARTA UTARA,CILINCING,16976,46,16503,334,93,139,2021-08-24
317510,JAKARTA TIMUR,CIPAYUNG,24817,65,24346,257,149,214,2021-08-24
317509,JAKARTA TIMUR,CIRACAS,22117,56,21531,363,167,223,2021-08-24
317507,JAKARTA TIMUR,DUREN SAWIT,28977,70,28125,593,189,259,2021-08-24
317101,JAKARTA PUSAT,GAMBIR,8443,33,8238,129,43,76,2021-08-24
317302,JAKARTA BARAT,GROGOL PETAMBURAN,18920,44,18528,297,51,95,2021-08-24
317409,JAKARTA SELATAN,JAGAKARSA,26232,122,25516,397,197,319,2021-08-24
317506,JAKARTA TIMUR,CAKUNG,22346,63,21787,396,100,163,2021-08-24
317108,JAKARTA PUSAT,JOHAR BARU,8594,25,8389,156,24,49,2021-08-24
317308,JAKARTA BARAT,KEMBANGAN,20029,59,19555,287,128,187,2021-08-24
317503,JAKARTA TIMUR,JATINEGARA,19278,44,18760,376,98,142,2021-08-24
310101,KAB.ADM.KEP.SERIBU,KEP. SERIBU UTARA,626,0,618,6,2,2,2021-08-24
317103,JAKARTA PUSAT,KEMAYORAN,19542,89,19004,365,84,173,2021-08-24
310102,KAB.ADM.KEP.SERIBU,KEP. SERIBU SELATAN,699,0,687,10,2,2,2021-08-24
317305,JAKARTA BARAT,KEBON JERUK,21857,73,21337,354,93,166,2021-08-24
317405,JAKARTA SELATAN,KEBAYORAN LAMA,19796,71,19297,349,79,150,2021-08-24
317407,JAKARTA SELATAN,KEBAYORAN BARU,13622,45,13306,179,92,137,2021-08-24
317306,JAKARTA BARAT,KALI DERES,17794,44,17382,304,64,108,2021-08-24
317206,JAKARTA UTARA,KELAPA GADING,12416,24,12139,188,65,89,2021-08-24
317106,JAKARTA PUSAT,MENTENG,6372,13,6215,118,26,39,2021-08-25
317201,JAKARTA UTARA,PENJARINGAN,18308,38,17992,227,51,89,2021-08-25
317205,JAKARTA UTARA,PADEMANGAN,12251,28,11848,160,215,243,2021-08-25
317307,JAKARTA BARAT,PALMERAH,15668,44,15256,313,55,99,2021-08-25
317408,JAKARTA SELATAN,PANCORAN,14166,23,13850,223,70,93,2021-08-25
317404,JAKARTA SELATAN,PASAR MINGGU,23433,74,22810,413,136,210,2021-08-25
317505,JAKARTA TIMUR,PASAR REBO,17492,46,17005,320,121,167,2021-08-25
317410,JAKARTA SELATAN,PESANGGRAHAN,16121,36,15728,248,109,145,2021-08-25
317402,JAKARTA SELATAN,SETIA BUDI,11552,96,11199,178,79,175,2021-08-25
317102,JAKARTA PUSAT,SAWAH BESAR,8963,40,8712,166,45,85,2021-08-25
317104,JAKARTA PUSAT,SENEN,9282,23,9067,166,26,49,2021-08-25
317501,JAKARTA TIMUR,MATRAMAN,14090,30,13733,271,56,86,2021-08-25
317303,JAKARTA BARAT,TAMAN SARI,8663,26,8486,137,14,40,2021-08-25
317304,JAKARTA BARAT,TAMBORA,13971,28,13681,237,25,53,2021-08-25
317107,JAKARTA PUSAT,TANAH ABANG,10918,42,10625,216,35,77,2021-08-25
317202,JAKARTA UTARA,TANJUNG PRIOK,25396,61,24794,417,124,185,2021-08-25
317401,JAKARTA SELATAN,TEBET,16763,43,16363,273,84,127,2021-08-25
111111,Luar DKI & Proses Update,Luar DKI & Proses Update,143008,137,141294,1273,304,441,2021-08-25
317502,JAKARTA TIMUR,PULO GADUNG,21528,54,20992,388,94,148,2021-08-25
317403,JAKARTA SELATAN,MAMPANG PRAPATAN,11359,40,11061,177,81,121,2021-08-25
310102,KAB.ADM.KEP.SERIBU,KEP. SERIBU SELATAN,699,0,688,10,1,1,2021-08-25
317504,JAKARTA TIMUR,KRAMAT JATI,21390,58,20820,392,120,178,2021-08-25
317506,JAKARTA TIMUR,CAKUNG,22353,65,21788,395,105,170,2021-08-25
317105,JAKARTA PUSAT,CEMPAKA PUTIH,10367,20,10126,164,57,77,2021-08-25
317301,JAKARTA BARAT,CENGKARENG,28250,93,27509,544,104,197,2021-08-25
317406,JAKARTA SELATAN,CILANDAK,17421,63,16987,253,118,181,2021-08-25
317204,JAKARTA UTARA,CILINCING,16994,47,16516,334,97,144,2021-08-25
317510,JAKARTA TIMUR,CIPAYUNG,24858,71,24348,258,181,252,2021-08-25
317509,JAKARTA TIMUR,CIRACAS,22133,55,21540,363,175,230,2021-08-25
317507,JAKARTA TIMUR,DUREN SAWIT,29060,71,28162,593,234,305,2021-08-25
317101,JAKARTA PUSAT,GAMBIR,8450,34,8246,129,41,75,2021-08-25
317302,JAKARTA BARAT,GROGOL PETAMBURAN,18925,42,18547,297,39,81,2021-08-25
317409,JAKARTA SELATAN,JAGAKARSA,26243,118,25533,397,195,313,2021-08-25
317503,JAKARTA TIMUR,JATINEGARA,19295,43,18766,376,110,153,2021-08-25
317108,JAKARTA PUSAT,JOHAR BARU,8597,22,8400,156,19,41,2021-08-25
317306,JAKARTA BARAT,KALI DERES,17801,36,17397,306,62,98,2021-08-25
317405,JAKARTA SELATAN,KEBAYORAN LAMA,19816,68,19313,349,86,154,2021-08-25
317305,JAKARTA BARAT,KEBON JERUK,21868,65,21364,354,85,150,2021-08-25
317206,JAKARTA UTARA,KELAPA GADING,12426,22,12149,188,67,89,2021-08-25
317103,JAKARTA PUSAT,KEMAYORAN,19564,79,19022,366,97,176,2021-08-25
317308,JAKARTA BARAT,KEMBANGAN,20039,58,19565,288,128,186,2021-08-25
310101,KAB.ADM.KEP.SERIBU,KEP. SERIBU UTARA,626,0,617,6,3,3,2021-08-25
317203,JAKARTA UTARA,KOJA,16967,55,16511,331,70,125,2021-08-25
317508,JAKARTA TIMUR,MAKASAR,17321,55,16894,288,84,139,2021-08-25
317407,JAKARTA SELATAN,KEBAYORAN BARU,13637,47,13318,179,93,140,2021-08-25
310101,KAB.ADM.KEP.SERIBU,KEP. SERIBU UTARA,627,0,618,6,3,3,2021-08-26
111111,Luar DKI & Proses Update,Luar DKI & Proses Update,143008,137,141294,1273,304,441,2021-08-26
317206,JAKARTA UTARA,KELAPA GADING,12434,22,12162,188,62,84,2021-08-26
317305,JAKARTA BARAT,KEBON JERUK,21875,66,21373,354,82,148,2021-08-26
317405,JAKARTA SELATAN,KEBAYORAN LAMA,19832,66,19336,349,81,147,2021-08-26
317407,JAKARTA SELATAN,KEBAYORAN BARU,13643,42,13334,179,88,130,2021-08-26
317306,JAKARTA BARAT,KALI DERES,17803,34,17405,306,58,92,2021-08-26
317108,JAKARTA PUSAT,JOHAR BARU,8602,22,8401,156,23,45,2021-08-26
317503,JAKARTA TIMUR,JATINEGARA,19304,37,18791,376,100,137,2021-08-26
317409,JAKARTA SELATAN,JAGAKARSA,26266,69,25624,397,176,245,2021-08-26
310102,KAB.ADM.KEP.SERIBU,KEP. SERIBU SELATAN,700,0,688,10,2,2,2021-08-26
317302,JAKARTA BARAT,GROGOL PETAMBURAN,18930,38,18554,297,41,79,2021-08-26
317507,JAKARTA TIMUR,DUREN SAWIT,29069,72,28187,593,217,289,2021-08-26
317509,JAKARTA TIMUR,CIRACAS,22150,53,21572,363,162,215,2021-08-26
317510,JAKARTA TIMUR,CIPAYUNG,24869,66,24382,259,162,228,2021-08-26
317204,JAKARTA UTARA,CILINCING,17001,44,16546,334,77,121,2021-08-26
317406,JAKARTA SELATAN,CILANDAK,17437,62,16998,253,124,186,2021-08-26
317301,JAKARTA BARAT,CENGKARENG,28260,89,27527,544,100,189,2021-08-26
317105,JAKARTA PUSAT,CEMPAKA PUTIH,10369,21,10128,164,56,77,2021-08-26
317506,JAKARTA TIMUR,CAKUNG,22373,65,21808,395,105,170,2021-08-26
317101,JAKARTA PUSAT,GAMBIR,8454,32,8253,129,40,72,2021-08-26
317103,JAKARTA PUSAT,KEMAYORAN,19579,76,19029,366,108,184,2021-08-26
317308,JAKARTA BARAT,KEMBANGAN,20048,55,19583,288,122,177,2021-08-26
317401,JAKARTA SELATAN,TEBET,16780,44,16374,273,89,133,2021-08-26
317202,JAKARTA UTARA,TANJUNG PRIOK,25419,54,24829,417,119,173,2021-08-26
317107,JAKARTA PUSAT,TANAH ABANG,10924,41,10629,216,38,79,2021-08-26
317304,JAKARTA BARAT,TAMBORA,13974,27,13683,238,26,53,2021-08-26
317303,JAKARTA BARAT,TAMAN SARI,8668,26,8489,137,16,42,2021-08-26
317402,JAKARTA SELATAN,SETIA BUDI,11573,106,11215,178,74,180,2021-08-26
317104,JAKARTA PUSAT,SENEN,9283,20,9072,166,25,45,2021-08-26
317502,JAKARTA TIMUR,PULO GADUNG,21541,50,21011,388,92,142,2021-08-26
317410,JAKARTA SELATAN,PESANGGRAHAN,16138,36,15745,248,109,145,2021-08-26
317201,JAKARTA UTARA,PENJARINGAN,18322,38,17999,227,58,96,2021-08-26
317505,JAKARTA TIMUR,PASAR REBO,17505,48,17028,320,109,157,2021-08-26
317102,JAKARTA PUSAT,SAWAH BESAR,8974,38,8716,166,54,92,2021-08-26
317408,JAKARTA SELATAN,PANCORAN,14171,23,13858,223,67,90,2021-08-26
317404,JAKARTA SELATAN,PASAR MINGGU,23450,69,22841,413,127,196,2021-08-26
317504,JAKARTA TIMUR,KRAMAT JATI,21399,56,20841,392,110,166,2021-08-26
317508,JAKARTA TIMUR,MAKASAR,17326,56,16906,288,76,132,2021-08-26
317403,JAKARTA SELATAN,MAMPANG PRAPATAN,11365,39,11072,177,77,116,2021-08-26
317203,JAKARTA UTARA,KOJA,16974,55,16515,331,73,128,2021-08-26
317106,JAKARTA PUSAT,MENTENG,6372,12,6216,118,26,38,2021-08-26
317205,JAKARTA UTARA,PADEMANGAN,12264,29,11856,160,219,248,2021-08-26
317307,JAKARTA BARAT,PALMERAH,15672,44,15266,313,49,93,2021-08-26
317501,JAKARTA TIMUR,MATRAMAN,14095,29,13745,271,50,79,2021-08-26
317505,JAKARTA TIMUR,PASAR REBO,17509,48,17033,320,108,156,2021-08-27
317508,JAKARTA TIMUR,MAKASAR,17332,48,16913,289,82,130,2021-08-27
317403,JAKARTA SELATAN,MAMPANG PRAPATAN,11371,32,11080,178,81,113,2021-08-27
317501,JAKARTA TIMUR,MATRAMAN,14099,30,13746,271,52,82,2021-08-27
317106,JAKARTA PUSAT,MENTENG,6375,12,6217,118,28,40,2021-08-27
317205,JAKARTA UTARA,PADEMANGAN,12333,31,11873,160,269,300,2021-08-27
317307,JAKARTA BARAT,PALMERAH,15683,44,15274,314,51,95,2021-08-27
317408,JAKARTA SELATAN,PANCORAN,14175,22,13861,223,69,91,2021-08-27
317404,JAKARTA SELATAN,PASAR MINGGU,23467,58,22868,413,128,186,2021-08-27
317201,JAKARTA UTARA,PENJARINGAN,18340,40,18002,227,71,111,2021-08-27
317305,JAKARTA BARAT,KEBON JERUK,21889,64,21382,354,89,153,2021-08-27
317502,JAKARTA TIMUR,PULO GADUNG,21553,49,21023,388,93,142,2021-08-27
317102,JAKARTA PUSAT,SAWAH BESAR,8978,37,8718,166,57,94,2021-08-27
317104,JAKARTA PUSAT,SENEN,9286,19,9073,166,28,47,2021-08-27
317402,JAKARTA SELATAN,SETIA BUDI,11591,115,11222,178,76,191,2021-08-27
317303,JAKARTA BARAT,TAMAN SARI,8671,25,8492,137,17,42,2021-08-27
317304,JAKARTA BARAT,TAMBORA,13980,29,13685,238,28,57,2021-08-27
317107,JAKARTA PUSAT,TANAH ABANG,10926,39,10632,216,39,78,2021-08-27
317202,JAKARTA UTARA,TANJUNG PRIOK,25425,51,24836,418,120,171,2021-08-27
317401,JAKARTA SELATAN,TEBET,16788,41,16378,274,95,136,2021-08-27
317504,JAKARTA TIMUR,KRAMAT JATI,21409,52,20852,392,113,165,2021-08-27
317410,JAKARTA SELATAN,PESANGGRAHAN,16146,33,15752,248,113,146,2021-08-27
317203,JAKARTA UTARA,KOJA,16981,48,16532,333,68,116,2021-08-27
317405,JAKARTA SELATAN,KEBAYORAN LAMA,19838,64,19341,349,84,148,2021-08-27
310102,KAB.ADM.KEP.SERIBU,KEP. SERIBU SELATAN,700,0,688,10,2,2,2021-08-27
317506,JAKARTA TIMUR,CAKUNG,22384,62,21813,396,113,175,2021-08-27
317105,JAKARTA PUSAT,CEMPAKA PUTIH,10374,18,10132,164,60,78,2021-08-27
317301,JAKARTA BARAT,CENGKARENG,28268,79,27542,544,103,182,2021-08-27
317406,JAKARTA SELATAN,CILANDAK,17447,62,17004,253,128,190,2021-08-27
310101,KAB.ADM.KEP.SERIBU,KEP. SERIBU UTARA,627,0,618,6,3,3,2021-08-27
317510,JAKARTA TIMUR,CIPAYUNG,24893,66,24387,260,180,246,2021-08-27
317509,JAKARTA TIMUR,CIRACAS,22173,50,21577,366,180,230,2021-08-27
317507,JAKARTA TIMUR,DUREN SAWIT,29101,68,28195,593,245,313,2021-08-27
317101,JAKARTA PUSAT,GAMBIR,8455,27,8258,129,41,68,2021-08-27
317302,JAKARTA BARAT,GROGOL PETAMBURAN,18937,33,18562,297,45,78,2021-08-27
317204,JAKARTA UTARA,CILINCING,17013,48,16550,334,81,129,2021-08-27
317409,JAKARTA SELATAN,JAGAKARSA,26280,72,25633,397,178,250,2021-08-27
317503,JAKARTA TIMUR,JATINEGARA,19314,30,18800,376,108,138,2021-08-27
317108,JAKARTA PUSAT,JOHAR BARU,8605,19,8405,156,25,44,2021-08-27
317306,JAKARTA BARAT,KALI DERES,17809,34,17407,306,62,96,2021-08-27
317407,JAKARTA SELATAN,KEBAYORAN BARU,13648,38,13341,179,90,128,2021-08-27
317206,JAKARTA UTARA,KELAPA GADING,12441,22,12165,189,65,87,2021-08-27
317103,JAKARTA PUSAT,KEMAYORAN,19595,74,19037,367,117,191,2021-08-27
317308,JAKARTA BARAT,KEMBANGAN,20057,57,19585,289,126,183,2021-08-27
111111,Luar DKI & Proses Update,Luar DKI & Proses Update,143008,137,141294,1273,304,441,2021-08-27
317409,JAKARTA SELATAN,JAGAKARSA,26309,71,25645,397,196,267,2021-08-28
317302,JAKARTA BARAT,GROGOL PETAMBURAN,18943,27,18572,297,47,74,2021-08-28
317101,JAKARTA PUSAT,GAMBIR,8460,30,8259,129,42,72,2021-08-28
317507,JAKARTA TIMUR,DUREN SAWIT,29120,71,28198,593,258,329,2021-08-28
317509,JAKARTA TIMUR,CIRACAS,22184,52,21583,366,183,235,2021-08-28
317105,JAKARTA PUSAT,CEMPAKA PUTIH,10379,17,10135,164,63,80,2021-08-28
317406,JAKARTA SELATAN,CILANDAK,17455,55,17013,253,134,189,2021-08-28
317301,JAKARTA BARAT,CENGKARENG,28280,74,27554,544,108,182,2021-08-28
317506,JAKARTA TIMUR,CAKUNG,22391,62,21820,396,113,175,2021-08-28
317503,JAKARTA TIMUR,JATINEGARA,19317,32,18803,376,106,138,2021-08-28
317510,JAKARTA TIMUR,CIPAYUNG,24911,60,24399,261,191,251,2021-08-28
317108,JAKARTA PUSAT,JOHAR BARU,8605,16,8409,156,24,40,2021-08-28
317204,JAKARTA UTARA,CILINCING,17030,49,16552,335,94,143,2021-08-28
317407,JAKARTA SELATAN,KEBAYORAN BARU,13655,36,13348,179,92,128,2021-08-28
317306,JAKARTA BARAT,KALI DERES,17813,36,17408,306,63,99,2021-08-28
111111,Luar DKI & Proses Update,Luar DKI & Proses Update,143008,137,141294,1273,304,441,2021-08-28
317401,JAKARTA SELATAN,TEBET,16790,41,16380,274,95,136,2021-08-28
317202,JAKARTA UTARA,TANJUNG PRIOK,25438,50,24846,418,124,174,2021-08-28
317107,JAKARTA PUSAT,TANAH ABANG,10930,37,10636,216,41,78,2021-08-28
317304,JAKARTA BARAT,TAMBORA,13988,27,13690,238,33,60,2021-08-28
317402,JAKARTA SELATAN,SETIA BUDI,11608,121,11233,178,76,197,2021-08-28
317104,JAKARTA PUSAT,SENEN,9287,16,9077,166,28,44,2021-08-28
317102,JAKARTA PUSAT,SAWAH BESAR,8984,34,8723,166,61,95,2021-08-28
317502,JAKARTA TIMUR,PULO GADUNG,21560,50,21028,388,94,144,2021-08-28
317410,JAKARTA SELATAN,PESANGGRAHAN,16165,33,15761,248,123,156,2021-08-28
317201,JAKARTA UTARA,PENJARINGAN,18346,38,18007,227,74,112,2021-08-28
317505,JAKARTA TIMUR,PASAR REBO,17513,40,17045,320,108,148,2021-08-28
317404,JAKARTA SELATAN,PASAR MINGGU,23486,54,22874,415,143,197,2021-08-28
317408,JAKARTA SELATAN,PANCORAN,14176,21,13863,223,69,90,2021-08-28
317303,JAKARTA BARAT,TAMAN SARI,8674,24,8495,137,18,42,2021-08-28
317205,JAKARTA UTARA,PADEMANGAN,12344,30,11877,160,277,307,2021-08-28
317307,JAKARTA BARAT,PALMERAH,15687,42,15280,314,51,93,2021-08-28
317405,JAKARTA SELATAN,KEBAYORAN LAMA,19845,60,19347,350,88,148,2021-08-28
317305,JAKARTA BARAT,KEBON JERUK,21892,65,21385,354,88,153,2021-08-28
317206,JAKARTA UTARA,KELAPA GADING,12443,18,12168,190,67,85,2021-08-28
317103,JAKARTA PUSAT,KEMAYORAN,19615,72,19042,368,133,205,2021-08-28
310102,KAB.ADM.KEP.SERIBU,KEP. SERIBU SELATAN,700,0,689,10,1,1,2021-08-28
310101,KAB.ADM.KEP.SERIBU,KEP. SERIBU UTARA,627,0,619,6,2,2,2021-08-28
317308,JAKARTA BARAT,KEMBANGAN,20056,46,19599,290,121,167,2021-08-28
317203,JAKARTA UTARA,KOJA,16987,43,16539,334,71,114,2021-08-28
317504,JAKARTA TIMUR,KRAMAT JATI,21411,48,20855,392,116,164,2021-08-28
317508,JAKARTA TIMUR,MAKASAR,17338,45,16916,289,88,133,2021-08-28
317403,JAKARTA SELATAN,MAMPANG PRAPATAN,11375,31,11084,178,82,113,2021-08-28
317501,JAKARTA TIMUR,MATRAMAN,14099,27,13750,271,51,78,2021-08-28
317106,JAKARTA PUSAT,MENTENG,6378,13,6218,118,29,42,2021-08-28
317501,JAKARTA TIMUR,MATRAMAN,14104,25,13754,272,53,78,2021-08-29
317505,JAKARTA TIMUR,PASAR REBO,17517,37,17053,320,107,144,2021-08-29
317106,JAKARTA PUSAT,MENTENG,6383,17,6220,118,28,45,2021-08-29
317205,JAKARTA UTARA,PADEMANGAN,12393,29,11928,160,276,305,2021-08-29
317307,JAKARTA BARAT,PALMERAH,15692,38,15298,315,41,79,2021-08-29
317408,JAKARTA SELATAN,PANCORAN,14186,22,13864,224,76,98,2021-08-29
317404,JAKARTA SELATAN,PASAR MINGGU,23498,55,22884,415,144,199,2021-08-29
317403,JAKARTA SELATAN,MAMPANG PRAPATAN,11387,30,11088,178,91,121,2021-08-29
317201,JAKARTA UTARA,PENJARINGAN,18359,35,18016,227,81,116,2021-08-29
317304,JAKARTA BARAT,TAMBORA,13992,23,13700,238,31,54,2021-08-29
317502,JAKARTA TIMUR,PULO GADUNG,21562,41,21037,389,95,136,2021-08-29
317102,JAKARTA PUSAT,SAWAH BESAR,8987,33,8729,166,59,92,2021-08-29
317104,JAKARTA PUSAT,SENEN,9288,13,9082,166,27,40,2021-08-29
317402,JAKARTA SELATAN,SETIA BUDI,11616,116,11247,178,75,191,2021-08-29
317303,JAKARTA BARAT,TAMAN SARI,8675,23,8501,137,14,37,2021-08-29
317107,JAKARTA PUSAT,TANAH ABANG,10937,31,10647,216,43,74,2021-08-29
317202,JAKARTA UTARA,TANJUNG PRIOK,25444,47,24863,418,116,163,2021-08-29
317401,JAKARTA SELATAN,TEBET,16795,40,16388,274,93,133,2021-08-29
317508,JAKARTA TIMUR,MAKASAR,17343,37,16933,289,84,121,2021-08-29
111111,Luar DKI & Proses Update,Luar DKI & Proses Update,143008,137,141294,1273,304,441,2021-08-29
317410,JAKARTA SELATAN,PESANGGRAHAN,16168,30,15770,248,120,150,2021-08-29
317504,JAKARTA TIMUR,KRAMAT JATI,21431,47,20868,393,123,170,2021-08-29
317305,JAKARTA BARAT,KEBON JERUK,21898,58,21407,355,78,136,2021-08-29
310101,KAB.ADM.KEP.SERIBU,KEP. SERIBU UTARA,627,0,619,6,2,2,2021-08-29
317506,JAKARTA TIMUR,CAKUNG,22404,62,21836,396,110,172,2021-08-29
317203,JAKARTA UTARA,KOJA,16991,42,16543,334,72,114,2021-08-29
317301,JAKARTA BARAT,CENGKARENG,28292,60,27604,544,84,144,2021-08-29
317406,JAKARTA SELATAN,CILANDAK,17461,52,17028,253,128,180,2021-08-29
317204,JAKARTA UTARA,CILINCING,17036,48,16559,336,93,141,2021-08-29
317510,JAKARTA TIMUR,CIPAYUNG,24931,59,24406,261,205,264,2021-08-29
317509,JAKARTA TIMUR,CIRACAS,22196,46,21597,366,187,233,2021-08-29
317507,JAKARTA TIMUR,DUREN SAWIT,29128,70,28213,594,251,321,2021-08-29
317101,JAKARTA PUSAT,GAMBIR,8462,26,8272,129,35,61,2021-08-29
317302,JAKARTA BARAT,GROGOL PETAMBURAN,18952,25,18585,297,45,70,2021-08-29
317105,JAKARTA PUSAT,CEMPAKA PUTIH,10380,11,10144,164,61,72,2021-08-29
317308,JAKARTA BARAT,KEMBANGAN,20070,43,19621,291,115,158,2021-08-29
317503,JAKARTA TIMUR,JATINEGARA,19324,28,18817,376,103,131,2021-08-29
317108,JAKARTA PUSAT,JOHAR BARU,8609,16,8414,156,23,39,2021-08-29
317306,JAKARTA BARAT,KALI DERES,17819,33,17427,306,53,86,2021-08-29
317407,JAKARTA SELATAN,KEBAYORAN BARU,13661,34,13359,180,88,122,2021-08-29
317405,JAKARTA SELATAN,KEBAYORAN LAMA,19848,57,19355,350,86,143,2021-08-29
317206,JAKARTA UTARA,KELAPA GADING,12446,17,12177,190,62,79,2021-08-29
317103,JAKARTA PUSAT,KEMAYORAN,19625,56,19063,368,138,194,2021-08-29
310102,KAB.ADM.KEP.SERIBU,KEP. SERIBU SELATAN,700,0,689,10,1,1,2021-08-29
317409,JAKARTA SELATAN,JAGAKARSA,26319,69,25657,397,196,265,2021-08-29
317505,JAKARTA TIMUR,PASAR REBO,17520,34,17090,321,75,109,2021-08-30
317404,JAKARTA SELATAN,PASAR MINGGU,23513,52,22903,415,143,195,2021-08-30
317408,JAKARTA SELATAN,PANCORAN,14191,20,13876,224,71,91,2021-08-30
317401,JAKARTA SELATAN,TEBET,16797,39,16403,274,81,120,2021-08-30
317205,JAKARTA UTARA,PADEMANGAN,12430,27,11934,160,309,336,2021-08-30
317106,JAKARTA PUSAT,MENTENG,6383,16,6231,118,18,34,2021-08-30
317201,JAKARTA UTARA,PENJARINGAN,18363,35,18027,227,74,109,2021-08-30
317501,JAKARTA TIMUR,MATRAMAN,14106,21,13773,272,40,61,2021-08-30
317307,JAKARTA BARAT,PALMERAH,15697,39,15300,315,43,82,2021-08-30
317410,JAKARTA SELATAN,PESANGGRAHAN,16174,28,15798,248,100,128,2021-08-30
317303,JAKARTA BARAT,TAMAN SARI,8675,22,8502,137,14,36,2021-08-30
317102,JAKARTA PUSAT,SAWAH BESAR,8989,30,8741,166,52,82,2021-08-30
317104,JAKARTA PUSAT,SENEN,9290,13,9083,166,28,41,2021-08-30
317402,JAKARTA SELATAN,SETIA BUDI,11625,112,11259,178,76,188,2021-08-30
317304,JAKARTA BARAT,TAMBORA,13997,25,13701,238,33,58,2021-08-30
317107,JAKARTA PUSAT,TANAH ABANG,10943,31,10652,216,44,75,2021-08-30
111111,Luar DKI & Proses Update,Luar DKI & Proses Update,143008,137,141294,1273,304,441,2021-08-30
317403,JAKARTA SELATAN,MAMPANG PRAPATAN,11393,28,11101,178,86,114,2021-08-30
317202,JAKARTA UTARA,TANJUNG PRIOK,25447,41,24879,418,109,150,2021-08-30
317502,JAKARTA TIMUR,PULO GADUNG,21572,41,21052,389,90,131,2021-08-30
317508,JAKARTA TIMUR,MAKASAR,17348,33,16957,289,69,102,2021-08-30
317204,JAKARTA UTARA,CILINCING,17040,39,16584,336,81,120,2021-08-30
317203,JAKARTA UTARA,KOJA,16995,38,16555,334,68,106,2021-08-30
317301,JAKARTA BARAT,CENGKARENG,28301,60,27609,545,87,147,2021-08-30
317105,JAKARTA PUSAT,CEMPAKA PUTIH,10381,11,10145,164,61,72,2021-08-30
317506,JAKARTA TIMUR,CAKUNG,22408,55,21863,396,94,149,2021-08-30
317504,JAKARTA TIMUR,KRAMAT JATI,21438,45,20881,394,118,163,2021-08-30
317510,JAKARTA TIMUR,CIPAYUNG,24937,56,24449,261,171,227,2021-08-30
317509,JAKARTA TIMUR,CIRACAS,22202,43,21642,368,149,192,2021-08-30
317507,JAKARTA TIMUR,DUREN SAWIT,29135,67,28243,595,230,297,2021-08-30
317101,JAKARTA PUSAT,GAMBIR,8464,25,8278,129,32,57,2021-08-30
317302,JAKARTA BARAT,GROGOL PETAMBURAN,18954,23,18590,297,44,67,2021-08-30
317409,JAKARTA SELATAN,JAGAKARSA,26327,57,25703,397,170,227,2021-08-30
317406,JAKARTA SELATAN,CILANDAK,17466,45,17059,254,108,153,2021-08-30
317108,JAKARTA PUSAT,JOHAR BARU,8609,16,8414,156,23,39,2021-08-30
317503,JAKARTA TIMUR,JATINEGARA,19329,29,18834,376,90,119,2021-08-30
310102,KAB.ADM.KEP.SERIBU,KEP. SERIBU SELATAN,700,0,689,10,1,1,2021-08-30
310101,KAB.ADM.KEP.SERIBU,KEP. SERIBU UTARA,627,0,620,6,1,1,2021-08-30
317206,JAKARTA UTARA,KELAPA GADING,12450,17,12189,190,54,71,2021-08-30
317308,JAKARTA BARAT,KEMBANGAN,20075,45,19625,291,114,159,2021-08-30
317405,JAKARTA SELATAN,KEBAYORAN LAMA,19856,58,19368,350,80,138,2021-08-30
317407,JAKARTA SELATAN,KEBAYORAN BARU,13666,36,13373,180,77,113,2021-08-30
317306,JAKARTA BARAT,KALI DERES,17822,33,17430,306,53,86,2021-08-30
317305,JAKARTA BARAT,KEBON JERUK,21902,59,21407,357,79,138,2021-08-30
317103,JAKARTA PUSAT,KEMAYORAN,19656,77,19079,368,132,209,2021-08-30
317106,JAKARTA PUSAT,MENTENG,6384,17,6232,118,17,34,2021-08-31
317203,JAKARTA UTARA,KOJA,17001,38,16557,335,71,109,2021-08-31
317504,JAKARTA TIMUR,KRAMAT JATI,21443,42,20895,394,112,154,2021-08-31
317508,JAKARTA TIMUR,MAKASAR,17352,34,16963,290,65,99,2021-08-31
317403,JAKARTA SELATAN,MAMPANG PRAPATAN,11394,28,11106,178,82,110,2021-08-31
317501,JAKARTA TIMUR,MATRAMAN,14111,25,13774,274,38,63,2021-08-31
317505,JAKARTA TIMUR,PASAR REBO,17523,33,17096,321,73,106,2021-08-31
317307,JAKARTA BARAT,PALMERAH,15704,34,15308,318,44,78,2021-08-31
317408,JAKARTA SELATAN,PANCORAN,14195,20,13882,224,69,89,2021-08-31
317404,JAKARTA SELATAN,PASAR MINGGU,23515,49,22913,416,137,186,2021-08-31
310101,KAB.ADM.KEP.SERIBU,KEP. SERIBU UTARA,627,0,620,6,1,1,2021-08-31
317201,JAKARTA UTARA,PENJARINGAN,18375,29,18035,228,83,112,2021-08-31
317410,JAKARTA SELATAN,PESANGGRAHAN,16187,30,15800,248,109,139,2021-08-31
317502,JAKARTA TIMUR,PULO GADUNG,21584,47,21065,389,83,130,2021-08-31
317104,JAKARTA PUSAT,SENEN,9291,13,9086,166,26,39,2021-08-31
317205,JAKARTA UTARA,PADEMANGAN,12433,25,11939,161,308,333,2021-08-31
310102,KAB.ADM.KEP.SERIBU,KEP. SERIBU SELATAN,700,0,689,10,1,1,2021-08-31
317305,JAKARTA BARAT,KEBON JERUK,21907,49,21421,358,79,128,2021-08-31
317103,JAKARTA PUSAT,KEMAYORAN,19664,83,19088,368,125,208,2021-08-31
317102,JAKARTA PUSAT,SAWAH BESAR,8997,31,8750,167,49,80,2021-08-31
111111,Luar DKI & Proses Update,Luar DKI & Proses Update,143008,137,141294,1273,304,441,2021-08-31
317506,JAKARTA TIMUR,CAKUNG,22412,54,21868,400,90,144,2021-08-31
317105,JAKARTA PUSAT,CEMPAKA PUTIH,10382,10,10148,164,60,70,2021-08-31
317301,JAKARTA BARAT,CENGKARENG,28308,59,27621,545,83,142,2021-08-31
317406,JAKARTA SELATAN,CILANDAK,17478,42,17068,256,112,154,2021-08-31
317204,JAKARTA UTARA,CILINCING,17045,38,16590,336,81,119,2021-08-31
317510,JAKARTA TIMUR,CIPAYUNG,24940,50,24459,262,169,219,2021-08-31
317308,JAKARTA BARAT,KEMBANGAN,20083,42,19631,291,119,161,2021-08-31
317509,JAKARTA TIMUR,CIRACAS,22204,40,21650,369,145,185,2021-08-31
317101,JAKARTA PUSAT,GAMBIR,8466,24,8283,129,30,54,2021-08-31
317302,JAKARTA BARAT,GROGOL PETAMBURAN,18960,26,18591,297,46,72,2021-08-31
317503,JAKARTA TIMUR,JATINEGARA,19334,28,18848,376,82,110,2021-08-31
317108,JAKARTA PUSAT,JOHAR BARU,8612,15,8415,156,26,41,2021-08-31
317306,JAKARTA BARAT,KALI DERES,17829,34,17437,306,52,86,2021-08-31
317407,JAKARTA SELATAN,KEBAYORAN BARU,13671,32,13381,181,77,109,2021-08-31
317405,JAKARTA SELATAN,KEBAYORAN LAMA,19864,59,19376,351,78,137,2021-08-31
317206,JAKARTA UTARA,KELAPA GADING,12453,20,12193,190,50,70,2021-08-31
317507,JAKARTA TIMUR,DUREN SAWIT,29149,64,28254,597,234,298,2021-08-31
317409,JAKARTA SELATAN,JAGAKARSA,26344,55,25723,398,168,223,2021-08-31
317402,JAKARTA SELATAN,SETIA BUDI,11636,116,11271,178,71,187,2021-08-31
317303,JAKARTA BARAT,TAMAN SARI,8681,23,8504,137,17,40,2021-08-31
317304,JAKARTA BARAT,TAMBORA,14000,24,13708,239,29,53,2021-08-31
317107,JAKARTA PUSAT,TANAH ABANG,10944,28,10659,216,41,69,2021-08-31
317202,JAKARTA UTARA,TANJUNG PRIOK,25453,39,24887,418,109,148,2021-08-31
317401,JAKARTA SELATAN,TEBET,16798,37,16419,274,68,105,2021-08-31
317307,JAKARTA BARAT,PALMERAH,15712,31,15327,318,36,67,2021-09-01
317403,JAKARTA SELATAN,MAMPANG PRAPATAN,11402,28,11131,178,65,93,2021-09-01
317501,JAKARTA TIMUR,MATRAMAN,14119,30,13783,274,32,62,2021-09-01
317106,JAKARTA PUSAT,MENTENG,6385,17,6236,118,14,31,2021-09-01
317205,JAKARTA UTARA,PADEMANGAN,12443,25,11969,161,288,313,2021-09-01
317408,JAKARTA SELATAN,PANCORAN,14198,21,13893,224,60,81,2021-09-01
317404,JAKARTA SELATAN,PASAR MINGGU,23535,52,22940,416,127,179,2021-09-01
317505,JAKARTA TIMUR,PASAR REBO,17532,33,17115,321,63,96,2021-09-01
317201,JAKARTA UTARA,PENJARINGAN,18389,32,18043,228,86,118,2021-09-01
317410,JAKARTA SELATAN,PESANGGRAHAN,16194,29,15813,248,104,133,2021-09-01
317104,JAKARTA PUSAT,SENEN,9297,18,9088,166,25,43,2021-09-01
317102,JAKARTA PUSAT,SAWAH BESAR,9012,39,8764,167,42,81,2021-09-01
317508,JAKARTA TIMUR,MAKASAR,17361,35,16985,291,50,85,2021-09-01
317402,JAKARTA SELATAN,SETIA BUDI,11666,138,11289,178,61,199,2021-09-01
317303,JAKARTA BARAT,TAMAN SARI,8684,22,8510,137,15,37,2021-09-01
317304,JAKARTA BARAT,TAMBORA,14008,22,13720,240,26,48,2021-09-01
317107,JAKARTA PUSAT,TANAH ABANG,10949,28,10667,216,38,66,2021-09-01
317202,JAKARTA UTARA,TANJUNG PRIOK,25461,32,24918,418,93,125,2021-09-01
317401,JAKARTA SELATAN,TEBET,16808,30,16439,275,64,94,2021-09-01
111111,Luar DKI & Proses Update,Luar DKI & Proses Update,143008,137,141294,1273,304,441,2021-09-01
317502,JAKARTA TIMUR,PULO GADUNG,21602,47,21093,390,72,119,2021-09-01
317203,JAKARTA UTARA,KOJA,17005,34,16577,335,59,93,2021-09-01
317504,JAKARTA TIMUR,KRAMAT JATI,21454,43,20912,394,105,148,2021-09-01
310102,KAB.ADM.KEP.SERIBU,KEP. SERIBU SELATAN,700,0,689,10,1,1,2021-09-01
317506,JAKARTA TIMUR,CAKUNG,22419,52,21892,400,75,127,2021-09-01
317105,JAKARTA PUSAT,CEMPAKA PUTIH,10387,11,10159,164,53,64,2021-09-01
317301,JAKARTA BARAT,CENGKARENG,28317,57,27642,545,73,130,2021-09-01
317406,JAKARTA SELATAN,CILANDAK,17505,44,17090,256,115,159,2021-09-01
317204,JAKARTA UTARA,CILINCING,17055,40,16611,336,68,108,2021-09-01
317510,JAKARTA TIMUR,CIPAYUNG,24947,46,24495,262,144,190,2021-09-01
317509,JAKARTA TIMUR,CIRACAS,22209,41,21682,369,117,158,2021-09-01
310101,KAB.ADM.KEP.SERIBU,KEP. SERIBU UTARA,627,0,621,6,0,0,2021-09-01
317101,JAKARTA PUSAT,GAMBIR,8474,19,8297,129,29,48,2021-09-01
317302,JAKARTA BARAT,GROGOL PETAMBURAN,18974,32,18600,297,45,77,2021-09-01
317409,JAKARTA SELATAN,JAGAKARSA,26360,52,25765,399,144,196,2021-09-01
317507,JAKARTA TIMUR,DUREN SAWIT,29163,62,28296,597,208,270,2021-09-01
317108,JAKARTA PUSAT,JOHAR BARU,8614,12,8419,157,26,38,2021-09-01
317503,JAKARTA TIMUR,JATINEGARA,19339,29,18863,377,70,99,2021-09-01
317103,JAKARTA PUSAT,KEMAYORAN,19674,73,19115,368,118,191,2021-09-01
317206,JAKARTA UTARA,KELAPA GADING,12463,20,12206,190,47,67,2021-09-01
317305,JAKARTA BARAT,KEBON JERUK,21916,51,21436,360,69,120,2021-09-01
317308,JAKARTA BARAT,KEMBANGAN,20088,40,19668,292,88,128,2021-09-01
317407,JAKARTA SELATAN,KEBAYORAN BARU,13686,40,13409,181,56,96,2021-09-01
317306,JAKARTA BARAT,KALI DERES,17833,27,17450,306,50,77,2021-09-01
317405,JAKARTA SELATAN,KEBAYORAN LAMA,19875,56,19397,351,71,127,2021-09-01
317508,JAKARTA TIMUR,MAKASAR,17367,34,16994,291,48,82,2021-09-02
317202,JAKARTA UTARA,TANJUNG PRIOK,25466,32,24933,418,83,115,2021-09-02
317401,JAKARTA SELATAN,TEBET,16814,26,16450,275,63,89,2021-09-02
111111,Luar DKI & Proses Update,Luar DKI & Proses Update,143008,137,141294,1273,304,441,2021-09-02
317307,JAKARTA BARAT,PALMERAH,15716,30,15339,318,29,59,2021-09-02
317501,JAKARTA TIMUR,MATRAMAN,14127,30,13788,274,35,65,2021-09-02
317106,JAKARTA PUSAT,MENTENG,6393,17,6239,118,19,36,2021-09-02
317205,JAKARTA UTARA,PADEMANGAN,12445,21,11977,161,286,307,2021-09-02
317408,JAKARTA SELATAN,PANCORAN,14206,21,13907,224,54,75,2021-09-02
317304,JAKARTA BARAT,TAMBORA,14012,19,13726,240,27,46,2021-09-02
317505,JAKARTA TIMUR,PASAR REBO,17535,31,17122,321,61,92,2021-09-02
317201,JAKARTA UTARA,PENJARINGAN,18396,34,18059,228,75,109,2021-09-02
317410,JAKARTA SELATAN,PESANGGRAHAN,16198,30,15825,248,95,125,2021-09-02
317502,JAKARTA TIMUR,PULO GADUNG,21610,49,21113,390,58,107,2021-09-02
317102,JAKARTA PUSAT,SAWAH BESAR,9013,27,8780,168,38,65,2021-09-02
317104,JAKARTA PUSAT,SENEN,9298,17,9102,166,13,30,2021-09-02
317402,JAKARTA SELATAN,SETIA BUDI,11674,131,11312,179,52,183,2021-09-02
317107,JAKARTA PUSAT,TANAH ABANG,10955,26,10674,216,39,65,2021-09-02
317504,JAKARTA TIMUR,KRAMAT JATI,21458,35,20942,395,86,121,2021-09-02
317404,JAKARTA SELATAN,PASAR MINGGU,23538,44,22957,416,121,165,2021-09-02
317203,JAKARTA UTARA,KOJA,17011,31,16595,335,50,81,2021-09-02
317403,JAKARTA SELATAN,MAMPANG PRAPATAN,11411,26,11151,178,56,82,2021-09-02
310102,KAB.ADM.KEP.SERIBU,KEP. SERIBU SELATAN,700,0,690,10,0,0,2021-09-02
310101,KAB.ADM.KEP.SERIBU,KEP. SERIBU UTARA,627,0,621,6,0,0,2021-09-02
317506,JAKARTA TIMUR,CAKUNG,22429,49,21918,400,62,111,2021-09-02
317105,JAKARTA PUSAT,CEMPAKA PUTIH,10392,10,10175,165,42,52,2021-09-02
317301,JAKARTA BARAT,CENGKARENG,28352,49,27659,545,99,148,2021-09-02
317406,JAKARTA SELATAN,CILANDAK,17515,38,17120,257,100,138,2021-09-02
317204,JAKARTA UTARA,CILINCING,17067,42,16622,336,67,109,2021-09-02
317510,JAKARTA TIMUR,CIPAYUNG,24961,39,24532,263,127,166,2021-09-02
317509,JAKARTA TIMUR,CIRACAS,22219,42,21709,370,98,140,2021-09-02
317507,JAKARTA TIMUR,DUREN SAWIT,29192,61,28328,597,206,267,2021-09-02
317101,JAKARTA PUSAT,GAMBIR,8476,12,8309,129,26,38,2021-09-02
317302,JAKARTA BARAT,GROGOL PETAMBURAN,18980,32,18610,298,40,72,2021-09-02
317303,JAKARTA BARAT,TAMAN SARI,8691,21,8516,137,17,38,2021-09-02
317503,JAKARTA TIMUR,JATINEGARA,19344,29,18880,377,58,87,2021-09-02
317409,JAKARTA SELATAN,JAGAKARSA,26372,45,25800,400,127,172,2021-09-02
317103,JAKARTA PUSAT,KEMAYORAN,19685,73,19134,368,110,183,2021-09-02
317206,JAKARTA UTARA,KELAPA GADING,12466,21,12217,190,38,59,2021-09-02
317305,JAKARTA BARAT,KEBON JERUK,21919,47,21448,361,63,110,2021-09-02
317308,JAKARTA BARAT,KEMBANGAN,20092,34,19692,292,74,108,2021-09-02
317407,JAKARTA SELATAN,KEBAYORAN BARU,13694,39,13421,181,53,92,2021-09-02
317108,JAKARTA PUSAT,JOHAR BARU,8616,9,8426,157,24,33,2021-09-02
317306,JAKARTA BARAT,KALI DERES,17838,27,17462,306,43,70,2021-09-02
317405,JAKARTA SELATAN,KEBAYORAN LAMA,19883,53,19414,351,65,118,2021-09-02
317202,JAKARTA UTARA,TANJUNG PRIOK,25471,29,24943,418,81,110,2021-09-03
317203,JAKARTA UTARA,KOJA,17017,21,16616,335,45,66,2021-09-03
317504,JAKARTA TIMUR,KRAMAT JATI,21466,32,20956,395,83,115,2021-09-03
317508,JAKARTA TIMUR,MAKASAR,17369,29,17011,291,38,67,2021-09-03
317403,JAKARTA SELATAN,MAMPANG PRAPATAN,11414,22,11164,178,50,72,2021-09-03
317501,JAKARTA TIMUR,MATRAMAN,14132,28,13800,274,30,58,2021-09-03
317205,JAKARTA UTARA,PADEMANGAN,12451,18,12034,162,237,255,2021-09-03
317307,JAKARTA BARAT,PALMERAH,15721,30,15346,318,27,57,2021-09-03
317408,JAKARTA SELATAN,PANCORAN,14210,21,13924,225,40,61,2021-09-03
317505,JAKARTA TIMUR,PASAR REBO,17537,23,17143,321,50,73,2021-09-03
317201,JAKARTA UTARA,PENJARINGAN,18404,39,18064,228,73,112,2021-09-03
317410,JAKARTA SELATAN,PESANGGRAHAN,16208,27,15851,248,82,109,2021-09-03
317102,JAKARTA PUSAT,SAWAH BESAR,9019,28,8783,168,40,68,2021-09-03
317104,JAKARTA PUSAT,SENEN,9300,17,9105,166,12,29,2021-09-03
317402,JAKARTA SELATAN,SETIA BUDI,11690,143,11325,179,43,186,2021-09-03
317303,JAKARTA BARAT,TAMAN SARI,8694,21,8518,137,18,39,2021-09-03
317304,JAKARTA BARAT,TAMBORA,14012,17,13728,240,27,44,2021-09-03
317107,JAKARTA PUSAT,TANAH ABANG,10960,20,10685,217,38,58,2021-09-03
317401,JAKARTA SELATAN,TEBET,16821,23,16466,275,57,80,2021-09-03
317404,JAKARTA SELATAN,PASAR MINGGU,23542,40,22978,416,108,148,2021-09-03
317502,JAKARTA TIMUR,PULO GADUNG,21616,52,21128,390,46,98,2021-09-03
317106,JAKARTA PUSAT,MENTENG,6393,14,6243,118,18,32,2021-09-03
317308,JAKARTA BARAT,KEMBANGAN,20097,31,19717,292,57,88,2021-09-03
310102,KAB.ADM.KEP.SERIBU,KEP. SERIBU SELATAN,700,0,690,10,0,0,2021-09-03
111111,Luar DKI & Proses Update,Luar DKI & Proses Update,143008,137,141294,1273,304,441,2021-09-03
317506,JAKARTA TIMUR,CAKUNG,22434,50,21930,400,54,104,2021-09-03
317105,JAKARTA PUSAT,CEMPAKA PUTIH,10393,11,10185,165,32,43,2021-09-03
317301,JAKARTA BARAT,CENGKARENG,28359,51,27668,545,95,146,2021-09-03
317406,JAKARTA SELATAN,CILANDAK,17526,36,17137,258,95,131,2021-09-03
317204,JAKARTA UTARA,CILINCING,17072,40,16634,336,62,102,2021-09-03
317510,JAKARTA TIMUR,CIPAYUNG,24970,38,24548,263,121,159,2021-09-03
317509,JAKARTA TIMUR,CIRACAS,22235,38,21744,371,82,120,2021-09-03
317507,JAKARTA TIMUR,DUREN SAWIT,29198,50,28364,598,186,236,2021-09-03
310101,KAB.ADM.KEP.SERIBU,KEP. SERIBU UTARA,627,0,621,6,0,0,2021-09-03
317302,JAKARTA BARAT,GROGOL PETAMBURAN,18983,31,18617,298,37,68,2021-09-03
317101,JAKARTA PUSAT,GAMBIR,8479,10,8314,129,26,36,2021-09-03
317206,JAKARTA UTARA,KELAPA GADING,12467,17,12230,190,30,47,2021-09-03
317305,JAKARTA BARAT,KEBON JERUK,21928,46,21466,362,54,100,2021-09-03
317405,JAKARTA SELATAN,KEBAYORAN LAMA,19885,47,19426,351,61,108,2021-09-03
317103,JAKARTA PUSAT,KEMAYORAN,19693,69,19158,368,98,167,2021-09-03
317306,JAKARTA BARAT,KALI DERES,17840,21,17474,307,38,59,2021-09-03
317108,JAKARTA PUSAT,JOHAR BARU,8619,8,8439,157,15,23,2021-09-03
317503,JAKARTA TIMUR,JATINEGARA,19351,30,18895,377,49,79,2021-09-03
317409,JAKARTA SELATAN,JAGAKARSA,26377,39,25820,400,118,157,2021-09-03
317407,JAKARTA SELATAN,KEBAYORAN BARU,13699,39,13427,182,51,90,2021-09-03
317108,JAKARTA PUSAT,JOHAR BARU,8619,8,8439,157,15,23,2021-09-04
317308,JAKARTA BARAT,KEMBANGAN,20099,25,19730,292,52,77,2021-09-04
317103,JAKARTA PUSAT,KEMAYORAN,19701,66,19175,368,92,158,2021-09-04
317206,JAKARTA UTARA,KELAPA GADING,12470,17,12235,190,28,45,2021-09-04
317305,JAKARTA BARAT,KEBON JERUK,21936,46,21479,362,49,95,2021-09-04
317405,JAKARTA SELATAN,KEBAYORAN LAMA,19891,45,19434,353,59,104,2021-09-04
317407,JAKARTA SELATAN,KEBAYORAN BARU,13706,35,13435,182,54,89,2021-09-04
317306,JAKARTA BARAT,KALI DERES,17844,21,17478,307,38,59,2021-09-04
317503,JAKARTA TIMUR,JATINEGARA,19355,29,18902,377,47,76,2021-09-04
317510,JAKARTA TIMUR,CIPAYUNG,24984,33,24557,263,131,164,2021-09-04
317302,JAKARTA BARAT,GROGOL PETAMBURAN,18983,30,18624,298,31,61,2021-09-04
317101,JAKARTA PUSAT,GAMBIR,8481,11,8317,129,24,35,2021-09-04
317507,JAKARTA TIMUR,DUREN SAWIT,29218,45,28376,599,198,243,2021-09-04
317509,JAKARTA TIMUR,CIRACAS,22249,37,21750,371,91,128,2021-09-04
317204,JAKARTA UTARA,CILINCING,17077,40,16637,336,64,104,2021-09-04
317406,JAKARTA SELATAN,CILANDAK,17532,35,17146,259,92,127,2021-09-04
317301,JAKARTA BARAT,CENGKARENG,28362,47,27674,547,94,141,2021-09-04
317105,JAKARTA PUSAT,CEMPAKA PUTIH,10396,13,10190,165,28,41,2021-09-04
317506,JAKARTA TIMUR,CAKUNG,22442,46,21935,400,61,107,2021-09-04
317409,JAKARTA SELATAN,JAGAKARSA,26399,41,25830,400,128,169,2021-09-04
310102,KAB.ADM.KEP.SERIBU,KEP. SERIBU SELATAN,700,0,690,10,0,0,2021-09-04
310101,KAB.ADM.KEP.SERIBU,KEP. SERIBU UTARA,629,1,621,6,1,2,2021-09-04
317504,JAKARTA TIMUR,KRAMAT JATI,21471,32,20962,395,82,114,2021-09-04
111111,Luar DKI & Proses Update,Luar DKI & Proses Update,143008,137,141294,1273,304,441,2021-09-04
317401,JAKARTA SELATAN,TEBET,16827,19,16472,275,61,80,2021-09-04
317202,JAKARTA UTARA,TANJUNG PRIOK,25480,29,24950,418,83,112,2021-09-04
317107,JAKARTA PUSAT,TANAH ABANG,10954,17,10690,218,29,46,2021-09-04
317304,JAKARTA BARAT,TAMBORA,14017,16,13730,241,30,46,2021-09-04
317303,JAKARTA BARAT,TAMAN SARI,8697,18,8524,137,18,36,2021-09-04
317203,JAKARTA UTARA,KOJA,17024,20,16623,335,46,66,2021-09-04
317104,JAKARTA PUSAT,SENEN,9303,14,9109,166,14,28,2021-09-04
317102,JAKARTA PUSAT,SAWAH BESAR,9020,26,8788,168,38,64,2021-09-04
317502,JAKARTA TIMUR,PULO GADUNG,21618,47,21134,390,47,94,2021-09-04
317402,JAKARTA SELATAN,SETIA BUDI,11709,153,11339,179,38,191,2021-09-04
317201,JAKARTA UTARA,PENJARINGAN,18409,36,18068,228,77,113,2021-09-04
317505,JAKARTA TIMUR,PASAR REBO,17546,22,17152,322,50,72,2021-09-04
317404,JAKARTA SELATAN,PASAR MINGGU,23556,38,22992,416,110,148,2021-09-04
317408,JAKARTA SELATAN,PANCORAN,14214,19,13933,225,37,56,2021-09-04
317307,JAKARTA BARAT,PALMERAH,15723,23,15354,319,27,50,2021-09-04
317205,JAKARTA UTARA,PADEMANGAN,12476,19,12037,162,258,277,2021-09-04
317106,JAKARTA PUSAT,MENTENG,6394,12,6247,118,17,29,2021-09-04
317501,JAKARTA TIMUR,MATRAMAN,14134,23,13807,274,30,53,2021-09-04
317403,JAKARTA SELATAN,MAMPANG PRAPATAN,11414,18,11169,178,49,67,2021-09-04
317410,JAKARTA SELATAN,PESANGGRAHAN,16214,26,15856,248,84,110,2021-09-04
317508,JAKARTA TIMUR,MAKASAR,17373,27,17018,291,37,64,2021-09-04
317201,JAKARTA UTARA,PENJARINGAN,18416,39,18071,228,78,117,2021-09-05
317505,JAKARTA TIMUR,PASAR REBO,17550,21,17159,323,47,68,2021-09-05
317404,JAKARTA SELATAN,PASAR MINGGU,23563,38,23003,416,106,144,2021-09-05
317501,JAKARTA TIMUR,MATRAMAN,14141,20,13811,274,36,56,2021-09-05
317307,JAKARTA BARAT,PALMERAH,15726,25,15355,319,27,52,2021-09-05
317205,JAKARTA UTARA,PADEMANGAN,12486,18,12076,162,230,248,2021-09-05
317106,JAKARTA PUSAT,MENTENG,6395,11,6250,118,16,27,2021-09-05
317408,JAKARTA SELATAN,PANCORAN,14216,18,13935,225,38,56,2021-09-05
317410,JAKARTA SELATAN,PESANGGRAHAN,16217,24,15860,248,85,109,2021-09-05
111111,Luar DKI & Proses Update,Luar DKI & Proses Update,143008,137,141294,1273,304,441,2021-09-05
317102,JAKARTA PUSAT,SAWAH BESAR,9028,30,8795,168,35,65,2021-09-05
317104,JAKARTA PUSAT,SENEN,9305,15,9111,166,13,28,2021-09-05
317402,JAKARTA SELATAN,SETIA BUDI,11711,140,11357,180,34,174,2021-09-05
317303,JAKARTA BARAT,TAMAN SARI,8702,18,8525,137,22,40,2021-09-05
317304,JAKARTA BARAT,TAMBORA,14023,18,13731,242,32,50,2021-09-05
317107,JAKARTA PUSAT,TANAH ABANG,10955,17,10692,218,28,45,2021-09-05
317202,JAKARTA UTARA,TANJUNG PRIOK,25490,33,24955,418,84,117,2021-09-05
317401,JAKARTA SELATAN,TEBET,16830,21,16475,275,59,80,2021-09-05
317403,JAKARTA SELATAN,MAMPANG PRAPATAN,11415,16,11172,178,49,65,2021-09-05
317502,JAKARTA TIMUR,PULO GADUNG,21623,41,21141,391,50,91,2021-09-05
317508,JAKARTA TIMUR,MAKASAR,17379,23,17023,291,42,65,2021-09-05
317108,JAKARTA PUSAT,JOHAR BARU,8620,9,8439,157,15,24,2021-09-05
310101,KAB.ADM.KEP.SERIBU,KEP. SERIBU UTARA,628,0,621,6,1,1,2021-09-05
317506,JAKARTA TIMUR,CAKUNG,22448,46,21937,400,65,111,2021-09-05
317105,JAKARTA PUSAT,CEMPAKA PUTIH,10399,12,10192,165,30,42,2021-09-05
317301,JAKARTA BARAT,CENGKARENG,28367,43,27678,548,98,141,2021-09-05
317406,JAKARTA SELATAN,CILANDAK,17534,34,17151,259,90,124,2021-09-05
317204,JAKARTA UTARA,CILINCING,17089,44,16640,336,69,113,2021-09-05
317510,JAKARTA TIMUR,CIPAYUNG,25000,31,24559,263,147,178,2021-09-05
317509,JAKARTA TIMUR,CIRACAS,22262,38,21752,371,101,139,2021-09-05
317507,JAKARTA TIMUR,DUREN SAWIT,29225,47,28380,600,198,245,2021-09-05
317101,JAKARTA PUSAT,GAMBIR,8482,9,8320,129,24,33,2021-09-05
317203,JAKARTA UTARA,KOJA,17029,19,16627,335,48,67,2021-09-05
317302,JAKARTA BARAT,GROGOL PETAMBURAN,18988,30,18625,298,35,65,2021-09-05
317503,JAKARTA TIMUR,JATINEGARA,19359,30,18903,377,49,79,2021-09-05
317306,JAKARTA BARAT,KALI DERES,17846,21,17481,307,37,58,2021-09-05
317407,JAKARTA SELATAN,KEBAYORAN BARU,13709,35,13442,182,50,85,2021-09-05
317405,JAKARTA SELATAN,KEBAYORAN LAMA,19897,43,19443,354,57,100,2021-09-05
317305,JAKARTA BARAT,KEBON JERUK,21939,44,21484,363,48,92,2021-09-05
317206,JAKARTA UTARA,KELAPA GADING,12474,16,12237,190,31,47,2021-09-05
317103,JAKARTA PUSAT,KEMAYORAN,19707,59,19183,369,96,155,2021-09-05
317308,JAKARTA BARAT,KEMBANGAN,20108,26,19734,293,55,81,2021-09-05
310102,KAB.ADM.KEP.SERIBU,KEP. SERIBU SELATAN,700,0,690,10,0,0,2021-09-05
317409,JAKARTA SELATAN,JAGAKARSA,26401,37,25840,400,124,161,2021-09-05
317504,JAKARTA TIMUR,KRAMAT JATI,21481,32,20970,395,84,116,2021-09-05
317305,JAKARTA BARAT,KEBON JERUK,21944,40,21508,363,33,73,2021-09-06
317506,JAKARTA TIMUR,CAKUNG,22450,40,21952,400,58,98,2021-09-06
317501,JAKARTA TIMUR,MATRAMAN,14143,17,13819,275,32,49,2021-09-06
317205,JAKARTA UTARA,PADEMANGAN,12467,18,12088,162,199,217,2021-09-06
317307,JAKARTA BARAT,PALMERAH,15728,20,15365,320,23,43,2021-09-06
317408,JAKARTA SELATAN,PANCORAN,14217,15,13945,226,31,46,2021-09-06
317404,JAKARTA SELATAN,PASAR MINGGU,23583,39,23025,416,103,142,2021-09-06
317505,JAKARTA TIMUR,PASAR REBO,17553,21,17172,323,37,58,2021-09-06
317201,JAKARTA UTARA,PENJARINGAN,18417,37,18077,228,75,112,2021-09-06
317410,JAKARTA SELATAN,PESANGGRAHAN,16219,22,15868,248,81,103,2021-09-06
317502,JAKARTA TIMUR,PULO GADUNG,21630,40,21153,393,44,84,2021-09-06
317102,JAKARTA PUSAT,SAWAH BESAR,9034,27,8804,168,35,62,2021-09-06
317104,JAKARTA PUSAT,SENEN,9305,12,9115,166,12,24,2021-09-06
317402,JAKARTA SELATAN,SETIA BUDI,11717,132,11376,180,29,161,2021-09-06
317303,JAKARTA BARAT,TAMAN SARI,8704,18,8527,138,21,39,2021-09-06
317304,JAKARTA BARAT,TAMBORA,14022,18,13734,244,26,44,2021-09-06
317107,JAKARTA PUSAT,TANAH ABANG,10959,19,10702,218,20,39,2021-09-06
317202,JAKARTA UTARA,TANJUNG PRIOK,25491,32,24980,418,61,93,2021-09-06
317401,JAKARTA SELATAN,TEBET,16833,17,16485,276,55,72,2021-09-06
317405,JAKARTA SELATAN,KEBAYORAN LAMA,19904,41,19456,354,53,94,2021-09-06
317407,JAKARTA SELATAN,KEBAYORAN BARU,13713,30,13457,182,44,74,2021-09-06
317403,JAKARTA SELATAN,MAMPANG PRAPATAN,11420,15,11180,178,47,62,2021-09-06
317508,JAKARTA TIMUR,MAKASAR,17381,23,17030,292,36,59,2021-09-06
317106,JAKARTA PUSAT,MENTENG,6396,10,6253,118,15,25,2021-09-06
317203,JAKARTA UTARA,KOJA,17030,18,16634,337,41,59,2021-09-06
317105,JAKARTA PUSAT,CEMPAKA PUTIH,10401,11,10200,165,25,36,2021-09-06
317301,JAKARTA BARAT,CENGKARENG,28371,38,27699,548,86,124,2021-09-06
317406,JAKARTA SELATAN,CILANDAK,17538,31,17166,259,82,113,2021-09-06
317204,JAKARTA UTARA,CILINCING,17085,43,16651,336,55,98,2021-09-06
317510,JAKARTA TIMUR,CIPAYUNG,25010,28,24595,264,123,151,2021-09-06
317509,JAKARTA TIMUR,CIRACAS,22266,35,21769,372,90,125,2021-09-06
317504,JAKARTA TIMUR,KRAMAT JATI,21485,28,20993,396,68,96,2021-09-06
317101,JAKARTA PUSAT,GAMBIR,8482,7,8328,129,18,25,2021-09-06
317302,JAKARTA BARAT,GROGOL PETAMBURAN,18990,29,18631,298,32,61,2021-09-06
317409,JAKARTA SELATAN,JAGAKARSA,26406,37,25853,400,116,153,2021-09-06
317507,JAKARTA TIMUR,DUREN SAWIT,29227,40,28447,601,139,179,2021-09-06
317108,JAKARTA PUSAT,JOHAR BARU,8622,10,8439,157,16,26,2021-09-06
317306,JAKARTA BARAT,KALI DERES,17849,20,17491,307,31,51,2021-09-06
111111,Luar DKI & Proses Update,Luar DKI & Proses Update,143008,137,141294,1273,304,441,2021-09-06
317206,JAKARTA UTARA,KELAPA GADING,12476,16,12238,191,31,47,2021-09-06
317103,JAKARTA PUSAT,KEMAYORAN,19718,55,19204,369,90,145,2021-09-06
317308,JAKARTA BARAT,KEMBANGAN,20113,24,19744,293,52,76,2021-09-06
310102,KAB.ADM.KEP.SERIBU,KEP. SERIBU SELATAN,700,0,690,10,0,0,2021-09-06
310101,KAB.ADM.KEP.SERIBU,KEP. SERIBU UTARA,628,0,621,6,1,1,2021-09-06
317503,JAKARTA TIMUR,JATINEGARA,19362,30,18918,377,37,67,2021-09-06
317510,JAKARTA TIMUR,CIPAYUNG,25014,22,24612,264,116,138,2021-09-07
317204,JAKARTA UTARA,CILINCING,17091,42,16664,337,48,90,2021-09-07
317105,JAKARTA PUSAT,CEMPAKA PUTIH,10404,12,10204,165,23,35,2021-09-07
317301,JAKARTA BARAT,CENGKARENG,28375,39,27706,550,80,119,2021-09-07
317509,JAKARTA TIMUR,CIRACAS,22270,36,21781,372,81,117,2021-09-07
317506,JAKARTA TIMUR,CAKUNG,22457,39,21965,401,52,91,2021-09-07
317406,JAKARTA SELATAN,CILANDAK,17541,31,17173,259,78,109,2021-09-07
317507,JAKARTA TIMUR,DUREN SAWIT,29230,36,28467,601,126,162,2021-09-07
317305,JAKARTA BARAT,KEBON JERUK,21950,38,21514,364,34,72,2021-09-07
317302,JAKARTA BARAT,GROGOL PETAMBURAN,18992,29,18635,298,30,59,2021-09-07
317404,JAKARTA SELATAN,PASAR MINGGU,23587,36,23044,417,90,126,2021-09-07
317505,JAKARTA TIMUR,PASAR REBO,17553,16,17184,323,30,46,2021-09-07
317201,JAKARTA UTARA,PENJARINGAN,18424,38,18093,228,65,103,2021-09-07
317410,JAKARTA SELATAN,PESANGGRAHAN,16222,19,15883,248,72,91,2021-09-07
317502,JAKARTA TIMUR,PULO GADUNG,21637,46,21160,394,37,83,2021-09-07
317102,JAKARTA PUSAT,SAWAH BESAR,9040,27,8806,169,38,65,2021-09-07
317408,JAKARTA SELATAN,PANCORAN,14217,12,13951,226,28,40,2021-09-07
317104,JAKARTA PUSAT,SENEN,9308,13,9118,166,11,24,2021-09-07
317303,JAKARTA BARAT,TAMAN SARI,8704,16,8532,138,18,34,2021-09-07
317304,JAKARTA BARAT,TAMBORA,14030,20,13738,244,28,48,2021-09-07
317107,JAKARTA PUSAT,TANAH ABANG,10959,17,10706,218,18,35,2021-09-07
317202,JAKARTA UTARA,TANJUNG PRIOK,25496,30,25002,418,46,76,2021-09-07
317401,JAKARTA SELATAN,TEBET,16839,13,16506,276,44,57,2021-09-07
111111,Luar DKI & Proses Update,Luar DKI & Proses Update,143008,137,141294,1273,304,441,2021-09-07
317402,JAKARTA SELATAN,SETIA BUDI,11741,142,11394,180,25,167,2021-09-07
317101,JAKARTA PUSAT,GAMBIR,8485,9,8330,130,16,25,2021-09-07
317307,JAKARTA BARAT,PALMERAH,15734,21,15368,320,25,46,2021-09-07
317106,JAKARTA PUSAT,MENTENG,6396,9,6254,118,15,24,2021-09-07
317409,JAKARTA SELATAN,JAGAKARSA,26411,34,25875,400,102,136,2021-09-07
317108,JAKARTA PUSAT,JOHAR BARU,8622,9,8445,157,11,20,2021-09-07
317306,JAKARTA BARAT,KALI DERES,17854,21,17496,308,29,50,2021-09-07
317407,JAKARTA SELATAN,KEBAYORAN BARU,13722,30,13463,183,46,76,2021-09-07
317405,JAKARTA SELATAN,KEBAYORAN LAMA,19910,36,19471,354,49,85,2021-09-07
317206,JAKARTA UTARA,KELAPA GADING,12476,15,12245,191,25,40,2021-09-07
317205,JAKARTA UTARA,PADEMANGAN,12474,16,12097,162,199,215,2021-09-07
317103,JAKARTA PUSAT,KEMAYORAN,19730,58,19214,369,89,147,2021-09-07
310102,KAB.ADM.KEP.SERIBU,KEP. SERIBU SELATAN,700,0,690,10,0,0,2021-09-07
310101,KAB.ADM.KEP.SERIBU,KEP. SERIBU UTARA,628,0,621,6,1,1,2021-09-07
317203,JAKARTA UTARA,KOJA,17031,17,16641,337,36,53,2021-09-07
317504,JAKARTA TIMUR,KRAMAT JATI,21487,22,21007,396,62,84,2021-09-07
317508,JAKARTA TIMUR,MAKASAR,17387,25,17032,293,37,62,2021-09-07
317403,JAKARTA SELATAN,MAMPANG PRAPATAN,11420,13,11189,178,40,53,2021-09-07
317501,JAKARTA TIMUR,MATRAMAN,14144,18,13821,275,30,48,2021-09-07
317308,JAKARTA BARAT,KEMBANGAN,20117,23,19752,294,48,71,2021-09-07
317503,JAKARTA TIMUR,JATINEGARA,19366,29,18926,377,34,63,2021-09-07
111111,Luar DKI & Proses Update,Luar DKI & Proses Update,143008,137,141294,1273,304,441,2021-09-08
317108,JAKARTA PUSAT,JOHAR BARU,8625,9,8446,157,13,22,2021-09-08
317202,JAKARTA UTARA,TANJUNG PRIOK,25507,34,25011,418,44,78,2021-09-08
317504,JAKARTA TIMUR,KRAMAT JATI,21494,21,21015,397,61,82,2021-09-08
317508,JAKARTA TIMUR,MAKASAR,17392,26,17038,293,35,61,2021-09-08
317403,JAKARTA SELATAN,MAMPANG PRAPATAN,11424,13,11191,179,41,54,2021-09-08
317501,JAKARTA TIMUR,MATRAMAN,14147,16,13827,275,29,45,2021-09-08
317106,JAKARTA PUSAT,MENTENG,6396,8,6257,118,13,21,2021-09-08
317205,JAKARTA UTARA,PADEMANGAN,12490,15,12170,162,143,158,2021-09-08
317307,JAKARTA BARAT,PALMERAH,15741,22,15374,320,25,47,2021-09-08
317408,JAKARTA SELATAN,PANCORAN,14226,15,13954,226,31,46,2021-09-08
317203,JAKARTA UTARA,KOJA,17041,18,16647,337,39,57,2021-09-08
317404,JAKARTA SELATAN,PASAR MINGGU,23604,37,23058,418,91,128,2021-09-08
317201,JAKARTA UTARA,PENJARINGAN,18428,36,18107,229,56,92,2021-09-08
317410,JAKARTA SELATAN,PESANGGRAHAN,16229,18,15898,248,65,83,2021-09-08
317502,JAKARTA TIMUR,PULO GADUNG,21641,44,21171,394,32,76,2021-09-08
317102,JAKARTA PUSAT,SAWAH BESAR,9045,25,8812,169,39,64,2021-09-08
317104,JAKARTA PUSAT,SENEN,9314,14,9122,166,12,26,2021-09-08
317402,JAKARTA SELATAN,SETIA BUDI,11742,126,11411,180,25,151,2021-09-08
317303,JAKARTA BARAT,TAMAN SARI,8707,14,8534,138,21,35,2021-09-08
317304,JAKARTA BARAT,TAMBORA,14032,21,13742,244,25,46,2021-09-08
317505,JAKARTA TIMUR,PASAR REBO,17555,15,17189,323,28,43,2021-09-08
310101,KAB.ADM.KEP.SERIBU,KEP. SERIBU UTARA,628,0,621,6,1,1,2021-09-08
310102,KAB.ADM.KEP.SERIBU,KEP. SERIBU SELATAN,700,0,690,10,0,0,2021-09-08
317308,JAKARTA BARAT,KEMBANGAN,20117,20,19763,295,39,59,2021-09-08
317506,JAKARTA TIMUR,CAKUNG,22467,37,21981,402,47,84,2021-09-08
317105,JAKARTA PUSAT,CEMPAKA PUTIH,10408,12,10205,165,26,38,2021-09-08
317301,JAKARTA BARAT,CENGKARENG,28377,36,27714,551,76,112,2021-09-08
317406,JAKARTA SELATAN,CILANDAK,17546,27,17188,260,71,98,2021-09-08
317204,JAKARTA UTARA,CILINCING,17104,42,16672,337,53,95,2021-09-08
317510,JAKARTA TIMUR,CIPAYUNG,25029,19,24634,266,110,129,2021-09-08
317509,JAKARTA TIMUR,CIRACAS,22281,30,21807,373,71,101,2021-09-08
317507,JAKARTA TIMUR,DUREN SAWIT,29249,37,28502,602,108,145,2021-09-08
317101,JAKARTA PUSAT,GAMBIR,8485,9,8332,130,14,23,2021-09-08
317302,JAKARTA BARAT,GROGOL PETAMBURAN,18998,28,18643,298,29,57,2021-09-08
317409,JAKARTA SELATAN,JAGAKARSA,26425,29,25890,401,105,134,2021-09-08
317503,JAKARTA TIMUR,JATINEGARA,19373,31,18936,378,28,59,2021-09-08
317306,JAKARTA BARAT,KALI DERES,17857,21,17499,308,29,50,2021-09-08
317407,JAKARTA SELATAN,KEBAYORAN BARU,13725,30,13468,183,44,74,2021-09-08
317405,JAKARTA SELATAN,KEBAYORAN LAMA,19918,35,19488,354,41,76,2021-09-08
317305,JAKARTA BARAT,KEBON JERUK,21952,37,21521,364,30,67,2021-09-08
317206,JAKARTA UTARA,KELAPA GADING,12476,11,12252,191,22,33,2021-09-08
317103,JAKARTA PUSAT,KEMAYORAN,19757,52,19232,369,104,156,2021-09-08
317107,JAKARTA PUSAT,TANAH ABANG,10962,18,10710,218,16,34,2021-09-08
317401,JAKARTA SELATAN,TEBET,16845,13,16518,276,38,51,2021-09-08
111111,Luar DKI & Proses Update,Luar DKI & Proses Update,143008,137,141294,1273,304,441,2021-09-09
317202,JAKARTA UTARA,TANJUNG PRIOK,25518,34,25017,418,49,83,2021-09-09
317506,JAKARTA TIMUR,CAKUNG,22473,32,21994,405,42,74,2021-09-09
317508,JAKARTA TIMUR,MAKASAR,17394,27,17045,293,29,56,2021-09-09
317403,JAKARTA SELATAN,MAMPANG PRAPATAN,11427,13,11200,179,35,48,2021-09-09
317501,JAKARTA TIMUR,MATRAMAN,14149,16,13828,275,30,46,2021-09-09
317106,JAKARTA PUSAT,MENTENG,6398,7,6261,118,12,19,2021-09-09
317205,JAKARTA UTARA,PADEMANGAN,12495,15,12185,162,133,148,2021-09-09
317307,JAKARTA BARAT,PALMERAH,15744,23,15379,320,22,45,2021-09-09
317408,JAKARTA SELATAN,PANCORAN,14226,14,13957,227,28,42,2021-09-09
317404,JAKARTA SELATAN,PASAR MINGGU,23615,42,23071,419,83,125,2021-09-09
317504,JAKARTA TIMUR,KRAMAT JATI,21504,18,21026,397,63,81,2021-09-09
317505,JAKARTA TIMUR,PASAR REBO,17559,16,17191,323,29,45,2021-09-09
317410,JAKARTA SELATAN,PESANGGRAHAN,16235,17,15914,248,56,73,2021-09-09
317502,JAKARTA TIMUR,PULO GADUNG,21648,45,21177,394,32,77,2021-09-09
317102,JAKARTA PUSAT,SAWAH BESAR,9045,25,8818,169,33,58,2021-09-09
317104,JAKARTA PUSAT,SENEN,9317,17,9125,166,9,26,2021-09-09
317402,JAKARTA SELATAN,SETIA BUDI,11750,112,11431,180,27,139,2021-09-09
317303,JAKARTA BARAT,TAMAN SARI,8709,11,8537,139,22,33,2021-09-09
317304,JAKARTA BARAT,TAMBORA,14033,20,13748,244,21,41,2021-09-09
317107,JAKARTA PUSAT,TANAH ABANG,10965,17,10713,218,17,34,2021-09-09
317201,JAKARTA UTARA,PENJARINGAN,18436,36,18116,229,55,91,2021-09-09
317203,JAKARTA UTARA,KOJA,17045,16,16654,337,38,54,2021-09-09
310101,KAB.ADM.KEP.SERIBU,KEP. SERIBU UTARA,628,0,621,6,1,1,2021-09-09
310102,KAB.ADM.KEP.SERIBU,KEP. SERIBU SELATAN,700,0,690,10,0,0,2021-09-09
317105,JAKARTA PUSAT,CEMPAKA PUTIH,10411,13,10212,165,21,34,2021-09-09
317301,JAKARTA BARAT,CENGKARENG,28392,37,27725,551,79,116,2021-09-09
317406,JAKARTA SELATAN,CILANDAK,17550,26,17197,260,67,93,2021-09-09
317204,JAKARTA UTARA,CILINCING,17109,37,16689,338,45,82,2021-09-09
317510,JAKARTA TIMUR,CIPAYUNG,25035,17,24652,266,100,117,2021-09-09
317509,JAKARTA TIMUR,CIRACAS,22291,31,21819,375,66,97,2021-09-09
317507,JAKARTA TIMUR,DUREN SAWIT,29257,36,28506,603,112,148,2021-09-09
317101,JAKARTA PUSAT,GAMBIR,8487,7,8336,130,14,21,2021-09-09
317302,JAKARTA BARAT,GROGOL PETAMBURAN,19004,31,18648,298,27,58,2021-09-09
317409,JAKARTA SELATAN,JAGAKARSA,26430,23,25911,402,94,117,2021-09-09
317503,JAKARTA TIMUR,JATINEGARA,19376,30,18942,378,26,56,2021-09-09
317108,JAKARTA PUSAT,JOHAR BARU,8628,10,8448,157,13,23,2021-09-09
317306,JAKARTA BARAT,KALI DERES,17869,23,17504,308,34,57,2021-09-09
317407,JAKARTA SELATAN,KEBAYORAN BARU,13740,31,13475,183,51,82,2021-09-09
317405,JAKARTA SELATAN,KEBAYORAN LAMA,19924,34,19495,354,41,75,2021-09-09
317305,JAKARTA BARAT,KEBON JERUK,21959,35,21531,366,27,62,2021-09-09
317206,JAKARTA UTARA,KELAPA GADING,12476,9,12256,191,20,29,2021-09-09
317103,JAKARTA PUSAT,KEMAYORAN,19768,52,19253,369,94,146,2021-09-09
317308,JAKARTA BARAT,KEMBANGAN,20118,19,19768,295,36,55,2021-09-09
317401,JAKARTA SELATAN,TEBET,16845,13,16519,276,37,50,2021-09-09
111111,Luar DKI & Proses Update,Luar DKI & Proses Update,143008,137,141294,1273,304,441,2021-09-10
317101,JAKARTA PUSAT,GAMBIR,8489,5,8338,130,16,21,2021-09-10
317505,JAKARTA TIMUR,PASAR REBO,17560,16,17196,324,24,40,2021-09-10
317508,JAKARTA TIMUR,MAKASAR,17395,30,17047,293,25,55,2021-09-10
317403,JAKARTA SELATAN,MAMPANG PRAPATAN,11431,12,11208,179,32,44,2021-09-10
317106,JAKARTA PUSAT,MENTENG,6398,4,6264,118,12,16,2021-09-10
317205,JAKARTA UTARA,PADEMANGAN,12498,13,12235,162,88,101,2021-09-10
317307,JAKARTA BARAT,PALMERAH,15747,24,15382,320,21,45,2021-09-10
317408,JAKARTA SELATAN,PANCORAN,14235,14,13962,227,32,46,2021-09-10
317404,JAKARTA SELATAN,PASAR MINGGU,23621,37,23088,419,77,114,2021-09-10
317201,JAKARTA UTARA,PENJARINGAN,18440,34,18130,229,47,81,2021-09-10
317504,JAKARTA TIMUR,KRAMAT JATI,21506,16,21039,397,54,70,2021-09-10
317410,JAKARTA SELATAN,PESANGGRAHAN,16236,17,15917,248,54,71,2021-09-10
317102,JAKARTA PUSAT,SAWAH BESAR,9050,26,8819,169,36,62,2021-09-10
317104,JAKARTA PUSAT,SENEN,9318,17,9125,166,10,27,2021-09-10
317402,JAKARTA SELATAN,SETIA BUDI,11769,117,11438,181,33,150,2021-09-10
317303,JAKARTA BARAT,TAMAN SARI,8710,11,8538,139,22,33,2021-09-10
317304,JAKARTA BARAT,TAMBORA,14037,20,13755,245,17,37,2021-09-10
317107,JAKARTA PUSAT,TANAH ABANG,10966,16,10721,218,11,27,2021-09-10
317202,JAKARTA UTARA,TANJUNG PRIOK,25525,31,25029,420,45,76,2021-09-10
317401,JAKARTA SELATAN,TEBET,16850,13,16524,276,37,50,2021-09-10
317502,JAKARTA TIMUR,PULO GADUNG,21649,42,21187,396,24,66,2021-09-10
317203,JAKARTA UTARA,KOJA,17051,18,16656,337,40,58,2021-09-10
317501,JAKARTA TIMUR,MATRAMAN,14148,13,13831,277,27,40,2021-09-10
310102,KAB.ADM.KEP.SERIBU,KEP. SERIBU SELATAN,700,0,690,10,0,0,2021-09-10
317506,JAKARTA TIMUR,CAKUNG,22484,36,22000,405,43,79,2021-09-10
317105,JAKARTA PUSAT,CEMPAKA PUTIH,10414,16,10216,165,17,33,2021-09-10
317301,JAKARTA BARAT,CENGKARENG,28395,36,27740,551,68,104,2021-09-10
317406,JAKARTA SELATAN,CILANDAK,17558,28,17207,260,63,91,2021-09-10
317204,JAKARTA UTARA,CILINCING,17111,37,16700,338,36,73,2021-09-10
317510,JAKARTA TIMUR,CIPAYUNG,25045,16,24671,267,91,107,2021-09-10
310101,KAB.ADM.KEP.SERIBU,KEP. SERIBU UTARA,628,0,621,6,1,1,2021-09-10
317507,JAKARTA TIMUR,DUREN SAWIT,29267,36,28525,603,103,139,2021-09-10
317302,JAKARTA BARAT,GROGOL PETAMBURAN,19004,27,18655,298,24,51,2021-09-10
317409,JAKARTA SELATAN,JAGAKARSA,26438,23,25926,403,86,109,2021-09-10
317509,JAKARTA TIMUR,CIRACAS,22301,33,21826,375,67,100,2021-09-10
317308,JAKARTA BARAT,KEMBANGAN,20121,16,19775,295,35,51,2021-09-10
317108,JAKARTA PUSAT,JOHAR BARU,8628,10,8450,157,11,21,2021-09-10
317306,JAKARTA BARAT,KALI DERES,17872,22,17509,308,33,55,2021-09-10
317407,JAKARTA SELATAN,KEBAYORAN BARU,13749,32,13479,183,55,87,2021-09-10
317405,JAKARTA SELATAN,KEBAYORAN LAMA,19926,33,19499,354,40,73,2021-09-10
317305,JAKARTA BARAT,KEBON JERUK,21962,33,21536,367,26,59,2021-09-10
317206,JAKARTA UTARA,KELAPA GADING,12481,10,12258,191,22,32,2021-09-10
317103,JAKARTA PUSAT,KEMAYORAN,19779,50,19261,369,99,149,2021-09-10
317503,JAKARTA TIMUR,JATINEGARA,19381,33,18947,378,23,56,2021-09-10
317505,JAKARTA TIMUR,PASAR REBO,17564,18,17198,325,23,41,2021-09-11
317404,JAKARTA SELATAN,PASAR MINGGU,23625,34,23102,421,68,102,2021-09-11
317408,JAKARTA SELATAN,PANCORAN,14237,11,13966,228,32,43,2021-09-11
317307,JAKARTA BARAT,PALMERAH,15749,20,15387,320,22,42,2021-09-11
317403,JAKARTA SELATAN,MAMPANG PRAPATAN,11432,11,11212,179,30,41,2021-09-11
317106,JAKARTA PUSAT,MENTENG,6401,5,6266,118,12,17,2021-09-11
317501,JAKARTA TIMUR,MATRAMAN,14149,13,13835,277,24,37,2021-09-11
317201,JAKARTA UTARA,PENJARINGAN,18444,35,18134,229,46,81,2021-09-11
317205,JAKARTA UTARA,PADEMANGAN,12507,20,12271,162,54,74,2021-09-11
317410,JAKARTA SELATAN,PESANGGRAHAN,16239,14,15923,249,53,67,2021-09-11
317409,JAKARTA SELATAN,JAGAKARSA,26445,22,25933,403,87,109,2021-09-11
317102,JAKARTA PUSAT,SAWAH BESAR,9053,27,8824,169,33,60,2021-09-11
317104,JAKARTA PUSAT,SENEN,9320,17,9127,167,9,26,2021-09-11
317402,JAKARTA SELATAN,SETIA BUDI,11778,117,11445,182,34,151,2021-09-11
317303,JAKARTA BARAT,TAMAN SARI,8711,11,8539,139,22,33,2021-09-11
317304,JAKARTA BARAT,TAMBORA,14039,18,13758,246,17,35,2021-09-11
317107,JAKARTA PUSAT,TANAH ABANG,10968,17,10725,219,7,24,2021-09-11
317202,JAKARTA UTARA,TANJUNG PRIOK,25536,34,25035,420,47,81,2021-09-11
317401,JAKARTA SELATAN,TEBET,16851,14,16525,276,36,50,2021-09-11
111111,Luar DKI & Proses Update,Luar DKI & Proses Update,143008,137,141294,1273,304,441,2021-09-11
317508,JAKARTA TIMUR,MAKASAR,17396,25,17055,294,22,47,2021-09-11
317502,JAKARTA TIMUR,PULO GADUNG,21657,48,21189,396,24,72,2021-09-11
317504,JAKARTA TIMUR,KRAMAT JATI,21511,20,21043,397,51,71,2021-09-11
317204,JAKARTA UTARA,CILINCING,17113,39,16699,339,36,75,2021-09-11
310101,KAB.ADM.KEP.SERIBU,KEP. SERIBU UTARA,628,0,621,6,1,1,2021-09-11
317506,JAKARTA TIMUR,CAKUNG,22489,33,22007,406,43,76,2021-09-11
317105,JAKARTA PUSAT,CEMPAKA PUTIH,10415,16,10216,165,18,34,2021-09-11
317301,JAKARTA BARAT,CENGKARENG,28402,38,27751,551,62,100,2021-09-11
317406,JAKARTA SELATAN,CILANDAK,17562,28,17213,260,61,89,2021-09-11
317510,JAKARTA TIMUR,CIPAYUNG,25047,15,24677,267,88,103,2021-09-11
317203,JAKARTA UTARA,KOJA,17053,18,16660,337,38,56,2021-09-11
317507,JAKARTA TIMUR,DUREN SAWIT,29281,36,28531,604,110,146,2021-09-11
317101,JAKARTA PUSAT,GAMBIR,8491,7,8338,130,16,23,2021-09-11
317302,JAKARTA BARAT,GROGOL PETAMBURAN,19007,26,18659,298,24,50,2021-09-11
317509,JAKARTA TIMUR,CIRACAS,22307,33,21833,376,65,98,2021-09-11
317308,JAKARTA BARAT,KEMBANGAN,20121,14,19783,295,29,43,2021-09-11
317108,JAKARTA PUSAT,JOHAR BARU,8628,8,8452,157,11,19,2021-09-11
317306,JAKARTA BARAT,KALI DERES,17883,21,17516,309,37,58,2021-09-11
317407,JAKARTA SELATAN,KEBAYORAN BARU,13753,28,13483,183,59,87,2021-09-11
317405,JAKARTA SELATAN,KEBAYORAN LAMA,19932,33,19506,355,38,71,2021-09-11
317305,JAKARTA BARAT,KEBON JERUK,21962,32,21538,367,25,57,2021-09-11
317206,JAKARTA UTARA,KELAPA GADING,12483,10,12262,191,20,30,2021-09-11
317103,JAKARTA PUSAT,KEMAYORAN,19786,22,19294,371,99,121,2021-09-11
317503,JAKARTA TIMUR,JATINEGARA,19386,31,18951,379,25,56,2021-09-11
310102,KAB.ADM.KEP.SERIBU,KEP. SERIBU SELATAN,700,0,690,10,0,0,2021-09-11
317505,JAKARTA TIMUR,PASAR REBO,17567,18,17203,325,21,39,2021-09-12
317404,JAKARTA SELATAN,PASAR MINGGU,23627,32,23107,421,67,99,2021-09-12
317408,JAKARTA SELATAN,PANCORAN,14237,11,13970,228,28,39,2021-09-12
317307,JAKARTA BARAT,PALMERAH,15752,20,15394,321,17,37,2021-09-12
317403,JAKARTA SELATAN,MAMPANG PRAPATAN,11433,11,11214,179,29,40,2021-09-12
317106,JAKARTA PUSAT,MENTENG,6402,4,6268,118,12,16,2021-09-12
317501,JAKARTA TIMUR,MATRAMAN,14153,11,13842,277,23,34,2021-09-12
317201,JAKARTA UTARA,PENJARINGAN,18447,34,18138,229,46,80,2021-09-12
317205,JAKARTA UTARA,PADEMANGAN,12509,19,12275,162,53,72,2021-09-12
317410,JAKARTA SELATAN,PESANGGRAHAN,16244,14,15937,249,44,58,2021-09-12
317402,JAKARTA SELATAN,SETIA BUDI,11788,112,11456,182,38,150,2021-09-12
317102,JAKARTA PUSAT,SAWAH BESAR,9058,26,8832,169,31,57,2021-09-12
317104,JAKARTA PUSAT,SENEN,9324,18,9129,167,10,28,2021-09-12
317303,JAKARTA BARAT,TAMAN SARI,8712,10,8541,139,22,32,2021-09-12
317304,JAKARTA BARAT,TAMBORA,14043,18,13762,246,17,35,2021-09-12
317107,JAKARTA PUSAT,TANAH ABANG,10973,19,10726,220,8,27,2021-09-12
317202,JAKARTA UTARA,TANJUNG PRIOK,25541,32,25037,422,50,82,2021-09-12
317401,JAKARTA SELATAN,TEBET,16853,14,16526,276,37,51,2021-09-12
111111,Luar DKI & Proses Update,Luar DKI & Proses Update,143008,137,141294,1273,304,441,2021-09-12
317508,JAKARTA TIMUR,MAKASAR,17399,24,17058,294,23,47,2021-09-12
317502,JAKARTA TIMUR,PULO GADUNG,21665,41,21201,396,27,68,2021-09-12
317504,JAKARTA TIMUR,KRAMAT JATI,21517,20,21046,398,53,73,2021-09-12
317306,JAKARTA BARAT,KALI DERES,17885,20,17520,309,36,56,2021-09-12
310101,KAB.ADM.KEP.SERIBU,KEP. SERIBU UTARA,628,0,622,6,0,0,2021-09-12
317203,JAKARTA UTARA,KOJA,17055,18,16664,337,36,54,2021-09-12
317105,JAKARTA PUSAT,CEMPAKA PUTIH,10415,16,10217,165,17,33,2021-09-12
317301,JAKARTA BARAT,CENGKARENG,28412,35,27761,551,65,100,2021-09-12
317406,JAKARTA SELATAN,CILANDAK,17564,28,17221,260,55,83,2021-09-12
317204,JAKARTA UTARA,CILINCING,17121,39,16703,339,40,79,2021-09-12
317510,JAKARTA TIMUR,CIPAYUNG,25052,13,24680,267,92,105,2021-09-12
317507,JAKARTA TIMUR,DUREN SAWIT,29288,34,28546,604,104,138,2021-09-12
317101,JAKARTA PUSAT,GAMBIR,8491,7,8339,130,15,22,2021-09-12
317302,JAKARTA BARAT,GROGOL PETAMBURAN,19008,23,18665,298,22,45,2021-09-12
317409,JAKARTA SELATAN,JAGAKARSA,26450,22,25947,403,78,100,2021-09-12
317509,JAKARTA TIMUR,CIRACAS,22317,33,21835,376,73,106,2021-09-12
317108,JAKARTA PUSAT,JOHAR BARU,8629,8,8454,157,10,18,2021-09-12
317503,JAKARTA TIMUR,JATINEGARA,19392,32,18956,379,25,57,2021-09-12
317308,JAKARTA BARAT,KEMBANGAN,20127,16,19790,295,26,42,2021-09-12
317103,JAKARTA PUSAT,KEMAYORAN,19789,16,19303,371,99,115,2021-09-12
317206,JAKARTA UTARA,KELAPA GADING,12486,8,12266,191,21,29,2021-09-12
310102,KAB.ADM.KEP.SERIBU,KEP. SERIBU SELATAN,700,0,690,10,0,0,2021-09-12
317405,JAKARTA SELATAN,KEBAYORAN LAMA,19936,31,19511,355,39,70,2021-09-12
317407,JAKARTA SELATAN,KEBAYORAN BARU,13761,26,13491,184,60,86,2021-09-12
317506,JAKARTA TIMUR,CAKUNG,22496,37,22011,406,42,79,2021-09-12
317305,JAKARTA BARAT,KEBON JERUK,21974,36,21546,367,25,61,2021-09-12
317408,JAKARTA SELATAN,PANCORAN,14238,8,13974,228,28,36,2021-09-13
317504,JAKARTA TIMUR,KRAMAT JATI,21517,19,21051,398,49,68,2021-09-13
317508,JAKARTA TIMUR,MAKASAR,17399,18,17065,294,22,40,2021-09-13
317403,JAKARTA SELATAN,MAMPANG PRAPATAN,11433,8,11221,179,25,33,2021-09-13
317501,JAKARTA TIMUR,MATRAMAN,14155,13,13843,277,22,35,2021-09-13
317106,JAKARTA PUSAT,MENTENG,6405,6,6269,118,12,18,2021-09-13
317205,JAKARTA UTARA,PADEMANGAN,12512,20,12281,162,49,69,2021-09-13
317307,JAKARTA BARAT,PALMERAH,15754,18,15398,321,17,35,2021-09-13
317404,JAKARTA SELATAN,PASAR MINGGU,23632,28,23115,421,68,96,2021-09-13
317107,JAKARTA PUSAT,TANAH ABANG,10976,18,10730,220,8,26,2021-09-13
317201,JAKARTA UTARA,PENJARINGAN,18449,28,18157,229,35,63,2021-09-13
317410,JAKARTA SELATAN,PESANGGRAHAN,16245,14,15940,249,42,56,2021-09-13
317502,JAKARTA TIMUR,PULO GADUNG,21668,38,21206,396,28,66,2021-09-13
317102,JAKARTA PUSAT,SAWAH BESAR,9061,18,8839,170,34,52,2021-09-13
317104,JAKARTA PUSAT,SENEN,9325,16,9132,167,10,26,2021-09-13
317402,JAKARTA SELATAN,SETIA BUDI,11791,86,11486,182,37,123,2021-09-13
317303,JAKARTA BARAT,TAMAN SARI,8713,8,8549,139,17,25,2021-09-13
317304,JAKARTA BARAT,TAMBORA,14044,19,13762,246,17,36,2021-09-13
317202,JAKARTA UTARA,TANJUNG PRIOK,25547,33,25048,422,44,77,2021-09-13
317401,JAKARTA SELATAN,TEBET,16853,14,16530,276,33,47,2021-09-13
317505,JAKARTA TIMUR,PASAR REBO,17567,16,17207,325,19,35,2021-09-13
310101,KAB.ADM.KEP.SERIBU,KEP. SERIBU UTARA,628,0,622,6,0,0,2021-09-13
317203,JAKARTA UTARA,KOJA,17058,20,16666,337,35,55,2021-09-13
317308,JAKARTA BARAT,KEMBANGAN,20129,15,19794,296,24,39,2021-09-13
310102,KAB.ADM.KEP.SERIBU,KEP. SERIBU SELATAN,700,0,690,10,0,0,2021-09-13
317506,JAKARTA TIMUR,CAKUNG,22498,34,22016,407,41,75,2021-09-13
317105,JAKARTA PUSAT,CEMPAKA PUTIH,10419,15,10219,165,20,35,2021-09-13
317301,JAKARTA BARAT,CENGKARENG,28413,33,27768,551,61,94,2021-09-13
317406,JAKARTA SELATAN,CILANDAK,17565,21,17237,260,47,68,2021-09-13
317510,JAKARTA TIMUR,CIPAYUNG,25053,14,24682,267,90,104,2021-09-13
317509,JAKARTA TIMUR,CIRACAS,22317,31,21837,376,73,104,2021-09-13
317507,JAKARTA TIMUR,DUREN SAWIT,29291,33,28552,605,101,134,2021-09-13
317101,JAKARTA PUSAT,GAMBIR,8496,11,8340,130,15,26,2021-09-13
317302,JAKARTA BARAT,GROGOL PETAMBURAN,19008,15,18674,298,21,36,2021-09-13
317204,JAKARTA UTARA,CILINCING,17121,34,16710,339,38,72,2021-09-13
317503,JAKARTA TIMUR,JATINEGARA,19394,30,18961,379,24,54,2021-09-13
317108,JAKARTA PUSAT,JOHAR BARU,8629,8,8456,157,8,16,2021-09-13
317306,JAKARTA BARAT,KALI DERES,17888,21,17522,310,35,56,2021-09-13
317407,JAKARTA SELATAN,KEBAYORAN BARU,13764,16,13502,184,62,78,2021-09-13
317405,JAKARTA SELATAN,KEBAYORAN LAMA,19939,30,19519,355,35,65,2021-09-13
317305,JAKARTA BARAT,KEBON JERUK,21975,31,21553,367,24,55,2021-09-13
317206,JAKARTA UTARA,KELAPA GADING,12489,9,12271,191,18,27,2021-09-13
317103,JAKARTA PUSAT,KEMAYORAN,19814,13,19310,371,120,133,2021-09-13
317409,JAKARTA SELATAN,JAGAKARSA,26456,18,25959,403,76,94,2021-09-13
111111,Luar DKI & Proses Update,Luar DKI & Proses Update,143008,137,141294,1273,304,441,2021-09-13
317407,JAKARTA SELATAN,KEBAYORAN BARU,13765,14,13510,184,57,71,2021-09-14
317405,JAKARTA SELATAN,KEBAYORAN LAMA,19940,22,19528,355,35,57,2021-09-14
317305,JAKARTA BARAT,KEBON JERUK,21976,24,21560,368,24,48,2021-09-14
317206,JAKARTA UTARA,KELAPA GADING,12495,7,12276,191,21,28,2021-09-14
310101,KAB.ADM.KEP.SERIBU,KEP. SERIBU UTARA,628,0,622,6,0,0,2021-09-14
317308,JAKARTA BARAT,KEMBANGAN,20132,13,19797,296,26,39,2021-09-14
310102,KAB.ADM.KEP.SERIBU,KEP. SERIBU SELATAN,700,0,690,10,0,0,2021-09-14
317203,JAKARTA UTARA,KOJA,17058,16,16672,337,33,49,2021-09-14
317306,JAKARTA BARAT,KALI DERES,17894,20,17526,310,38,58,2021-09-14
317103,JAKARTA PUSAT,KEMAYORAN,19821,13,19318,372,118,131,2021-09-14
317108,JAKARTA PUSAT,JOHAR BARU,8630,7,8458,157,8,15,2021-09-14
317105,JAKARTA PUSAT,CEMPAKA PUTIH,10421,14,10224,165,18,32,2021-09-14
317409,JAKARTA SELATAN,JAGAKARSA,26457,14,25972,403,68,82,2021-09-14
317302,JAKARTA BARAT,GROGOL PETAMBURAN,19009,10,18683,298,18,28,2021-09-14
317101,JAKARTA PUSAT,GAMBIR,8500,6,8351,130,13,19,2021-09-14
317507,JAKARTA TIMUR,DUREN SAWIT,29294,30,28575,605,84,114,2021-09-14
317509,JAKARTA TIMUR,CIRACAS,22317,25,21846,376,70,95,2021-09-14
317510,JAKARTA TIMUR,CIPAYUNG,25053,11,24698,267,77,88,2021-09-14
317204,JAKARTA UTARA,CILINCING,17121,27,16722,339,33,60,2021-09-14
317406,JAKARTA SELATAN,CILANDAK,17569,17,17256,260,36,53,2021-09-14
317301,JAKARTA BARAT,CENGKARENG,28417,33,27793,552,39,72,2021-09-14
317506,JAKARTA TIMUR,CAKUNG,22500,33,22026,407,34,67,2021-09-14
317504,JAKARTA TIMUR,KRAMAT JATI,21519,17,21060,398,44,61,2021-09-14
317503,JAKARTA TIMUR,JATINEGARA,19394,23,18969,379,23,46,2021-09-14
317508,JAKARTA TIMUR,MAKASAR,17399,12,17076,294,17,29,2021-09-14
317501,JAKARTA TIMUR,MATRAMAN,14155,8,13851,277,19,27,2021-09-14
317303,JAKARTA BARAT,TAMAN SARI,8715,6,8555,139,15,21,2021-09-14
111111,Luar DKI & Proses Update,Luar DKI & Proses Update,143008,137,141294,1273,304,441,2021-09-14
317401,JAKARTA SELATAN,TEBET,16854,11,16540,276,27,38,2021-09-14
317202,JAKARTA UTARA,TANJUNG PRIOK,25549,32,25051,422,44,76,2021-09-14
317107,JAKARTA PUSAT,TANAH ABANG,10978,18,10732,220,8,26,2021-09-14
317304,JAKARTA BARAT,TAMBORA,14046,18,13767,246,15,33,2021-09-14
317403,JAKARTA SELATAN,MAMPANG PRAPATAN,11433,6,11232,179,16,22,2021-09-14
317402,JAKARTA SELATAN,SETIA BUDI,11808,95,11494,182,37,132,2021-09-14
317104,JAKARTA PUSAT,SENEN,9327,13,9137,167,10,23,2021-09-14
317102,JAKARTA PUSAT,SAWAH BESAR,9065,14,8846,170,35,49,2021-09-14
317410,JAKARTA SELATAN,PESANGGRAHAN,16247,12,15947,249,39,51,2021-09-14
317201,JAKARTA UTARA,PENJARINGAN,18453,32,18161,229,31,63,2021-09-14
317505,JAKARTA TIMUR,PASAR REBO,17568,17,17209,325,17,34,2021-09-14
317404,JAKARTA SELATAN,PASAR MINGGU,23634,25,23124,421,64,89,2021-09-14
317408,JAKARTA SELATAN,PANCORAN,14239,6,13981,228,24,30,2021-09-14
317307,JAKARTA BARAT,PALMERAH,15759,18,15401,321,19,37,2021-09-14
317205,JAKARTA UTARA,PADEMANGAN,12517,19,12285,162,51,70,2021-09-14
317106,JAKARTA PUSAT,MENTENG,6407,5,6275,118,9,14,2021-09-14
317502,JAKARTA TIMUR,PULO GADUNG,21670,31,21215,395,29,60,2021-09-14
317408,JAKARTA SELATAN,PANCORAN,14241,7,13985,228,21,28,2021-09-15
111111,Luar DKI & Proses Update,Luar DKI & Proses Update,143008,137,141294,1273,304,441,2021-09-15
317307,JAKARTA BARAT,PALMERAH,15763,17,15405,323,18,35,2021-09-15
317404,JAKARTA SELATAN,PASAR MINGGU,23640,26,23128,422,64,90,2021-09-15
317106,JAKARTA PUSAT,MENTENG,6409,5,6277,118,9,14,2021-09-15
317501,JAKARTA TIMUR,MATRAMAN,14157,8,13857,277,15,23,2021-09-15
317403,JAKARTA SELATAN,MAMPANG PRAPATAN,11440,5,11235,179,21,26,2021-09-15
317205,JAKARTA UTARA,PADEMANGAN,12524,19,12289,162,54,73,2021-09-15
317401,JAKARTA SELATAN,TEBET,16855,12,16546,276,21,33,2021-09-15
317410,JAKARTA SELATAN,PESANGGRAHAN,16248,10,15958,250,30,40,2021-09-15
317107,JAKARTA PUSAT,TANAH ABANG,10980,19,10733,221,7,26,2021-09-15
317304,JAKARTA BARAT,TAMBORA,14048,18,13769,246,15,33,2021-09-15
317303,JAKARTA BARAT,TAMAN SARI,8717,7,8557,139,14,21,2021-09-15
317402,JAKARTA SELATAN,SETIA BUDI,11816,82,11510,182,42,124,2021-09-15
317104,JAKARTA PUSAT,SENEN,9330,13,9139,167,11,24,2021-09-15
317102,JAKARTA PUSAT,SAWAH BESAR,9074,16,8851,170,37,53,2021-09-15
317502,JAKARTA TIMUR,PULO GADUNG,21673,26,21225,395,27,53,2021-09-15
317508,JAKARTA TIMUR,MAKASAR,17401,13,17076,294,18,31,2021-09-15
317201,JAKARTA UTARA,PENJARINGAN,18455,23,18175,229,28,51,2021-09-15
317202,JAKARTA UTARA,TANJUNG PRIOK,25554,33,25055,423,43,76,2021-09-15
317504,JAKARTA TIMUR,KRAMAT JATI,21526,16,21068,398,44,60,2021-09-15
317505,JAKARTA TIMUR,PASAR REBO,17568,15,17213,325,15,30,2021-09-15
310101,KAB.ADM.KEP.SERIBU,KEP. SERIBU UTARA,628,0,622,6,0,0,2021-09-15
317503,JAKARTA TIMUR,JATINEGARA,19402,22,18976,379,25,47,2021-09-15
317302,JAKARTA BARAT,GROGOL PETAMBURAN,19014,12,18686,298,18,30,2021-09-15
317101,JAKARTA PUSAT,GAMBIR,8501,7,8353,130,11,18,2021-09-15
317507,JAKARTA TIMUR,DUREN SAWIT,29302,27,28590,607,78,105,2021-09-15
317509,JAKARTA TIMUR,CIRACAS,22325,22,21865,376,62,84,2021-09-15
317510,JAKARTA TIMUR,CIPAYUNG,25062,11,24707,267,77,88,2021-09-15
317204,JAKARTA UTARA,CILINCING,17123,26,16725,339,33,59,2021-09-15
317406,JAKARTA SELATAN,CILANDAK,17579,14,17265,260,40,54,2021-09-15
317301,JAKARTA BARAT,CENGKARENG,28421,32,27809,552,28,60,2021-09-15
317105,JAKARTA PUSAT,CEMPAKA PUTIH,10423,13,10229,165,16,29,2021-09-15
317409,JAKARTA SELATAN,JAGAKARSA,26462,15,25982,403,62,77,2021-09-15
317203,JAKARTA UTARA,KOJA,17059,15,16680,337,27,42,2021-09-15
317108,JAKARTA PUSAT,JOHAR BARU,8630,5,8461,157,7,12,2021-09-15
317306,JAKARTA BARAT,KALI DERES,17900,21,17530,310,39,60,2021-09-15
317407,JAKARTA SELATAN,KEBAYORAN BARU,13768,12,13515,184,57,69,2021-09-15
317405,JAKARTA SELATAN,KEBAYORAN LAMA,19942,22,19530,356,34,56,2021-09-15
317305,JAKARTA BARAT,KEBON JERUK,21979,25,21565,368,21,46,2021-09-15
317206,JAKARTA UTARA,KELAPA GADING,12499,10,12277,191,21,31,2021-09-15
317103,JAKARTA PUSAT,KEMAYORAN,19840,14,19343,372,111,125,2021-09-15
317308,JAKARTA BARAT,KEMBANGAN,20140,14,19804,296,26,40,2021-09-15
310102,KAB.ADM.KEP.SERIBU,KEP. SERIBU SELATAN,700,0,690,10,0,0,2021-09-15
317506,JAKARTA TIMUR,CAKUNG,22506,31,22031,407,37,68,2021-09-15
317505,JAKARTA TIMUR,PASAR REBO,17569,15,17220,325,9,24,2021-09-16
317404,JAKARTA SELATAN,PASAR MINGGU,23645,22,23142,422,59,81,2021-09-16
317408,JAKARTA SELATAN,PANCORAN,14241,6,13988,228,19,25,2021-09-16
317403,JAKARTA SELATAN,MAMPANG PRAPATAN,11442,5,11235,179,23,28,2021-09-16
317205,JAKARTA UTARA,PADEMANGAN,12525,18,12292,162,53,71,2021-09-16
317106,JAKARTA PUSAT,MENTENG,6409,5,6277,118,9,14,2021-09-16
317501,JAKARTA TIMUR,MATRAMAN,14159,8,13859,277,15,23,2021-09-16
317307,JAKARTA BARAT,PALMERAH,15769,18,15407,324,20,38,2021-09-16
317201,JAKARTA UTARA,PENJARINGAN,18461,26,18182,229,24,50,2021-09-16
317402,JAKARTA SELATAN,SETIA BUDI,11819,68,11530,182,39,107,2021-09-16
317502,JAKARTA TIMUR,PULO GADUNG,21676,24,21229,395,28,52,2021-09-16
317102,JAKARTA PUSAT,SAWAH BESAR,9076,17,8851,170,38,55,2021-09-16
317104,JAKARTA PUSAT,SENEN,9333,14,9141,167,11,25,2021-09-16
317303,JAKARTA BARAT,TAMAN SARI,8720,8,8558,139,15,23,2021-09-16
317304,JAKARTA BARAT,TAMBORA,14053,19,13772,247,15,34,2021-09-16
317107,JAKARTA PUSAT,TANAH ABANG,10980,16,10737,222,5,21,2021-09-16
317202,JAKARTA UTARA,TANJUNG PRIOK,25563,34,25063,423,43,77,2021-09-16
317401,JAKARTA SELATAN,TEBET,16856,12,16550,276,18,30,2021-09-16
317508,JAKARTA TIMUR,MAKASAR,17402,14,17079,294,15,29,2021-09-16
317410,JAKARTA SELATAN,PESANGGRAHAN,16251,8,15962,250,31,39,2021-09-16
317504,JAKARTA TIMUR,KRAMAT JATI,21533,15,21075,398,45,60,2021-09-16
310102,KAB.ADM.KEP.SERIBU,KEP. SERIBU SELATAN,700,0,690,10,0,0,2021-09-16
310101,KAB.ADM.KEP.SERIBU,KEP. SERIBU UTARA,628,0,622,6,0,0,2021-09-16
111111,Luar DKI & Proses Update,Luar DKI & Proses Update,143008,137,141294,1273,304,441,2021-09-16
317506,JAKARTA TIMUR,CAKUNG,22517,30,22035,408,44,74,2021-09-16
317105,JAKARTA PUSAT,CEMPAKA PUTIH,10424,14,10229,165,16,30,2021-09-16
317203,JAKARTA UTARA,KOJA,17060,15,16688,337,20,35,2021-09-16
317406,JAKARTA SELATAN,CILANDAK,17580,13,17270,260,37,50,2021-09-16
317204,JAKARTA UTARA,CILINCING,17129,21,16733,339,36,57,2021-09-16
317510,JAKARTA TIMUR,CIPAYUNG,25063,11,24719,267,66,77,2021-09-16
317509,JAKARTA TIMUR,CIRACAS,22327,21,21876,376,54,75,2021-09-16
317507,JAKARTA TIMUR,DUREN SAWIT,29309,30,28600,607,72,102,2021-09-16
317101,JAKARTA PUSAT,GAMBIR,8504,8,8354,131,11,19,2021-09-16
317302,JAKARTA BARAT,GROGOL PETAMBURAN,19015,13,18686,298,18,31,2021-09-16
317301,JAKARTA BARAT,CENGKARENG,28423,30,27815,552,26,56,2021-09-16
317503,JAKARTA TIMUR,JATINEGARA,19405,19,18979,380,27,46,2021-09-16
317409,JAKARTA SELATAN,JAGAKARSA,26467,16,25989,403,59,75,2021-09-16
317103,JAKARTA PUSAT,KEMAYORAN,19852,15,19351,372,114,129,2021-09-16
317206,JAKARTA UTARA,KELAPA GADING,12500,10,12279,191,20,30,2021-09-16
317305,JAKARTA BARAT,KEBON JERUK,21981,23,21575,368,15,38,2021-09-16
317308,JAKARTA BARAT,KEMBANGAN,20143,13,19808,297,25,38,2021-09-16
317407,JAKARTA SELATAN,KEBAYORAN BARU,13770,11,13523,184,52,63,2021-09-16
317306,JAKARTA BARAT,KALI DERES,17907,23,17532,310,42,65,2021-09-16
317108,JAKARTA PUSAT,JOHAR BARU,8631,5,8463,157,6,11,2021-09-16
317405,JAKARTA SELATAN,KEBAYORAN LAMA,19942,18,19537,356,31,49,2021-09-16
317409,JAKARTA SELATAN,JAGAKARSA,26468,16,26005,403,44,60,2021-09-17
317407,JAKARTA SELATAN,KEBAYORAN BARU,13772,11,13526,184,51,62,2021-09-17
317306,JAKARTA BARAT,KALI DERES,17910,21,17537,310,42,63,2021-09-17
317108,JAKARTA PUSAT,JOHAR BARU,8632,4,8464,157,7,11,2021-09-17
317405,JAKARTA SELATAN,KEBAYORAN LAMA,19942,17,19540,356,29,46,2021-09-17
317503,JAKARTA TIMUR,JATINEGARA,19407,18,18984,381,24,42,2021-09-17
317302,JAKARTA BARAT,GROGOL PETAMBURAN,19022,14,18689,298,21,35,2021-09-17
317204,JAKARTA UTARA,CILINCING,17131,17,16746,339,29,46,2021-09-17
317507,JAKARTA TIMUR,DUREN SAWIT,29313,29,28619,607,58,87,2021-09-17
317509,JAKARTA TIMUR,CIRACAS,22328,20,21889,376,43,63,2021-09-17
317510,JAKARTA TIMUR,CIPAYUNG,25066,11,24739,267,49,60,2021-09-17
317406,JAKARTA SELATAN,CILANDAK,17582,12,17275,260,35,47,2021-09-17
317301,JAKARTA BARAT,CENGKARENG,28428,32,27817,552,27,59,2021-09-17
317105,JAKARTA PUSAT,CEMPAKA PUTIH,10424,10,10234,165,15,25,2021-09-17
317506,JAKARTA TIMUR,CAKUNG,22517,27,22043,410,37,64,2021-09-17
317101,JAKARTA PUSAT,GAMBIR,8505,7,8356,131,11,18,2021-09-17
317305,JAKARTA BARAT,KEBON JERUK,21981,21,21581,368,11,32,2021-09-17
317203,JAKARTA UTARA,KOJA,17064,16,16692,337,19,35,2021-09-17
317103,JAKARTA PUSAT,KEMAYORAN,19856,17,19358,372,109,126,2021-09-17
111111,Luar DKI & Proses Update,Luar DKI & Proses Update,143008,137,141294,1273,304,441,2021-09-17
317206,JAKARTA UTARA,KELAPA GADING,12504,10,12283,192,19,29,2021-09-17
317202,JAKARTA UTARA,TANJUNG PRIOK,25568,29,25071,423,45,74,2021-09-17
317107,JAKARTA PUSAT,TANAH ABANG,10980,15,10738,222,5,20,2021-09-17
317304,JAKARTA BARAT,TAMBORA,14053,20,13776,247,10,30,2021-09-17
317303,JAKARTA BARAT,TAMAN SARI,8721,7,8564,139,11,18,2021-09-17
317402,JAKARTA SELATAN,SETIA BUDI,11820,66,11537,182,35,101,2021-09-17
317104,JAKARTA PUSAT,SENEN,9337,12,9145,167,13,25,2021-09-17
317102,JAKARTA PUSAT,SAWAH BESAR,9078,13,8859,170,36,49,2021-09-17
317502,JAKARTA TIMUR,PULO GADUNG,21679,24,21233,396,26,50,2021-09-17
317410,JAKARTA SELATAN,PESANGGRAHAN,16254,8,15970,250,26,34,2021-09-17
317201,JAKARTA UTARA,PENJARINGAN,18463,27,18187,229,20,47,2021-09-17
317401,JAKARTA SELATAN,TEBET,16856,11,16558,276,11,22,2021-09-17
317404,JAKARTA SELATAN,PASAR MINGGU,23653,23,23153,422,55,78,2021-09-17
317505,JAKARTA TIMUR,PASAR REBO,17570,13,17225,325,7,20,2021-09-17
310101,KAB.ADM.KEP.SERIBU,KEP. SERIBU UTARA,628,0,622,6,0,0,2021-09-17
317504,JAKARTA TIMUR,KRAMAT JATI,21534,16,21084,398,36,52,2021-09-17
317508,JAKARTA TIMUR,MAKASAR,17406,14,17084,294,14,28,2021-09-17
317403,JAKARTA SELATAN,MAMPANG PRAPATAN,11444,5,11236,179,24,29,2021-09-17
317308,JAKARTA BARAT,KEMBANGAN,20145,12,19812,297,24,36,2021-09-17
317106,JAKARTA PUSAT,MENTENG,6409,5,6279,118,7,12,2021-09-17
317205,JAKARTA UTARA,PADEMANGAN,12527,17,12299,162,49,66,2021-09-17
317307,JAKARTA BARAT,PALMERAH,15771,16,15412,324,19,35,2021-09-17
317408,JAKARTA SELATAN,PANCORAN,14241,6,13988,228,19,25,2021-09-17
317501,JAKARTA TIMUR,MATRAMAN,14162,6,13867,277,12,18,2021-09-17
310102,KAB.ADM.KEP.SERIBU,KEP. SERIBU SELATAN,700,0,690,10,0,0,2021-09-17
317201,JAKARTA UTARA,PENJARINGAN,18464,26,18190,229,19,45,2021-09-18
317501,JAKARTA TIMUR,MATRAMAN,14162,6,13867,277,12,18,2021-09-18
317106,JAKARTA PUSAT,MENTENG,6412,7,6280,118,7,14,2021-09-18
317205,JAKARTA UTARA,PADEMANGAN,12529,17,12304,162,46,63,2021-09-18
317307,JAKARTA BARAT,PALMERAH,15774,15,15414,326,19,34,2021-09-18
317408,JAKARTA SELATAN,PANCORAN,14242,6,13991,228,17,23,2021-09-18
317404,JAKARTA SELATAN,PASAR MINGGU,23655,18,23166,422,49,67,2021-09-18
317505,JAKARTA TIMUR,PASAR REBO,17571,12,17228,325,6,18,2021-09-18
317303,JAKARTA BARAT,TAMAN SARI,8722,6,8565,139,12,18,2021-09-18
317502,JAKARTA TIMUR,PULO GADUNG,21681,23,21234,397,27,50,2021-09-18
317102,JAKARTA PUSAT,SAWAH BESAR,9079,13,8864,171,31,44,2021-09-18
317104,JAKARTA PUSAT,SENEN,9339,12,9146,167,14,26,2021-09-18
317402,JAKARTA SELATAN,SETIA BUDI,11832,50,11557,182,43,93,2021-09-18
317403,JAKARTA SELATAN,MAMPANG PRAPATAN,11447,5,11239,179,24,29,2021-09-18
317304,JAKARTA BARAT,TAMBORA,14054,17,13782,247,8,25,2021-09-18
317107,JAKARTA PUSAT,TANAH ABANG,10982,16,10738,222,6,22,2021-09-18
317202,JAKARTA UTARA,TANJUNG PRIOK,25573,28,25074,423,48,76,2021-09-18
317401,JAKARTA SELATAN,TEBET,16859,10,16560,276,13,23,2021-09-18
111111,Luar DKI & Proses Update,Luar DKI & Proses Update,143008,137,141294,1273,304,441,2021-09-18
317410,JAKARTA SELATAN,PESANGGRAHAN,16262,8,15970,250,34,42,2021-09-18
317508,JAKARTA TIMUR,MAKASAR,17406,12,17087,295,12,24,2021-09-18
317308,JAKARTA BARAT,KEMBANGAN,20145,12,19818,297,18,30,2021-09-18
317203,JAKARTA UTARA,KOJA,17068,16,16695,337,20,36,2021-09-18
317506,JAKARTA TIMUR,CAKUNG,22517,25,22045,410,37,62,2021-09-18
317105,JAKARTA PUSAT,CEMPAKA PUTIH,10425,10,10235,166,14,24,2021-09-18
317301,JAKARTA BARAT,CENGKARENG,28433,34,27822,552,25,59,2021-09-18
317406,JAKARTA SELATAN,CILANDAK,17590,12,17277,260,41,53,2021-09-18
317204,JAKARTA UTARA,CILINCING,17134,14,16749,339,32,46,2021-09-18
317510,JAKARTA TIMUR,CIPAYUNG,25075,12,24746,267,50,62,2021-09-18
317509,JAKARTA TIMUR,CIRACAS,22329,20,21891,376,42,62,2021-09-18
317507,JAKARTA TIMUR,DUREN SAWIT,29316,27,28623,607,59,86,2021-09-18
317101,JAKARTA PUSAT,GAMBIR,8505,6,8357,131,11,17,2021-09-18
317504,JAKARTA TIMUR,KRAMAT JATI,21541,20,21090,398,33,53,2021-09-18
317302,JAKARTA BARAT,GROGOL PETAMBURAN,19023,12,18692,298,21,33,2021-09-18
317503,JAKARTA TIMUR,JATINEGARA,19409,18,18985,381,25,43,2021-09-18
317306,JAKARTA BARAT,KALI DERES,17914,23,17540,310,41,64,2021-09-18
317407,JAKARTA SELATAN,KEBAYORAN BARU,13780,10,13531,184,55,65,2021-09-18
317405,JAKARTA SELATAN,KEBAYORAN LAMA,19944,15,19547,356,26,41,2021-09-18
317305,JAKARTA BARAT,KEBON JERUK,21983,21,21582,368,12,33,2021-09-18
317206,JAKARTA UTARA,KELAPA GADING,12505,10,12284,192,19,29,2021-09-18
317103,JAKARTA PUSAT,KEMAYORAN,19856,16,19371,372,97,113,2021-09-18
310102,KAB.ADM.KEP.SERIBU,KEP. SERIBU SELATAN,700,0,690,10,0,0,2021-09-18
310101,KAB.ADM.KEP.SERIBU,KEP. SERIBU UTARA,628,0,622,6,0,0,2021-09-18
317409,JAKARTA SELATAN,JAGAKARSA,26468,16,26007,403,42,58,2021-09-18
317108,JAKARTA PUSAT,JOHAR BARU,8632,3,8466,157,6,9,2021-09-18
111111,Luar DKI & Proses Update,Luar DKI & Proses Update,143008,137,141294,1273,304,441,2021-09-19
317306,JAKARTA BARAT,KALI DERES,17914,22,17540,311,41,63,2021-09-19
317205,JAKARTA UTARA,PADEMANGAN,12536,16,12311,162,47,63,2021-09-19
317203,JAKARTA UTARA,KOJA,17073,16,16695,337,25,41,2021-09-19
317504,JAKARTA TIMUR,KRAMAT JATI,21544,20,21091,398,35,55,2021-09-19
317508,JAKARTA TIMUR,MAKASAR,17410,10,17090,295,15,25,2021-09-19
317403,JAKARTA SELATAN,MAMPANG PRAPATAN,11451,5,11241,179,26,31,2021-09-19
317501,JAKARTA TIMUR,MATRAMAN,14161,6,13869,277,9,15,2021-09-19
317106,JAKARTA PUSAT,MENTENG,6413,7,6280,118,8,15,2021-09-19
317307,JAKARTA BARAT,PALMERAH,15775,15,15417,326,17,32,2021-09-19
317408,JAKARTA SELATAN,PANCORAN,14246,9,13991,228,18,27,2021-09-19
317404,JAKARTA SELATAN,PASAR MINGGU,23661,19,23171,422,49,68,2021-09-19
317505,JAKARTA TIMUR,PASAR REBO,17576,11,17229,325,11,22,2021-09-19
317201,JAKARTA UTARA,PENJARINGAN,18467,25,18193,229,20,45,2021-09-19
317410,JAKARTA SELATAN,PESANGGRAHAN,16265,8,15971,250,36,44,2021-09-19
317502,JAKARTA TIMUR,PULO GADUNG,21681,19,21239,397,26,45,2021-09-19
317102,JAKARTA PUSAT,SAWAH BESAR,9080,13,8867,171,29,42,2021-09-19
317104,JAKARTA PUSAT,SENEN,9343,15,9148,167,13,28,2021-09-19
317402,JAKARTA SELATAN,SETIA BUDI,11837,48,11562,182,45,93,2021-09-19
317303,JAKARTA BARAT,TAMAN SARI,8723,5,8566,139,13,18,2021-09-19
317304,JAKARTA BARAT,TAMBORA,14057,19,13782,247,9,28,2021-09-19
317107,JAKARTA PUSAT,TANAH ABANG,10983,15,10740,222,6,21,2021-09-19
317202,JAKARTA UTARA,TANJUNG PRIOK,25577,28,25075,423,51,79,2021-09-19
317401,JAKARTA SELATAN,TEBET,16859,6,16564,276,13,19,2021-09-19
310102,KAB.ADM.KEP.SERIBU,KEP. SERIBU SELATAN,701,1,690,10,0,1,2021-09-19
317308,JAKARTA BARAT,KEMBANGAN,20147,11,19821,297,18,29,2021-09-19
310101,KAB.ADM.KEP.SERIBU,KEP. SERIBU UTARA,628,0,622,6,0,0,2021-09-19
317206,JAKARTA UTARA,KELAPA GADING,12507,11,12285,192,19,30,2021-09-19
317506,JAKARTA TIMUR,CAKUNG,22522,26,22046,410,40,66,2021-09-19
317105,JAKARTA PUSAT,CEMPAKA PUTIH,10425,10,10236,166,13,23,2021-09-19
317301,JAKARTA BARAT,CENGKARENG,28437,34,27825,553,25,59,2021-09-19
317406,JAKARTA SELATAN,CILANDAK,17591,11,17283,260,37,48,2021-09-19
317103,JAKARTA PUSAT,KEMAYORAN,19856,15,19380,372,89,104,2021-09-19
317510,JAKARTA TIMUR,CIPAYUNG,25077,12,24747,267,51,63,2021-09-19
317509,JAKARTA TIMUR,CIRACAS,22333,20,21894,376,43,63,2021-09-19
317507,JAKARTA TIMUR,DUREN SAWIT,29320,27,28624,607,62,89,2021-09-19
317101,JAKARTA PUSAT,GAMBIR,8505,5,8357,132,11,16,2021-09-19
317204,JAKARTA UTARA,CILINCING,17140,10,16753,340,37,47,2021-09-19
317409,JAKARTA SELATAN,JAGAKARSA,26469,16,26010,403,40,56,2021-09-19
317503,JAKARTA TIMUR,JATINEGARA,19415,18,18986,381,30,48,2021-09-19
317108,JAKARTA PUSAT,JOHAR BARU,8634,5,8466,157,6,11,2021-09-19
317407,JAKARTA SELATAN,KEBAYORAN BARU,13782,9,13539,184,50,59,2021-09-19
317405,JAKARTA SELATAN,KEBAYORAN LAMA,19945,13,19553,356,23,36,2021-09-19
317305,JAKARTA BARAT,KEBON JERUK,21986,20,21586,368,12,32,2021-09-19
317302,JAKARTA BARAT,GROGOL PETAMBURAN,19024,11,18695,298,20,31,2021-09-19
317106,JAKARTA PUSAT,MENTENG,6413,7,6280,118,8,15,2021-09-20
317408,JAKARTA SELATAN,PANCORAN,14250,11,13997,228,14,25,2021-09-20
317307,JAKARTA BARAT,PALMERAH,15775,15,15419,326,15,30,2021-09-20
317205,JAKARTA UTARA,PADEMANGAN,12538,11,12329,163,35,46,2021-09-20
317203,JAKARTA UTARA,KOJA,17075,13,16705,337,20,33,2021-09-20
317501,JAKARTA TIMUR,MATRAMAN,14162,5,13871,277,9,14,2021-09-20
317508,JAKARTA TIMUR,MAKASAR,17410,9,17095,295,11,20,2021-09-20
317403,JAKARTA SELATAN,MAMPANG PRAPATAN,11451,5,11245,179,22,27,2021-09-20
317404,JAKARTA SELATAN,PASAR MINGGU,23665,17,23183,423,42,59,2021-09-20
317504,JAKARTA TIMUR,KRAMAT JATI,21545,19,21097,398,31,50,2021-09-20
317505,JAKARTA TIMUR,PASAR REBO,17577,10,17230,325,12,22,2021-09-20
317509,JAKARTA TIMUR,CIRACAS,22333,19,21905,376,33,52,2021-09-20
317410,JAKARTA SELATAN,PESANGGRAHAN,16265,5,15979,250,31,36,2021-09-20
317502,JAKARTA TIMUR,PULO GADUNG,21683,11,21249,397,26,37,2021-09-20
317102,JAKARTA PUSAT,SAWAH BESAR,9080,12,8874,171,23,35,2021-09-20
317104,JAKARTA PUSAT,SENEN,9343,15,9149,167,12,27,2021-09-20
317402,JAKARTA SELATAN,SETIA BUDI,11837,48,11563,182,44,92,2021-09-20
310101,KAB.ADM.KEP.SERIBU,KEP. SERIBU UTARA,628,0,622,6,0,0,2021-09-20
317303,JAKARTA BARAT,TAMAN SARI,8723,5,8569,139,10,15,2021-09-20
317304,JAKARTA BARAT,TAMBORA,14057,17,13786,247,7,24,2021-09-20
317107,JAKARTA PUSAT,TANAH ABANG,10983,12,10744,222,5,17,2021-09-20
317202,JAKARTA UTARA,TANJUNG PRIOK,25579,24,25086,423,46,70,2021-09-20
317401,JAKARTA SELATAN,TEBET,16860,4,16572,276,8,12,2021-09-20
317201,JAKARTA UTARA,PENJARINGAN,18467,25,18197,229,16,41,2021-09-20
310102,KAB.ADM.KEP.SERIBU,KEP. SERIBU SELATAN,701,1,690,10,0,1,2021-09-20
317506,JAKARTA TIMUR,CAKUNG,22524,25,22055,410,34,59,2021-09-20
317103,JAKARTA PUSAT,KEMAYORAN,19858,15,19407,372,64,79,2021-09-20
111111,Luar DKI & Proses Update,Luar DKI & Proses Update,143008,137,141294,1273,304,441,2021-09-20
317105,JAKARTA PUSAT,CEMPAKA PUTIH,10425,8,10242,166,9,17,2021-09-20
317301,JAKARTA BARAT,CENGKARENG,28437,33,27830,553,21,54,2021-09-20
317406,JAKARTA SELATAN,CILANDAK,17593,9,17290,260,34,43,2021-09-20
317308,JAKARTA BARAT,KEMBANGAN,20149,10,19823,297,19,29,2021-09-20
317510,JAKARTA TIMUR,CIPAYUNG,25079,12,24762,267,38,50,2021-09-20
317507,JAKARTA TIMUR,DUREN SAWIT,29321,22,28639,607,53,75,2021-09-20
317101,JAKARTA PUSAT,GAMBIR,8505,5,8358,132,10,15,2021-09-20
317204,JAKARTA UTARA,CILINCING,17142,6,16767,340,29,35,2021-09-20
317409,JAKARTA SELATAN,JAGAKARSA,26469,12,26024,403,30,42,2021-09-20
317302,JAKARTA BARAT,GROGOL PETAMBURAN,19024,11,18699,298,16,27,2021-09-20
317305,JAKARTA BARAT,KEBON JERUK,21987,16,21594,368,9,25,2021-09-20
317405,JAKARTA SELATAN,KEBAYORAN LAMA,19947,12,19560,356,19,31,2021-09-20
317407,JAKARTA SELATAN,KEBAYORAN BARU,13783,10,13542,184,47,57,2021-09-20
317206,JAKARTA UTARA,KELAPA GADING,12508,11,12285,192,20,31,2021-09-20
317108,JAKARTA PUSAT,JOHAR BARU,8634,4,8467,157,6,10,2021-09-20
317503,JAKARTA TIMUR,JATINEGARA,19415,15,18994,381,25,40,2021-09-20
317306,JAKARTA BARAT,KALI DERES,17921,21,17546,312,42,63,2021-09-20
317403,JAKARTA SELATAN,MAMPANG PRAPATAN,11451,3,11250,179,19,22,2021-09-21
317408,JAKARTA SELATAN,PANCORAN,14250,9,14005,228,8,17,2021-09-21
317508,JAKARTA TIMUR,MAKASAR,17410,8,17098,295,9,17,2021-09-21
317504,JAKARTA TIMUR,KRAMAT JATI,21548,20,21107,398,23,43,2021-09-21
317203,JAKARTA UTARA,KOJA,17077,12,16710,337,18,30,2021-09-21
310101,KAB.ADM.KEP.SERIBU,KEP. SERIBU UTARA,628,0,622,6,0,0,2021-09-21
317501,JAKARTA TIMUR,MATRAMAN,14164,5,13872,277,10,15,2021-09-21
317106,JAKARTA PUSAT,MENTENG,6413,7,6280,118,8,15,2021-09-21
317205,JAKARTA UTARA,PADEMANGAN,12539,11,12332,163,33,44,2021-09-21
317307,JAKARTA BARAT,PALMERAH,15775,14,15421,326,14,28,2021-09-21
317404,JAKARTA SELATAN,PASAR MINGGU,23668,14,23196,423,35,49,2021-09-21
317107,JAKARTA PUSAT,TANAH ABANG,10983,10,10747,222,4,14,2021-09-21
317201,JAKARTA UTARA,PENJARINGAN,18470,24,18209,229,8,32,2021-09-21
317410,JAKARTA SELATAN,PESANGGRAHAN,16269,5,15984,250,30,35,2021-09-21
317502,JAKARTA TIMUR,PULO GADUNG,21685,10,21255,397,23,33,2021-09-21
317102,JAKARTA PUSAT,SAWAH BESAR,9081,13,8874,171,23,36,2021-09-21
317104,JAKARTA PUSAT,SENEN,9343,12,9154,167,10,22,2021-09-21
310102,KAB.ADM.KEP.SERIBU,KEP. SERIBU SELATAN,701,1,690,10,0,1,2021-09-21
317402,JAKARTA SELATAN,SETIA BUDI,11837,44,11571,182,40,84,2021-09-21
317304,JAKARTA BARAT,TAMBORA,14057,14,13789,248,6,20,2021-09-21
317202,JAKARTA UTARA,TANJUNG PRIOK,25583,18,25098,423,44,62,2021-09-21
317401,JAKARTA SELATAN,TEBET,16860,4,16570,278,8,12,2021-09-21
317505,JAKARTA TIMUR,PASAR REBO,17578,9,17234,325,10,19,2021-09-21
317308,JAKARTA BARAT,KEMBANGAN,20151,10,19823,297,21,31,2021-09-21
317303,JAKARTA BARAT,TAMAN SARI,8726,5,8571,139,11,16,2021-09-21
317206,JAKARTA UTARA,KELAPA GADING,12511,12,12285,192,22,34,2021-09-21
317103,JAKARTA PUSAT,KEMAYORAN,19859,13,19415,372,59,72,2021-09-21
111111,Luar DKI & Proses Update,Luar DKI & Proses Update,143008,137,141294,1273,304,441,2021-09-21
317506,JAKARTA TIMUR,CAKUNG,22524,22,22063,410,29,51,2021-09-21
317105,JAKARTA PUSAT,CEMPAKA PUTIH,10425,7,10243,166,9,16,2021-09-21
317301,JAKARTA BARAT,CENGKARENG,28441,33,27839,553,16,49,2021-09-21
317204,JAKARTA UTARA,CILINCING,17145,8,16770,340,27,35,2021-09-21
317510,JAKARTA TIMUR,CIPAYUNG,25079,9,24770,267,33,42,2021-09-21
317509,JAKARTA TIMUR,CIRACAS,22333,14,21914,376,29,43,2021-09-21
317507,JAKARTA TIMUR,DUREN SAWIT,29323,18,28652,607,46,64,2021-09-21
317406,JAKARTA SELATAN,CILANDAK,17594,9,17290,261,34,43,2021-09-21
317302,JAKARTA BARAT,GROGOL PETAMBURAN,19024,9,18705,298,12,21,2021-09-21
317409,JAKARTA SELATAN,JAGAKARSA,26473,12,26029,403,29,41,2021-09-21
317503,JAKARTA TIMUR,JATINEGARA,19417,11,19001,381,24,35,2021-09-21
317108,JAKARTA PUSAT,JOHAR BARU,8634,3,8471,157,3,6,2021-09-21
317306,JAKARTA BARAT,KALI DERES,17922,18,17559,312,33,51,2021-09-21
317407,JAKARTA SELATAN,KEBAYORAN BARU,13784,8,13554,184,38,46,2021-09-21
317405,JAKARTA SELATAN,KEBAYORAN LAMA,19951,10,19568,356,17,27,2021-09-21
317305,JAKARTA BARAT,KEBON JERUK,21990,16,21598,368,8,24,2021-09-21
317101,JAKARTA PUSAT,GAMBIR,8505,5,8359,132,9,14,2021-09-21
317408,JAKARTA SELATAN,PANCORAN,14251,9,14006,228,8,17,2021-09-22
317307,JAKARTA BARAT,PALMERAH,15776,13,15423,326,14,27,2021-09-22
317205,JAKARTA UTARA,PADEMANGAN,12546,11,12335,163,37,48,2021-09-22
317106,JAKARTA PUSAT,MENTENG,6414,5,6283,118,8,13,2021-09-22
317504,JAKARTA TIMUR,KRAMAT JATI,21554,22,21109,399,24,46,2021-09-22
317403,JAKARTA SELATAN,MAMPANG PRAPATAN,11451,3,11251,179,18,21,2021-09-22
317508,JAKARTA TIMUR,MAKASAR,17413,7,17099,295,12,19,2021-09-22
317404,JAKARTA SELATAN,PASAR MINGGU,23678,15,23200,423,40,55,2021-09-22
317501,JAKARTA TIMUR,MATRAMAN,14165,4,13876,277,8,12,2021-09-22
317505,JAKARTA TIMUR,PASAR REBO,17581,8,17236,325,12,20,2021-09-22
317202,JAKARTA UTARA,TANJUNG PRIOK,25590,17,25105,423,45,62,2021-09-22
317410,JAKARTA SELATAN,PESANGGRAHAN,16273,4,15987,251,31,35,2021-09-22
317502,JAKARTA TIMUR,PULO GADUNG,21688,7,21261,397,23,30,2021-09-22
317102,JAKARTA PUSAT,SAWAH BESAR,9082,13,8878,171,20,33,2021-09-22
317104,JAKARTA PUSAT,SENEN,9345,11,9156,167,11,22,2021-09-22
317402,JAKARTA SELATAN,SETIA BUDI,11839,36,11589,182,32,68,2021-09-22
317303,JAKARTA BARAT,TAMAN SARI,8729,8,8573,139,9,17,2021-09-22
317304,JAKARTA BARAT,TAMBORA,14057,13,13789,249,6,19,2021-09-22
317107,JAKARTA PUSAT,TANAH ABANG,10984,10,10748,222,4,14,2021-09-22
317203,JAKARTA UTARA,KOJA,17077,11,16715,337,14,25,2021-09-22
317401,JAKARTA SELATAN,TEBET,16860,3,16572,278,7,10,2021-09-22
317201,JAKARTA UTARA,PENJARINGAN,18472,24,18211,229,8,32,2021-09-22
310101,KAB.ADM.KEP.SERIBU,KEP. SERIBU UTARA,628,0,622,6,0,0,2021-09-22
310102,KAB.ADM.KEP.SERIBU,KEP. SERIBU SELATAN,701,1,690,10,0,1,2021-09-22
317308,JAKARTA BARAT,KEMBANGAN,20151,8,19826,297,20,28,2021-09-22
111111,Luar DKI & Proses Update,Luar DKI & Proses Update,143008,137,141294,1273,304,441,2021-09-22
317506,JAKARTA TIMUR,CAKUNG,22528,17,22071,410,30,47,2021-09-22
317105,JAKARTA PUSAT,CEMPAKA PUTIH,10430,5,10245,166,14,19,2021-09-22
317301,JAKARTA BARAT,CENGKARENG,28445,30,27848,554,13,43,2021-09-22
317406,JAKARTA SELATAN,CILANDAK,17598,9,17298,261,30,39,2021-09-22
317510,JAKARTA TIMUR,CIPAYUNG,25085,8,24780,267,30,38,2021-09-22
317509,JAKARTA TIMUR,CIRACAS,22334,11,21925,376,22,33,2021-09-22
317507,JAKARTA TIMUR,DUREN SAWIT,29333,15,28661,607,50,65,2021-09-22
317101,JAKARTA PUSAT,GAMBIR,8505,5,8362,132,6,11,2021-09-22
317204,JAKARTA UTARA,CILINCING,17151,11,16772,340,28,39,2021-09-22
317409,JAKARTA SELATAN,JAGAKARSA,26479,12,26036,403,28,40,2021-09-22
317503,JAKARTA TIMUR,JATINEGARA,19431,10,19007,381,33,43,2021-09-22
317108,JAKARTA PUSAT,JOHAR BARU,8638,3,8473,157,5,8,2021-09-22
317306,JAKARTA BARAT,KALI DERES,17923,17,17563,312,31,48,2021-09-22
317407,JAKARTA SELATAN,KEBAYORAN BARU,13786,6,13565,184,31,37,2021-09-22
317405,JAKARTA SELATAN,KEBAYORAN LAMA,19958,13,19574,356,15,28,2021-09-22
317305,JAKARTA BARAT,KEBON JERUK,21991,15,21601,368,7,22,2021-09-22
317206,JAKARTA UTARA,KELAPA GADING,12518,11,12292,192,23,34,2021-09-22
317302,JAKARTA BARAT,GROGOL PETAMBURAN,19024,8,18706,298,12,20,2021-09-22
317103,JAKARTA PUSAT,KEMAYORAN,19863,15,19430,372,46,61,2021-09-22
317408,JAKARTA SELATAN,PANCORAN,14253,9,14009,228,7,16,2021-09-23
317307,JAKARTA BARAT,PALMERAH,15776,11,15427,326,12,23,2021-09-23
317205,JAKARTA UTARA,PADEMANGAN,12552,5,12343,163,41,46,2021-09-23
317106,JAKARTA PUSAT,MENTENG,6414,4,6284,118,8,12,2021-09-23
317504,JAKARTA TIMUR,KRAMAT JATI,21559,19,21114,399,27,46,2021-09-23
317403,JAKARTA SELATAN,MAMPANG PRAPATAN,11450,3,11251,178,18,21,2021-09-23
317508,JAKARTA TIMUR,MAKASAR,17412,4,17099,295,14,18,2021-09-23
317404,JAKARTA SELATAN,PASAR MINGGU,23681,12,23204,424,41,53,2021-09-23
317501,JAKARTA TIMUR,MATRAMAN,14169,5,13876,277,11,16,2021-09-23
317505,JAKARTA TIMUR,PASAR REBO,17583,5,17240,325,13,18,2021-09-23
317202,JAKARTA UTARA,TANJUNG PRIOK,25597,15,25111,423,48,63,2021-09-23
317201,JAKARTA UTARA,PENJARINGAN,18475,21,18216,229,9,30,2021-09-23
317410,JAKARTA SELATAN,PESANGGRAHAN,16278,4,15992,251,31,35,2021-09-23
317502,JAKARTA TIMUR,PULO GADUNG,21689,4,21265,397,23,27,2021-09-23
317102,JAKARTA PUSAT,SAWAH BESAR,9084,11,8882,171,20,31,2021-09-23
317104,JAKARTA PUSAT,SENEN,9346,10,9157,167,12,22,2021-09-23
317402,JAKARTA SELATAN,SETIA BUDI,11841,30,11598,182,31,61,2021-09-23
317303,JAKARTA BARAT,TAMAN SARI,8730,8,8573,139,10,18,2021-09-23
317304,JAKARTA BARAT,TAMBORA,14057,10,13794,249,4,14,2021-09-23
317203,JAKARTA UTARA,KOJA,17080,8,16718,337,17,25,2021-09-23
317107,JAKARTA PUSAT,TANAH ABANG,10985,10,10749,222,4,14,2021-09-23
317401,JAKARTA SELATAN,TEBET,16863,3,16573,278,9,12,2021-09-23
310101,KAB.ADM.KEP.SERIBU,KEP. SERIBU UTARA,628,0,622,6,0,0,2021-09-23
317101,JAKARTA PUSAT,GAMBIR,8506,3,8364,132,7,10,2021-09-23
317308,JAKARTA BARAT,KEMBANGAN,20153,7,19828,297,21,28,2021-09-23
310102,KAB.ADM.KEP.SERIBU,KEP. SERIBU SELATAN,701,1,690,10,0,1,2021-09-23
317506,JAKARTA TIMUR,CAKUNG,22531,16,22080,410,25,41,2021-09-23
317105,JAKARTA PUSAT,CEMPAKA PUTIH,10433,4,10248,166,15,19,2021-09-23
317301,JAKARTA BARAT,CENGKARENG,28448,30,27849,556,13,43,2021-09-23
317406,JAKARTA SELATAN,CILANDAK,17598,7,17302,261,28,35,2021-09-23
317204,JAKARTA UTARA,CILINCING,17157,14,16773,340,30,44,2021-09-23
317510,JAKARTA TIMUR,CIPAYUNG,25089,7,24780,267,35,42,2021-09-23
317509,JAKARTA TIMUR,CIRACAS,22334,6,21930,376,22,28,2021-09-23
317507,JAKARTA TIMUR,DUREN SAWIT,29343,13,28673,607,50,63,2021-09-23
111111,Luar DKI & Proses Update,Luar DKI & Proses Update,143008,137,141294,1273,304,441,2021-09-23
317409,JAKARTA SELATAN,JAGAKARSA,26484,10,26041,403,30,40,2021-09-23
317503,JAKARTA TIMUR,JATINEGARA,19434,9,19012,381,32,41,2021-09-23
317108,JAKARTA PUSAT,JOHAR BARU,8638,3,8473,157,5,8,2021-09-23
317306,JAKARTA BARAT,KALI DERES,17927,15,17572,312,28,43,2021-09-23
317407,JAKARTA SELATAN,KEBAYORAN BARU,13788,6,13571,184,27,33,2021-09-23
317405,JAKARTA SELATAN,KEBAYORAN LAMA,19960,11,19577,356,16,27,2021-09-23
317305,JAKARTA BARAT,KEBON JERUK,21994,17,21601,368,8,25,2021-09-23
317206,JAKARTA UTARA,KELAPA GADING,12519,10,12294,192,23,33,2021-09-23
317103,JAKARTA PUSAT,KEMAYORAN,19866,16,19435,372,43,59,2021-09-23
317302,JAKARTA BARAT,GROGOL PETAMBURAN,19023,7,18708,298,10,17,2021-09-23
317106,JAKARTA PUSAT,MENTENG,6415,4,6284,118,9,13,2021-09-24
317501,JAKARTA TIMUR,MATRAMAN,14169,5,13877,277,10,15,2021-09-24
310101,KAB.ADM.KEP.SERIBU,KEP. SERIBU UTARA,628,0,622,6,0,0,2021-09-24
317508,JAKARTA TIMUR,MAKASAR,17415,4,17104,295,12,16,2021-09-24
317504,JAKARTA TIMUR,KRAMAT JATI,21559,18,21117,399,25,43,2021-09-24
317203,JAKARTA UTARA,KOJA,17079,7,16718,337,17,24,2021-09-24
317403,JAKARTA SELATAN,MAMPANG PRAPATAN,11452,2,11254,179,17,19,2021-09-24
317205,JAKARTA UTARA,PADEMANGAN,12579,6,12344,163,66,72,2021-09-24
317201,JAKARTA UTARA,PENJARINGAN,18476,22,18217,229,8,30,2021-09-24
317408,JAKARTA SELATAN,PANCORAN,14253,9,14009,228,7,16,2021-09-24
317404,JAKARTA SELATAN,PASAR MINGGU,23687,13,23208,424,42,55,2021-09-24
317505,JAKARTA TIMUR,PASAR REBO,17583,4,17243,326,10,14,2021-09-24
317410,JAKARTA SELATAN,PESANGGRAHAN,16278,4,15994,251,29,33,2021-09-24
317502,JAKARTA TIMUR,PULO GADUNG,21691,4,21271,397,19,23,2021-09-24
317102,JAKARTA PUSAT,SAWAH BESAR,9085,9,8888,172,16,25,2021-09-24
317104,JAKARTA PUSAT,SENEN,9350,10,9161,167,12,22,2021-09-24
310102,KAB.ADM.KEP.SERIBU,KEP. SERIBU SELATAN,701,1,690,10,0,1,2021-09-24
317402,JAKARTA SELATAN,SETIA BUDI,11846,26,11610,182,28,54,2021-09-24
317307,JAKARTA BARAT,PALMERAH,15776,10,15429,326,11,21,2021-09-24
317308,JAKARTA BARAT,KEMBANGAN,20154,6,19833,297,18,24,2021-09-24
317302,JAKARTA BARAT,GROGOL PETAMBURAN,19026,7,18710,298,11,18,2021-09-24
317206,JAKARTA UTARA,KELAPA GADING,12524,11,12295,192,26,37,2021-09-24
111111,Luar DKI & Proses Update,Luar DKI & Proses Update,143008,137,141294,1273,304,441,2021-09-24
317303,JAKARTA BARAT,TAMAN SARI,8730,7,8575,139,9,16,2021-09-24
317506,JAKARTA TIMUR,CAKUNG,22533,11,22086,410,26,37,2021-09-24
317105,JAKARTA PUSAT,CEMPAKA PUTIH,10434,4,10251,166,13,17,2021-09-24
317301,JAKARTA BARAT,CENGKARENG,28457,30,27862,556,9,39,2021-09-24
317406,JAKARTA SELATAN,CILANDAK,17600,5,17306,261,28,33,2021-09-24
317204,JAKARTA UTARA,CILINCING,17165,15,16782,340,28,43,2021-09-24
317510,JAKARTA TIMUR,CIPAYUNG,25097,8,24786,267,36,44,2021-09-24
317103,JAKARTA PUSAT,KEMAYORAN,19871,17,19445,372,37,54,2021-09-24
317509,JAKARTA TIMUR,CIRACAS,22338,8,21940,376,14,22,2021-09-24
317101,JAKARTA PUSAT,GAMBIR,8506,3,8364,132,7,10,2021-09-24
317409,JAKARTA SELATAN,JAGAKARSA,26486,9,26049,403,25,34,2021-09-24
317503,JAKARTA TIMUR,JATINEGARA,19437,8,19016,381,32,40,2021-09-24
317108,JAKARTA PUSAT,JOHAR BARU,8638,3,8473,157,5,8,2021-09-24
317306,JAKARTA BARAT,KALI DERES,17931,15,17576,312,28,43,2021-09-24
317407,JAKARTA SELATAN,KEBAYORAN BARU,13791,10,13579,184,18,28,2021-09-24
317405,JAKARTA SELATAN,KEBAYORAN LAMA,19963,6,19588,356,13,19,2021-09-24
317305,JAKARTA BARAT,KEBON JERUK,21996,15,21608,368,5,20,2021-09-24
317507,JAKARTA TIMUR,DUREN SAWIT,29347,9,28682,608,48,57,2021-09-24
317304,JAKARTA BARAT,TAMBORA,14056,9,13794,249,4,13,2021-09-24
317107,JAKARTA PUSAT,TANAH ABANG,10985,8,10752,222,3,11,2021-09-24
317401,JAKARTA SELATAN,TEBET,16863,2,16573,278,10,12,2021-09-24
317202,JAKARTA UTARA,TANJUNG PRIOK,25601,12,25120,423,46,58,2021-09-24
317306,JAKARTA BARAT,KALI DERES,17933,14,17579,312,28,42,2021-09-25
317510,JAKARTA TIMUR,CIPAYUNG,25099,8,24788,267,36,44,2021-09-25
317204,JAKARTA UTARA,CILINCING,17179,15,16791,340,33,48,2021-09-25
317406,JAKARTA SELATAN,CILANDAK,17601,5,17306,261,29,34,2021-09-25
317301,JAKARTA BARAT,CENGKARENG,28460,28,27866,556,10,38,2021-09-25
317105,JAKARTA PUSAT,CEMPAKA PUTIH,10435,4,10253,166,12,16,2021-09-25
317506,JAKARTA TIMUR,CAKUNG,22535,13,22085,410,27,40,2021-09-25
111111,Luar DKI & Proses Update,Luar DKI & Proses Update,143008,137,141294,1273,304,441,2021-09-25
317201,JAKARTA UTARA,PENJARINGAN,18476,19,18221,229,7,26,2021-09-25
317410,JAKARTA SELATAN,PESANGGRAHAN,16278,4,15996,251,27,31,2021-09-25
317502,JAKARTA TIMUR,PULO GADUNG,21695,2,21274,397,22,24,2021-09-25
317102,JAKARTA PUSAT,SAWAH BESAR,9085,9,8893,172,11,20,2021-09-25
317104,JAKARTA PUSAT,SENEN,9350,10,9162,167,11,21,2021-09-25
317402,JAKARTA SELATAN,SETIA BUDI,11848,15,11624,182,27,42,2021-09-25
317303,JAKARTA BARAT,TAMAN SARI,8733,8,8575,139,11,19,2021-09-25
317304,JAKARTA BARAT,TAMBORA,14065,6,13804,251,4,10,2021-09-25
317107,JAKARTA PUSAT,TANAH ABANG,10987,7,10755,222,3,10,2021-09-25
317202,JAKARTA UTARA,TANJUNG PRIOK,25604,11,25123,423,47,58,2021-09-25
317509,JAKARTA TIMUR,CIRACAS,22342,10,21940,376,16,26,2021-09-25
317507,JAKARTA TIMUR,DUREN SAWIT,29351,10,28684,608,49,59,2021-09-25
317101,JAKARTA PUSAT,GAMBIR,8507,3,8365,132,7,10,2021-09-25
317302,JAKARTA BARAT,GROGOL PETAMBURAN,19026,6,18711,298,11,17,2021-09-25
317205,JAKARTA UTARA,PADEMANGAN,12579,4,12350,163,62,66,2021-09-25
317106,JAKARTA PUSAT,MENTENG,6414,3,6284,119,8,11,2021-09-25
317501,JAKARTA TIMUR,MATRAMAN,14160,5,13868,276,11,16,2021-09-25
317403,JAKARTA SELATAN,MAMPANG PRAPATAN,11453,2,11254,179,18,20,2021-09-25
317508,JAKARTA TIMUR,MAKASAR,17428,4,17117,295,12,16,2021-09-25
317504,JAKARTA TIMUR,KRAMAT JATI,21548,17,21106,400,25,42,2021-09-25
317203,JAKARTA UTARA,KOJA,17079,4,16722,337,16,20,2021-09-25
310101,KAB.ADM.KEP.SERIBU,KEP. SERIBU UTARA,627,0,621,6,0,0,2021-09-25
310102,KAB.ADM.KEP.SERIBU,KEP. SERIBU SELATAN,702,1,691,10,0,1,2021-09-25
317401,JAKARTA SELATAN,TEBET,16869,4,16575,278,12,16,2021-09-25
317308,JAKARTA BARAT,KEMBANGAN,20159,6,19833,298,22,28,2021-09-25
317206,JAKARTA UTARA,KELAPA GADING,12528,11,12298,192,27,38,2021-09-25
317305,JAKARTA BARAT,KEBON JERUK,22000,17,21609,368,6,23,2021-09-25
317405,JAKARTA SELATAN,KEBAYORAN LAMA,19968,8,19589,356,15,23,2021-09-25
317404,JAKARTA SELATAN,PASAR MINGGU,23690,13,23210,424,43,56,2021-09-25
317407,JAKARTA SELATAN,KEBAYORAN BARU,13795,11,13581,184,19,30,2021-09-25
317505,JAKARTA TIMUR,PASAR REBO,17585,5,17244,326,10,15,2021-09-25
317108,JAKARTA PUSAT,JOHAR BARU,8641,3,8473,157,8,11,2021-09-25
317503,JAKARTA TIMUR,JATINEGARA,19440,9,19018,381,32,41,2021-09-25
317409,JAKARTA SELATAN,JAGAKARSA,26493,12,26051,403,27,39,2021-09-25
317103,JAKARTA PUSAT,KEMAYORAN,19874,16,19462,372,24,40,2021-09-25
317307,JAKARTA BARAT,PALMERAH,15783,8,15439,326,10,18,2021-09-25
317408,JAKARTA SELATAN,PANCORAN,14254,8,14010,227,9,17,2021-09-25
317303,JAKARTA BARAT,TAMAN SARI,8733,8,8576,139,10,18,2021-09-26
317203,JAKARTA UTARA,KOJA,17081,5,16723,337,16,21,2021-09-26
317504,JAKARTA TIMUR,KRAMAT JATI,21571,16,21129,401,25,41,2021-09-26
317508,JAKARTA TIMUR,MAKASAR,17428,5,17117,294,12,17,2021-09-26
317403,JAKARTA SELATAN,MAMPANG PRAPATAN,11456,2,11254,179,21,23,2021-09-26
317501,JAKARTA TIMUR,MATRAMAN,14163,5,13870,277,11,16,2021-09-26
317106,JAKARTA PUSAT,MENTENG,6415,2,6287,119,7,9,2021-09-26
317307,JAKARTA BARAT,PALMERAH,15786,8,15441,326,11,19,2021-09-26
317408,JAKARTA SELATAN,PANCORAN,14256,7,14009,227,13,20,2021-09-26
317404,JAKARTA SELATAN,PASAR MINGGU,23691,13,23213,424,41,54,2021-09-26
310101,KAB.ADM.KEP.SERIBU,KEP. SERIBU UTARA,628,0,622,6,0,0,2021-09-26
317505,JAKARTA TIMUR,PASAR REBO,17586,6,17243,326,11,17,2021-09-26
317410,JAKARTA SELATAN,PESANGGRAHAN,16281,6,15997,251,27,33,2021-09-26
317502,JAKARTA TIMUR,PULO GADUNG,21696,3,21274,397,22,25,2021-09-26
317102,JAKARTA PUSAT,SAWAH BESAR,9088,9,8896,172,11,20,2021-09-26
317104,JAKARTA PUSAT,SENEN,9350,10,9162,167,11,21,2021-09-26
317402,JAKARTA SELATAN,SETIA BUDI,11858,17,11625,182,34,51,2021-09-26
317304,JAKARTA BARAT,TAMBORA,14068,6,13807,251,4,10,2021-09-26
317107,JAKARTA PUSAT,TANAH ABANG,10988,7,10757,222,2,9,2021-09-26
317202,JAKARTA UTARA,TANJUNG PRIOK,25612,10,25126,423,53,63,2021-09-26
317401,JAKARTA SELATAN,TEBET,16870,4,16576,278,12,16,2021-09-26
317201,JAKARTA UTARA,PENJARINGAN,18486,17,18224,229,16,33,2021-09-26
310102,KAB.ADM.KEP.SERIBU,KEP. SERIBU SELATAN,702,0,692,10,0,0,2021-09-26
317205,JAKARTA UTARA,PADEMANGAN,12603,5,12350,163,85,90,2021-09-26
317103,JAKARTA PUSAT,KEMAYORAN,19875,15,19469,372,19,34,2021-09-26
111111,Luar DKI & Proses Update,Luar DKI & Proses Update,143008,137,141294,1273,304,441,2021-09-26
317506,JAKARTA TIMUR,CAKUNG,22543,14,22085,410,34,48,2021-09-26
317308,JAKARTA BARAT,KEMBANGAN,20160,6,19833,298,23,29,2021-09-26
317301,JAKARTA BARAT,CENGKARENG,28464,31,27867,556,10,41,2021-09-26
317406,JAKARTA SELATAN,CILANDAK,17605,5,17308,261,31,36,2021-09-26
317204,JAKARTA UTARA,CILINCING,17188,15,16793,340,40,55,2021-09-26
317510,JAKARTA TIMUR,CIPAYUNG,25103,8,24788,267,40,48,2021-09-26
317509,JAKARTA TIMUR,CIRACAS,22343,11,21938,376,18,29,2021-09-26
317507,JAKARTA TIMUR,DUREN SAWIT,29350,10,28683,608,49,59,2021-09-26
317101,JAKARTA PUSAT,GAMBIR,8512,3,8366,132,11,14,2021-09-26
317105,JAKARTA PUSAT,CEMPAKA PUTIH,10435,4,10253,166,12,16,2021-09-26
317409,JAKARTA SELATAN,JAGAKARSA,26499,17,26053,404,25,42,2021-09-26
317302,JAKARTA BARAT,GROGOL PETAMBURAN,19026,6,18711,298,11,17,2021-09-26
317206,JAKARTA UTARA,KELAPA GADING,12528,11,12301,192,24,35,2021-09-26
317405,JAKARTA SELATAN,KEBAYORAN LAMA,19966,8,19587,357,14,22,2021-09-26
317407,JAKARTA SELATAN,KEBAYORAN BARU,13798,11,13581,184,22,33,2021-09-26
317305,JAKARTA BARAT,KEBON JERUK,22001,17,21609,368,7,24,2021-09-26
317108,JAKARTA PUSAT,JOHAR BARU,8642,3,8473,157,9,12,2021-09-26
317503,JAKARTA TIMUR,JATINEGARA,19436,8,19015,381,32,40,2021-09-26
317306,JAKARTA BARAT,KALI DERES,17934,14,17581,312,27,41,2021-09-26
310101,KAB.ADM.KEP.SERIBU,KEP. SERIBU UTARA,628,0,622,6,0,0,2021-09-27
317501,JAKARTA TIMUR,MATRAMAN,14172,3,13879,279,11,14,2021-09-27
317203,JAKARTA UTARA,KOJA,17082,6,16724,337,15,21,2021-09-27
310102,KAB.ADM.KEP.SERIBU,KEP. SERIBU SELATAN,702,0,692,10,0,0,2021-09-27
317504,JAKARTA TIMUR,KRAMAT JATI,21564,14,21129,399,22,36,2021-09-27
317508,JAKARTA TIMUR,MAKASAR,17417,5,17106,295,11,16,2021-09-27
317403,JAKARTA SELATAN,MAMPANG PRAPATAN,11456,2,11259,179,16,18,2021-09-27
317106,JAKARTA PUSAT,MENTENG,6415,2,6289,119,5,7,2021-09-27
317505,JAKARTA TIMUR,PASAR REBO,17587,6,17244,326,11,17,2021-09-27
317307,JAKARTA BARAT,PALMERAH,15781,7,15438,326,10,17,2021-09-27
317408,JAKARTA SELATAN,PANCORAN,14259,7,14013,228,11,18,2021-09-27
317404,JAKARTA SELATAN,PASAR MINGGU,23692,13,23218,424,37,50,2021-09-27
317201,JAKARTA UTARA,PENJARINGAN,18488,17,18227,229,15,32,2021-09-27
317410,JAKARTA SELATAN,PESANGGRAHAN,16284,8,16000,251,25,33,2021-09-27
317102,JAKARTA PUSAT,SAWAH BESAR,9090,4,8903,172,11,15,2021-09-27
317502,JAKARTA TIMUR,PULO GADUNG,21696,3,21277,397,19,22,2021-09-27
317308,JAKARTA BARAT,KEMBANGAN,20162,4,19837,299,22,26,2021-09-27
317205,JAKARTA UTARA,PADEMANGAN,12603,5,12360,163,75,80,2021-09-27
317103,JAKARTA PUSAT,KEMAYORAN,19875,14,19470,372,19,33,2021-09-27
317305,JAKARTA BARAT,KEBON JERUK,22002,14,21611,369,8,22,2021-09-27
317405,JAKARTA SELATAN,KEBAYORAN LAMA,19969,5,19593,357,14,19,2021-09-27
111111,Luar DKI & Proses Update,Luar DKI & Proses Update,143008,137,141294,1273,304,441,2021-09-27
317104,JAKARTA PUSAT,SENEN,9350,10,9162,167,11,21,2021-09-27
317506,JAKARTA TIMUR,CAKUNG,22544,11,22092,410,31,42,2021-09-27
317105,JAKARTA PUSAT,CEMPAKA PUTIH,10436,2,10258,166,10,12,2021-09-27
317301,JAKARTA BARAT,CENGKARENG,28466,29,27871,556,10,39,2021-09-27
317406,JAKARTA SELATAN,CILANDAK,17606,4,17319,261,22,26,2021-09-27
317204,JAKARTA UTARA,CILINCING,17178,16,16784,340,38,54,2021-09-27
317510,JAKARTA TIMUR,CIPAYUNG,25105,7,24794,267,37,44,2021-09-27
317509,JAKARTA TIMUR,CIRACAS,22347,7,21950,376,14,21,2021-09-27
317507,JAKARTA TIMUR,DUREN SAWIT,29353,9,28691,608,45,54,2021-09-27
317101,JAKARTA PUSAT,GAMBIR,8512,2,8370,132,8,10,2021-09-27
317302,JAKARTA BARAT,GROGOL PETAMBURAN,19029,6,18715,298,10,16,2021-09-27
317409,JAKARTA SELATAN,JAGAKARSA,26500,16,26057,404,23,39,2021-09-27
317503,JAKARTA TIMUR,JATINEGARA,19441,6,19026,381,28,34,2021-09-27
317108,JAKARTA PUSAT,JOHAR BARU,8642,3,8474,157,8,11,2021-09-27
317306,JAKARTA BARAT,KALI DERES,17934,12,17588,313,21,33,2021-09-27
317407,JAKARTA SELATAN,KEBAYORAN BARU,13800,11,13586,184,19,30,2021-09-27
317206,JAKARTA UTARA,KELAPA GADING,12531,10,12308,192,21,31,2021-09-27
317402,JAKARTA SELATAN,SETIA BUDI,11874,19,11636,182,37,56,2021-09-27
317303,JAKARTA BARAT,TAMAN SARI,8734,7,8579,139,9,16,2021-09-27
317107,JAKARTA PUSAT,TANAH ABANG,10991,8,10759,222,2,10,2021-09-27
317202,JAKARTA UTARA,TANJUNG PRIOK,25613,10,25130,423,50,60,2021-09-27
317401,JAKARTA SELATAN,TEBET,16872,3,16578,278,13,16,2021-09-27
317304,JAKARTA BARAT,TAMBORA,14058,3,13802,250,3,6,2021-09-27
317307,JAKARTA BARAT,PALMERAH,15783,6,15442,326,9,15,2021-09-28
317508,JAKARTA TIMUR,MAKASAR,17417,3,17107,296,11,14,2021-09-28
317403,JAKARTA SELATAN,MAMPANG PRAPATAN,11456,2,11263,179,12,14,2021-09-28
317501,JAKARTA TIMUR,MATRAMAN,14173,3,13879,279,12,15,2021-09-28
317106,JAKARTA PUSAT,MENTENG,6415,2,6290,119,4,6,2021-09-28
317205,JAKARTA UTARA,PADEMANGAN,12608,7,12362,163,76,83,2021-09-28
317408,JAKARTA SELATAN,PANCORAN,14260,7,14013,228,12,19,2021-09-28
317404,JAKARTA SELATAN,PASAR MINGGU,23695,15,23219,425,36,51,2021-09-28
317505,JAKARTA TIMUR,PASAR REBO,17588,6,17245,326,11,17,2021-09-28
317201,JAKARTA UTARA,PENJARINGAN,18489,14,18231,229,15,29,2021-09-28
317502,JAKARTA TIMUR,PULO GADUNG,21697,3,21279,397,18,21,2021-09-28
317504,JAKARTA TIMUR,KRAMAT JATI,21562,15,21132,399,16,31,2021-09-28
317102,JAKARTA PUSAT,SAWAH BESAR,9094,3,8906,172,13,16,2021-09-28
317104,JAKARTA PUSAT,SENEN,9352,10,9165,167,10,20,2021-09-28
317402,JAKARTA SELATAN,SETIA BUDI,11876,17,11640,182,37,54,2021-09-28
317303,JAKARTA BARAT,TAMAN SARI,8734,6,8580,139,9,15,2021-09-28
317304,JAKARTA BARAT,TAMBORA,14059,3,13804,250,2,5,2021-09-28
317107,JAKARTA PUSAT,TANAH ABANG,10991,8,10759,222,2,10,2021-09-28
317202,JAKARTA UTARA,TANJUNG PRIOK,25617,7,25138,423,49,56,2021-09-28
317401,JAKARTA SELATAN,TEBET,16873,2,16579,278,14,16,2021-09-28
111111,Luar DKI & Proses Update,Luar DKI & Proses Update,143008,137,141294,1273,304,441,2021-09-28
317410,JAKARTA SELATAN,PESANGGRAHAN,16287,11,16002,251,23,34,2021-09-28
310101,KAB.ADM.KEP.SERIBU,KEP. SERIBU UTARA,628,0,622,6,0,0,2021-09-28
317203,JAKARTA UTARA,KOJA,17086,6,16724,337,19,25,2021-09-28
317101,JAKARTA PUSAT,GAMBIR,8512,1,8371,132,8,9,2021-09-28
317105,JAKARTA PUSAT,CEMPAKA PUTIH,10436,2,10257,167,10,12,2021-09-28
317301,JAKARTA BARAT,CENGKARENG,28469,30,27873,556,10,40,2021-09-28
317406,JAKARTA SELATAN,CILANDAK,17606,4,17320,261,21,25,2021-09-28
317204,JAKARTA UTARA,CILINCING,17177,15,16790,340,32,47,2021-09-28
317510,JAKARTA TIMUR,CIPAYUNG,25104,7,24797,267,33,40,2021-09-28
317509,JAKARTA TIMUR,CIRACAS,22346,7,21950,377,12,19,2021-09-28
317507,JAKARTA TIMUR,DUREN SAWIT,29354,8,28696,608,42,50,2021-09-28
310102,KAB.ADM.KEP.SERIBU,KEP. SERIBU SELATAN,702,0,692,10,0,0,2021-09-28
317302,JAKARTA BARAT,GROGOL PETAMBURAN,19029,5,18716,298,10,15,2021-09-28
317409,JAKARTA SELATAN,JAGAKARSA,26501,16,26061,404,20,36,2021-09-28
317503,JAKARTA TIMUR,JATINEGARA,19443,7,19029,381,26,33,2021-09-28
317108,JAKARTA PUSAT,JOHAR BARU,8642,2,8475,157,8,10,2021-09-28
317306,JAKARTA BARAT,KALI DERES,17938,11,17595,313,19,30,2021-09-28
317407,JAKARTA SELATAN,KEBAYORAN BARU,13801,11,13587,184,19,30,2021-09-28
317405,JAKARTA SELATAN,KEBAYORAN LAMA,19969,5,19592,358,14,19,2021-09-28
317305,JAKARTA BARAT,KEBON JERUK,22004,12,21613,369,10,22,2021-09-28
317206,JAKARTA UTARA,KELAPA GADING,12530,10,12308,192,20,30,2021-09-28
317103,JAKARTA PUSAT,KEMAYORAN,19877,12,19482,372,11,23,2021-09-28
317308,JAKARTA BARAT,KEMBANGAN,20162,3,19844,299,16,19,2021-09-28
317506,JAKARTA TIMUR,CAKUNG,22546,13,22102,410,21,34,2021-09-28
317205,JAKARTA UTARA,PADEMANGAN,12621,6,12363,163,89,95,2021-09-29
317307,JAKARTA BARAT,PALMERAH,15791,6,15451,326,8,14,2021-09-29
317106,JAKARTA PUSAT,MENTENG,6415,2,6290,119,4,6,2021-09-29
317408,JAKARTA SELATAN,PANCORAN,14260,7,14013,227,13,20,2021-09-29
317403,JAKARTA SELATAN,MAMPANG PRAPATAN,11459,3,11265,179,12,15,2021-09-29
317504,JAKARTA TIMUR,KRAMAT JATI,21557,18,21122,400,17,35,2021-09-29
317508,JAKARTA TIMUR,MAKASAR,17431,4,17122,296,9,13,2021-09-29
317501,JAKARTA TIMUR,MATRAMAN,14163,3,13871,278,11,14,2021-09-29
317404,JAKARTA SELATAN,PASAR MINGGU,23708,17,23226,425,40,57,2021-09-29
317402,JAKARTA SELATAN,SETIA BUDI,11876,15,11646,182,33,48,2021-09-29
317201,JAKARTA UTARA,PENJARINGAN,18493,12,18234,229,18,30,2021-09-29
317303,JAKARTA BARAT,TAMAN SARI,8734,5,8583,139,7,12,2021-09-29
317304,JAKARTA BARAT,TAMBORA,14067,3,13811,251,2,5,2021-09-29
317107,JAKARTA PUSAT,TANAH ABANG,10993,8,10758,222,5,13,2021-09-29
317202,JAKARTA UTARA,TANJUNG PRIOK,25620,8,25144,423,45,53,2021-09-29
317401,JAKARTA SELATAN,TEBET,16875,4,16579,278,14,18,2021-09-29
111111,Luar DKI & Proses Update,Luar DKI & Proses Update,143008,137,141294,1273,304,441,2021-09-29
317203,JAKARTA UTARA,KOJA,17087,4,16727,337,19,23,2021-09-29
317410,JAKARTA SELATAN,PESANGGRAHAN,16287,11,16003,251,22,33,2021-09-29
317502,JAKARTA TIMUR,PULO GADUNG,21700,4,21283,397,16,20,2021-09-29
317505,JAKARTA TIMUR,PASAR REBO,17591,7,17247,326,11,18,2021-09-29
310101,KAB.ADM.KEP.SERIBU,KEP. SERIBU UTARA,627,0,621,6,0,0,2021-09-29
317305,JAKARTA BARAT,KEBON JERUK,22004,12,21611,371,10,22,2021-09-29
317308,JAKARTA BARAT,KEMBANGAN,20166,5,19845,300,16,21,2021-09-29
310102,KAB.ADM.KEP.SERIBU,KEP. SERIBU SELATAN,702,0,692,10,0,0,2021-09-29
317104,JAKARTA PUSAT,SENEN,9353,10,9168,167,8,18,2021-09-29
317506,JAKARTA TIMUR,CAKUNG,22545,12,22105,410,18,30,2021-09-29
317105,JAKARTA PUSAT,CEMPAKA PUTIH,10439,3,10257,167,12,15,2021-09-29
317301,JAKARTA BARAT,CENGKARENG,28470,27,27879,556,8,35,2021-09-29
317406,JAKARTA SELATAN,CILANDAK,17608,3,17322,261,22,25,2021-09-29
317204,JAKARTA UTARA,CILINCING,17189,16,16801,340,32,48,2021-09-29
317510,JAKARTA TIMUR,CIPAYUNG,25107,7,24803,267,30,37,2021-09-29
317509,JAKARTA TIMUR,CIRACAS,22351,7,21951,377,16,23,2021-09-29
317507,JAKARTA TIMUR,DUREN SAWIT,29355,5,28701,609,40,45,2021-09-29
317102,JAKARTA PUSAT,SAWAH BESAR,9096,3,8908,172,13,16,2021-09-29
317302,JAKARTA BARAT,GROGOL PETAMBURAN,19033,5,18723,298,7,12,2021-09-29
317206,JAKARTA UTARA,KELAPA GADING,12532,9,12313,192,18,27,2021-09-29
317405,JAKARTA SELATAN,KEBAYORAN LAMA,19973,8,19592,358,15,23,2021-09-29
317407,JAKARTA SELATAN,KEBAYORAN BARU,13801,10,13589,184,18,28,2021-09-29
317101,JAKARTA PUSAT,GAMBIR,8514,0,8373,132,9,9,2021-09-29
317103,JAKARTA PUSAT,KEMAYORAN,19877,11,19484,372,10,21,2021-09-29
317306,JAKARTA BARAT,KALI DERES,17942,13,17599,313,17,30,2021-09-29
317108,JAKARTA PUSAT,JOHAR BARU,8644,2,8476,157,9,11,2021-09-29
317503,JAKARTA TIMUR,JATINEGARA,19444,8,19028,381,27,35,2021-09-29
317409,JAKARTA SELATAN,JAGAKARSA,26504,17,26063,404,20,37,2021-09-29
317504,JAKARTA TIMUR,KRAMAT JATI,21559,18,21124,401,16,34,2021-09-30
317304,JAKARTA BARAT,TAMBORA,14069,1,13814,251,3,4,2021-09-30
317403,JAKARTA SELATAN,MAMPANG PRAPATAN,11459,3,11268,179,9,12,2021-09-30
317501,JAKARTA TIMUR,MATRAMAN,14164,3,13872,278,11,14,2021-09-30
317106,JAKARTA PUSAT,MENTENG,6415,0,6293,119,3,3,2021-09-30
317203,JAKARTA UTARA,KOJA,17090,4,16731,337,18,22,2021-09-30
317508,JAKARTA TIMUR,MAKASAR,17431,3,17123,296,9,12,2021-09-30
317102,JAKARTA PUSAT,SAWAH BESAR,9098,4,8909,172,13,17,2021-09-30
317402,JAKARTA SELATAN,SETIA BUDI,11880,17,11652,182,29,46,2021-09-30
317104,JAKARTA PUSAT,SENEN,9353,8,9173,167,5,13,2021-09-30
310101,KAB.ADM.KEP.SERIBU,KEP. SERIBU UTARA,628,1,621,6,0,1,2021-09-30
317502,JAKARTA TIMUR,PULO GADUNG,21703,6,21285,397,15,21,2021-09-30
317410,JAKARTA SELATAN,PESANGGRAHAN,16289,12,16012,251,14,26,2021-09-30
317201,JAKARTA UTARA,PENJARINGAN,18495,10,18237,229,19,29,2021-09-30
317505,JAKARTA TIMUR,PASAR REBO,17593,7,17247,326,13,20,2021-09-30
317404,JAKARTA SELATAN,PASAR MINGGU,23717,16,23230,425,46,62,2021-09-30
317408,JAKARTA SELATAN,PANCORAN,14260,6,14015,227,12,18,2021-09-30
317303,JAKARTA BARAT,TAMAN SARI,8734,5,8583,139,7,12,2021-09-30
310102,KAB.ADM.KEP.SERIBU,KEP. SERIBU SELATAN,702,0,692,10,0,0,2021-09-30
317405,JAKARTA SELATAN,KEBAYORAN LAMA,19976,9,19594,358,15,24,2021-09-30
317103,JAKARTA PUSAT,KEMAYORAN,19879,12,19485,372,10,22,2021-09-30
317506,JAKARTA TIMUR,CAKUNG,22548,13,22106,410,19,32,2021-09-30
317105,JAKARTA PUSAT,CEMPAKA PUTIH,10441,3,10258,167,13,16,2021-09-30
317301,JAKARTA BARAT,CENGKARENG,28473,27,27882,556,8,35,2021-09-30
317406,JAKARTA SELATAN,CILANDAK,17611,3,17328,261,19,22,2021-09-30
317204,JAKARTA UTARA,CILINCING,17198,17,16803,340,38,55,2021-09-30
317510,JAKARTA TIMUR,CIPAYUNG,25109,8,24807,267,27,35,2021-09-30
317202,JAKARTA UTARA,TANJUNG PRIOK,25623,8,25151,423,41,49,2021-09-30
317509,JAKARTA TIMUR,CIRACAS,22355,6,21954,379,16,22,2021-09-30
317507,JAKARTA TIMUR,DUREN SAWIT,29357,5,28706,609,37,42,2021-09-30
317101,JAKARTA PUSAT,GAMBIR,8515,0,8373,132,10,10,2021-09-30
317409,JAKARTA SELATAN,JAGAKARSA,26506,17,26064,404,21,38,2021-09-30
317503,JAKARTA TIMUR,JATINEGARA,19448,7,19033,381,27,34,2021-09-30
317108,JAKARTA PUSAT,JOHAR BARU,8644,1,8477,157,9,10,2021-09-30
317306,JAKARTA BARAT,KALI DERES,17943,12,17602,313,16,28,2021-09-30
317407,JAKARTA SELATAN,KEBAYORAN BARU,13814,11,13598,184,21,32,2021-09-30
317305,JAKARTA BARAT,KEBON JERUK,22005,12,21613,371,9,21,2021-09-30
317206,JAKARTA UTARA,KELAPA GADING,12535,9,12314,192,20,29,2021-09-30
317308,JAKARTA BARAT,KEMBANGAN,20167,4,19847,300,16,20,2021-09-30
317302,JAKARTA BARAT,GROGOL PETAMBURAN,19035,5,18725,298,7,12,2021-09-30
317401,JAKARTA SELATAN,TEBET,16876,4,16582,278,12,16,2021-09-30
317307,JAKARTA BARAT,PALMERAH,15793,5,15454,326,8,13,2021-09-30
317107,JAKARTA PUSAT,TANAH ABANG,10994,7,10760,222,5,12,2021-09-30
317205,JAKARTA UTARA,PADEMANGAN,12622,6,12367,163,86,92,2021-09-30
111111,Luar DKI & Proses Update,Luar DKI & Proses Update,143008,137,141294,1273,304,441,2021-09-30
111111,Luar DKI & Proses Update,Luar DKI & Proses Update,143008,137,141294,1273,304,441,2021-10-01
317508,JAKARTA TIMUR,MAKASAR,17432,2,17126,296,8,10,2021-10-01
317403,JAKARTA SELATAN,MAMPANG PRAPATAN,11460,2,11271,179,8,10,2021-10-01
317501,JAKARTA TIMUR,MATRAMAN,14167,6,13872,278,11,17,2021-10-01
317106,JAKARTA PUSAT,MENTENG,6416,0,6294,119,3,3,2021-10-01
317205,JAKARTA UTARA,PADEMANGAN,12635,6,12371,163,95,101,2021-10-01
317307,JAKARTA BARAT,PALMERAH,15794,6,15455,326,7,13,2021-10-01
317408,JAKARTA SELATAN,PANCORAN,14261,6,14016,227,12,18,2021-10-01
317404,JAKARTA SELATAN,PASAR MINGGU,23718,15,23232,425,46,61,2021-10-01
317201,JAKARTA UTARA,PENJARINGAN,18499,12,18238,229,20,32,2021-10-01
317410,JAKARTA SELATAN,PESANGGRAHAN,16290,11,16015,251,13,24,2021-10-01
317502,JAKARTA TIMUR,PULO GADUNG,21708,8,21286,397,17,25,2021-10-01
317102,JAKARTA PUSAT,SAWAH BESAR,9099,4,8909,172,14,18,2021-10-01
317104,JAKARTA PUSAT,SENEN,9354,7,9175,167,5,12,2021-10-01
317402,JAKARTA SELATAN,SETIA BUDI,11889,19,11655,182,33,52,2021-10-01
317303,JAKARTA BARAT,TAMAN SARI,8734,5,8585,139,5,10,2021-10-01
317304,JAKARTA BARAT,TAMBORA,14069,1,13815,252,1,2,2021-10-01
317107,JAKARTA PUSAT,TANAH ABANG,10995,7,10760,222,6,13,2021-10-01
317202,JAKARTA UTARA,TANJUNG PRIOK,25632,9,25155,423,45,54,2021-10-01
317401,JAKARTA SELATAN,TEBET,16878,2,16583,278,15,17,2021-10-01
317504,JAKARTA TIMUR,KRAMAT JATI,21559,13,21133,401,12,25,2021-10-01
317203,JAKARTA UTARA,KOJA,17096,4,16735,337,20,24,2021-10-01
317505,JAKARTA TIMUR,PASAR REBO,17595,8,17252,326,9,17,2021-10-01
310102,KAB.ADM.KEP.SERIBU,KEP. SERIBU SELATAN,702,0,692,10,0,0,2021-10-01
310101,KAB.ADM.KEP.SERIBU,KEP. SERIBU UTARA,630,0,621,6,3,3,2021-10-01
317105,JAKARTA PUSAT,CEMPAKA PUTIH,10442,3,10259,167,13,16,2021-10-01
317301,JAKARTA BARAT,CENGKARENG,28475,23,27888,556,8,31,2021-10-01
317406,JAKARTA SELATAN,CILANDAK,17611,3,17332,261,15,18,2021-10-01
317204,JAKARTA UTARA,CILINCING,17198,17,16810,340,31,48,2021-10-01
317510,JAKARTA TIMUR,CIPAYUNG,25110,7,24811,267,25,32,2021-10-01
317509,JAKARTA TIMUR,CIRACAS,22350,5,21955,379,11,16,2021-10-01
317507,JAKARTA TIMUR,DUREN SAWIT,29357,4,28709,610,34,38,2021-10-01
317101,JAKARTA PUSAT,GAMBIR,8516,0,8373,132,11,11,2021-10-01
317302,JAKARTA BARAT,GROGOL PETAMBURAN,19038,6,18725,298,9,15,2021-10-01
317506,JAKARTA TIMUR,CAKUNG,22551,13,22109,410,19,32,2021-10-01
317503,JAKARTA TIMUR,JATINEGARA,19449,8,19038,381,22,30,2021-10-01
317409,JAKARTA SELATAN,JAGAKARSA,26508,18,26064,405,21,39,2021-10-01
317103,JAKARTA PUSAT,KEMAYORAN,19880,12,19485,372,11,23,2021-10-01
317206,JAKARTA UTARA,KELAPA GADING,12539,8,12316,192,23,31,2021-10-01
317305,JAKARTA BARAT,KEBON JERUK,22007,13,21614,371,9,22,2021-10-01
317308,JAKARTA BARAT,KEMBANGAN,20168,3,19848,301,16,19,2021-10-01
317407,JAKARTA SELATAN,KEBAYORAN BARU,13815,10,13600,184,21,31,2021-10-01
317306,JAKARTA BARAT,KALI DERES,17944,12,17602,314,16,28,2021-10-01
317108,JAKARTA PUSAT,JOHAR BARU,8645,2,8477,157,9,11,2021-10-01
317405,JAKARTA SELATAN,KEBAYORAN LAMA,19978,9,19595,358,16,25,2021-10-01
317505,JAKARTA TIMUR,PASAR REBO,17596,8,17252,326,10,18,2021-10-02
317501,JAKARTA TIMUR,MATRAMAN,14168,6,13873,278,11,17,2021-10-02
317106,JAKARTA PUSAT,MENTENG,6416,0,6294,119,3,3,2021-10-02
317205,JAKARTA UTARA,PADEMANGAN,12643,6,12373,163,101,107,2021-10-02
317307,JAKARTA BARAT,PALMERAH,15796,5,15456,326,9,14,2021-10-02
317408,JAKARTA SELATAN,PANCORAN,14261,1,14022,227,11,12,2021-10-02
317403,JAKARTA SELATAN,MAMPANG PRAPATAN,11460,1,11272,179,8,9,2021-10-02
317404,JAKARTA SELATAN,PASAR MINGGU,23721,12,23240,425,44,56,2021-10-02
317201,JAKARTA UTARA,PENJARINGAN,18500,12,18239,229,20,32,2021-10-02
317402,JAKARTA SELATAN,SETIA BUDI,11898,23,11655,182,38,61,2021-10-02
317502,JAKARTA TIMUR,PULO GADUNG,21711,7,21287,397,20,27,2021-10-02
317102,JAKARTA PUSAT,SAWAH BESAR,9103,5,8909,172,17,22,2021-10-02
317104,JAKARTA PUSAT,SENEN,9355,7,9176,167,5,12,2021-10-02
317303,JAKARTA BARAT,TAMAN SARI,8734,5,8585,139,5,10,2021-10-02
317304,JAKARTA BARAT,TAMBORA,14070,2,13815,252,1,3,2021-10-02
317107,JAKARTA PUSAT,TANAH ABANG,10996,6,10761,222,7,13,2021-10-02
317202,JAKARTA UTARA,TANJUNG PRIOK,25634,9,25157,423,45,54,2021-10-02
317401,JAKARTA SELATAN,TEBET,16882,4,16584,278,16,20,2021-10-02
317508,JAKARTA TIMUR,MAKASAR,17436,3,17127,296,10,13,2021-10-02
317410,JAKARTA SELATAN,PESANGGRAHAN,16296,13,16016,251,16,29,2021-10-02
317504,JAKARTA TIMUR,KRAMAT JATI,21560,13,21134,401,12,25,2021-10-02
111111,Luar DKI & Proses Update,Luar DKI & Proses Update,143008,137,141294,1273,304,441,2021-10-02
310101,KAB.ADM.KEP.SERIBU,KEP. SERIBU UTARA,631,0,621,6,4,4,2021-10-02
317506,JAKARTA TIMUR,CAKUNG,22551,9,22113,410,19,28,2021-10-02
317203,JAKARTA UTARA,KOJA,17098,3,16738,337,20,23,2021-10-02
317105,JAKARTA PUSAT,CEMPAKA PUTIH,10444,3,10259,167,15,18,2021-10-02
317301,JAKARTA BARAT,CENGKARENG,28478,24,27889,556,9,33,2021-10-02
317406,JAKARTA SELATAN,CILANDAK,17612,3,17335,261,13,16,2021-10-02
317204,JAKARTA UTARA,CILINCING,17213,20,16811,340,42,62,2021-10-02
317510,JAKARTA TIMUR,CIPAYUNG,25116,7,24812,267,30,37,2021-10-02
317509,JAKARTA TIMUR,CIRACAS,22356,5,21955,379,17,22,2021-10-02
317507,JAKARTA TIMUR,DUREN SAWIT,29358,3,28711,610,34,37,2021-10-02
317101,JAKARTA PUSAT,GAMBIR,8516,0,8373,132,11,11,2021-10-02
317302,JAKARTA BARAT,GROGOL PETAMBURAN,19038,5,18726,298,9,14,2021-10-02
317503,JAKARTA TIMUR,JATINEGARA,19449,7,19039,381,22,29,2021-10-02
317308,JAKARTA BARAT,KEMBANGAN,20172,3,19850,301,18,21,2021-10-02
317108,JAKARTA PUSAT,JOHAR BARU,8646,1,8478,157,10,11,2021-10-02
317306,JAKARTA BARAT,KALI DERES,17947,12,17609,315,11,23,2021-10-02
317407,JAKARTA SELATAN,KEBAYORAN BARU,13818,12,13601,184,21,33,2021-10-02
317405,JAKARTA SELATAN,KEBAYORAN LAMA,19980,9,19595,360,16,25,2021-10-02
317305,JAKARTA BARAT,KEBON JERUK,22010,12,21617,372,9,21,2021-10-02
317206,JAKARTA UTARA,KELAPA GADING,12539,7,12317,192,23,30,2021-10-02
317103,JAKARTA PUSAT,KEMAYORAN,19882,11,19488,372,11,22,2021-10-02
310102,KAB.ADM.KEP.SERIBU,KEP. SERIBU SELATAN,702,0,692,10,0,0,2021-10-02
317409,JAKARTA SELATAN,JAGAKARSA,26510,18,26064,405,23,41,2021-10-02
317405,JAKARTA SELATAN,KEBAYORAN LAMA,19981,9,19599,361,12,21,2021-10-03
317305,JAKARTA BARAT,KEBON JERUK,22012,10,21619,373,10,20,2021-10-03
317206,JAKARTA UTARA,KELAPA GADING,12541,6,12321,192,22,28,2021-10-03
317203,JAKARTA UTARA,KOJA,17099,4,16739,337,19,23,2021-10-03
317308,JAKARTA BARAT,KEMBANGAN,20173,4,19852,301,16,20,2021-10-03
310102,KAB.ADM.KEP.SERIBU,KEP. SERIBU SELATAN,703,0,692,10,1,1,2021-10-03
310101,KAB.ADM.KEP.SERIBU,KEP. SERIBU UTARA,631,0,621,6,4,4,2021-10-03
317407,JAKARTA SELATAN,KEBAYORAN BARU,13818,11,13602,184,21,32,2021-10-03
317103,JAKARTA PUSAT,KEMAYORAN,19882,11,19489,372,10,21,2021-10-03
317306,JAKARTA BARAT,KALI DERES,17951,13,17610,315,13,26,2021-10-03
317101,JAKARTA PUSAT,GAMBIR,8516,0,8373,132,11,11,2021-10-03
317503,JAKARTA TIMUR,JATINEGARA,19450,7,19040,381,22,29,2021-10-03
317409,JAKARTA SELATAN,JAGAKARSA,26512,17,26067,405,23,40,2021-10-03
317302,JAKARTA BARAT,GROGOL PETAMBURAN,19040,6,18726,298,10,16,2021-10-03
317507,JAKARTA TIMUR,DUREN SAWIT,29359,3,28713,610,33,36,2021-10-03
317509,JAKARTA TIMUR,CIRACAS,22356,5,21955,379,17,22,2021-10-03
317510,JAKARTA TIMUR,CIPAYUNG,25116,6,24813,267,30,36,2021-10-03
317204,JAKARTA UTARA,CILINCING,17230,18,16815,340,57,75,2021-10-03
317406,JAKARTA SELATAN,CILANDAK,17614,4,17336,261,13,17,2021-10-03
317301,JAKARTA BARAT,CENGKARENG,28482,25,27890,556,11,36,2021-10-03
317506,JAKARTA TIMUR,CAKUNG,22555,10,22113,410,22,32,2021-10-03
317108,JAKARTA PUSAT,JOHAR BARU,8646,1,8478,157,10,11,2021-10-03
317105,JAKARTA PUSAT,CEMPAKA PUTIH,10446,5,10259,167,15,20,2021-10-03
317504,JAKARTA TIMUR,KRAMAT JATI,21560,12,21136,401,11,23,2021-10-03
317501,JAKARTA TIMUR,MATRAMAN,14168,5,13875,278,10,15,2021-10-03
111111,Luar DKI & Proses Update,Luar DKI & Proses Update,143008,137,141294,1273,304,441,2021-10-03
317508,JAKARTA TIMUR,MAKASAR,17437,4,17127,296,10,14,2021-10-03
317401,JAKARTA SELATAN,TEBET,16884,4,16584,278,18,22,2021-10-03
317202,JAKARTA UTARA,TANJUNG PRIOK,25639,10,25160,424,45,55,2021-10-03
317107,JAKARTA PUSAT,TANAH ABANG,10997,6,10761,222,8,14,2021-10-03
317304,JAKARTA BARAT,TAMBORA,14071,2,13815,252,2,4,2021-10-03
317303,JAKARTA BARAT,TAMAN SARI,8734,5,8586,140,3,8,2021-10-03
317402,JAKARTA SELATAN,SETIA BUDI,11899,24,11655,182,38,62,2021-10-03
317104,JAKARTA PUSAT,SENEN,9357,8,9176,167,6,14,2021-10-03
317403,JAKARTA SELATAN,MAMPANG PRAPATAN,11460,2,11272,179,7,9,2021-10-03
317502,JAKARTA TIMUR,PULO GADUNG,21714,7,21289,397,21,28,2021-10-03
317205,JAKARTA UTARA,PADEMANGAN,12654,5,12376,163,110,115,2021-10-03
317106,JAKARTA PUSAT,MENTENG,6417,0,6294,119,4,4,2021-10-03
317307,JAKARTA BARAT,PALMERAH,15796,5,15455,327,9,14,2021-10-03
317408,JAKARTA SELATAN,PANCORAN,14262,0,14022,227,13,13,2021-10-03
317102,JAKARTA PUSAT,SAWAH BESAR,9103,5,8909,172,17,22,2021-10-03
317505,JAKARTA TIMUR,PASAR REBO,17596,8,17253,326,9,17,2021-10-03
317201,JAKARTA UTARA,PENJARINGAN,18503,15,18240,229,19,34,2021-10-03
317410,JAKARTA SELATAN,PESANGGRAHAN,16296,15,16019,251,11,26,2021-10-03
317404,JAKARTA SELATAN,PASAR MINGGU,23724,12,23244,425,43,55,2021-10-03
317403,JAKARTA SELATAN,MAMPANG PRAPATAN,11461,2,11271,179,9,11,2021-10-04
317505,JAKARTA TIMUR,PASAR REBO,17597,8,17255,326,8,16,2021-10-04
317501,JAKARTA TIMUR,MATRAMAN,14166,5,13875,277,9,14,2021-10-04
317106,JAKARTA PUSAT,MENTENG,6417,0,6295,119,3,3,2021-10-04
317205,JAKARTA UTARA,PADEMANGAN,12661,5,12385,163,108,113,2021-10-04
317307,JAKARTA BARAT,PALMERAH,15798,5,15456,327,10,15,2021-10-04
317408,JAKARTA SELATAN,PANCORAN,14264,1,14022,227,14,15,2021-10-04
317404,JAKARTA SELATAN,PASAR MINGGU,23725,9,23251,425,40,49,2021-10-04
317201,JAKARTA UTARA,PENJARINGAN,18555,13,18243,229,70,83,2021-10-04
317402,JAKARTA SELATAN,SETIA BUDI,11904,26,11656,182,40,66,2021-10-04
317502,JAKARTA TIMUR,PULO GADUNG,21715,6,21292,397,20,26,2021-10-04
317102,JAKARTA PUSAT,SAWAH BESAR,9103,4,8910,172,17,21,2021-10-04
317508,JAKARTA TIMUR,MAKASAR,17437,4,17129,296,8,12,2021-10-04
317303,JAKARTA BARAT,TAMAN SARI,8734,2,8590,140,2,4,2021-10-04
317304,JAKARTA BARAT,TAMBORA,14070,2,13814,252,2,4,2021-10-04
317107,JAKARTA PUSAT,TANAH ABANG,10998,7,10762,222,7,14,2021-10-04
317202,JAKARTA UTARA,TANJUNG PRIOK,25641,8,25165,424,44,52,2021-10-04
111111,Luar DKI & Proses Update,Luar DKI & Proses Update,143008,137,141294,1273,304,441,2021-10-04
317410,JAKARTA SELATAN,PESANGGRAHAN,16300,17,16023,251,9,26,2021-10-04
317504,JAKARTA TIMUR,KRAMAT JATI,21561,8,21143,401,9,17,2021-10-04
317401,JAKARTA SELATAN,TEBET,16884,4,16584,278,18,22,2021-10-04
310101,KAB.ADM.KEP.SERIBU,KEP. SERIBU UTARA,631,0,621,6,4,4,2021-10-04
317506,JAKARTA TIMUR,CAKUNG,22554,9,22114,410,21,30,2021-10-04
317105,JAKARTA PUSAT,CEMPAKA PUTIH,10446,5,10261,167,13,18,2021-10-04
317203,JAKARTA UTARA,KOJA,17101,4,16741,337,19,23,2021-10-04
317301,JAKARTA BARAT,CENGKARENG,28489,25,27889,556,19,44,2021-10-04
317406,JAKARTA SELATAN,CILANDAK,17615,4,17337,261,13,17,2021-10-04
317204,JAKARTA UTARA,CILINCING,17235,16,16819,340,60,76,2021-10-04
317510,JAKARTA TIMUR,CIPAYUNG,25118,8,24819,267,24,32,2021-10-04
317509,JAKARTA TIMUR,CIRACAS,22356,5,21956,379,16,21,2021-10-04
317507,JAKARTA TIMUR,DUREN SAWIT,29360,4,28715,610,31,35,2021-10-04
317101,JAKARTA PUSAT,GAMBIR,8516,0,8373,132,11,11,2021-10-04
317302,JAKARTA BARAT,GROGOL PETAMBURAN,19040,6,18727,298,9,15,2021-10-04
317104,JAKARTA PUSAT,SENEN,9357,8,9177,167,5,13,2021-10-04
317503,JAKARTA TIMUR,JATINEGARA,19450,6,19051,381,12,18,2021-10-04
317103,JAKARTA PUSAT,KEMAYORAN,19883,6,19495,372,10,16,2021-10-04
317308,JAKARTA BARAT,KEMBANGAN,20175,5,19851,301,18,23,2021-10-04
310102,KAB.ADM.KEP.SERIBU,KEP. SERIBU SELATAN,703,0,692,10,1,1,2021-10-04
317206,JAKARTA UTARA,KELAPA GADING,12541,4,12325,192,20,24,2021-10-04
317409,JAKARTA SELATAN,JAGAKARSA,26513,15,26073,405,20,35,2021-10-04
317405,JAKARTA SELATAN,KEBAYORAN LAMA,19984,9,19601,361,13,22,2021-10-04
317407,JAKARTA SELATAN,KEBAYORAN BARU,13819,11,13605,184,19,30,2021-10-04
317306,JAKARTA BARAT,KALI DERES,17952,13,17611,315,13,26,2021-10-04
317108,JAKARTA PUSAT,JOHAR BARU,8646,1,8481,157,7,8,2021-10-04
317305,JAKARTA BARAT,KEBON JERUK,22012,9,21620,373,10,19,2021-10-04
317201,JAKARTA UTARA,PENJARINGAN,18556,11,18247,229,69,80,2021-10-05
317106,JAKARTA PUSAT,MENTENG,6417,0,6295,119,3,3,2021-10-05
317205,JAKARTA UTARA,PADEMANGAN,12663,7,12386,163,107,114,2021-10-05
317307,JAKARTA BARAT,PALMERAH,15799,5,15456,327,11,16,2021-10-05
317408,JAKARTA SELATAN,PANCORAN,14265,1,14025,227,12,13,2021-10-05
317404,JAKARTA SELATAN,PASAR MINGGU,23725,6,23258,425,36,42,2021-10-05
317505,JAKARTA TIMUR,PASAR REBO,17599,9,17256,326,8,17,2021-10-05
317410,JAKARTA SELATAN,PESANGGRAHAN,16302,19,16027,251,5,24,2021-10-05
317402,JAKARTA SELATAN,SETIA BUDI,11908,28,11658,182,40,68,2021-10-05
317102,JAKARTA PUSAT,SAWAH BESAR,9103,4,8912,172,15,19,2021-10-05
317104,JAKARTA PUSAT,SENEN,9359,7,9180,168,4,11,2021-10-05
317501,JAKARTA TIMUR,MATRAMAN,14168,4,13879,278,7,11,2021-10-05
317303,JAKARTA BARAT,TAMAN SARI,8734,2,8590,140,2,4,2021-10-05
317304,JAKARTA BARAT,TAMBORA,14071,2,13815,252,2,4,2021-10-05
317107,JAKARTA PUSAT,TANAH ABANG,11000,7,10763,222,8,15,2021-10-05
317202,JAKARTA UTARA,TANJUNG PRIOK,25642,7,25172,424,39,46,2021-10-05
317401,JAKARTA SELATAN,TEBET,16884,4,16586,278,16,20,2021-10-05
111111,Luar DKI & Proses Update,Luar DKI & Proses Update,143008,137,141294,1273,304,441,2021-10-05
317502,JAKARTA TIMUR,PULO GADUNG,21718,7,21291,398,22,29,2021-10-05
317403,JAKARTA SELATAN,MAMPANG PRAPATAN,11462,2,11272,179,9,11,2021-10-05
310101,KAB.ADM.KEP.SERIBU,KEP. SERIBU UTARA,631,0,621,6,4,4,2021-10-05
317504,JAKARTA TIMUR,KRAMAT JATI,21563,7,21148,401,7,14,2021-10-05
317506,JAKARTA TIMUR,CAKUNG,22555,9,22119,410,17,26,2021-10-05
317105,JAKARTA PUSAT,CEMPAKA PUTIH,10447,5,10265,167,10,15,2021-10-05
317301,JAKARTA BARAT,CENGKARENG,28492,25,27894,556,17,42,2021-10-05
317406,JAKARTA SELATAN,CILANDAK,17616,3,17338,261,14,17,2021-10-05
317204,JAKARTA UTARA,CILINCING,17240,13,16823,340,64,77,2021-10-05
317510,JAKARTA TIMUR,CIPAYUNG,25118,8,24823,267,20,28,2021-10-05
317509,JAKARTA TIMUR,CIRACAS,22356,3,21958,379,16,19,2021-10-05
317507,JAKARTA TIMUR,DUREN SAWIT,29362,4,28725,610,23,27,2021-10-05
317101,JAKARTA PUSAT,GAMBIR,8517,0,8374,132,11,11,2021-10-05
317508,JAKARTA TIMUR,MAKASAR,17437,4,17132,296,5,9,2021-10-05
317302,JAKARTA BARAT,GROGOL PETAMBURAN,19040,6,18727,298,9,15,2021-10-05
317503,JAKARTA TIMUR,JATINEGARA,19451,6,19054,381,10,16,2021-10-05
317108,JAKARTA PUSAT,JOHAR BARU,8646,1,8481,157,7,8,2021-10-05
317306,JAKARTA BARAT,KALI DERES,17953,14,17610,316,13,27,2021-10-05
317405,JAKARTA SELATAN,KEBAYORAN LAMA,19984,7,19606,361,10,17,2021-10-05
317305,JAKARTA BARAT,KEBON JERUK,22013,8,21623,373,9,17,2021-10-05
317206,JAKARTA UTARA,KELAPA GADING,12541,4,12327,192,18,22,2021-10-05
317103,JAKARTA PUSAT,KEMAYORAN,19885,6,19496,372,11,17,2021-10-05
317308,JAKARTA BARAT,KEMBANGAN,20177,5,19854,301,17,22,2021-10-05
310102,KAB.ADM.KEP.SERIBU,KEP. SERIBU SELATAN,703,0,692,10,1,1,2021-10-05
317203,JAKARTA UTARA,KOJA,17102,4,16743,337,18,22,2021-10-05
317409,JAKARTA SELATAN,JAGAKARSA,26518,15,26077,405,21,36,2021-10-05
317407,JAKARTA SELATAN,KEBAYORAN BARU,13820,9,13609,184,18,27,2021-10-05
111111,Luar DKI & Proses Update,Luar DKI & Proses Update,143008,137,141294,1273,304,441,2021-10-06
317307,JAKARTA BARAT,PALMERAH,15799,5,15456,327,11,16,2021-10-06
317408,JAKARTA SELATAN,PANCORAN,14267,2,14026,227,12,14,2021-10-06
310101,KAB.ADM.KEP.SERIBU,KEP. SERIBU UTARA,633,0,621,6,6,6,2021-10-06
317504,JAKARTA TIMUR,KRAMAT JATI,21563,5,21150,401,7,12,2021-10-06
317508,JAKARTA TIMUR,MAKASAR,17438,4,17132,296,6,10,2021-10-06
317403,JAKARTA SELATAN,MAMPANG PRAPATAN,11463,2,11273,179,9,11,2021-10-06
317501,JAKARTA TIMUR,MATRAMAN,14171,5,13880,278,8,13,2021-10-06
317106,JAKARTA PUSAT,MENTENG,6418,1,6295,119,3,4,2021-10-06
317205,JAKARTA UTARA,PADEMANGAN,12668,7,12413,163,85,92,2021-10-06
317404,JAKARTA SELATAN,PASAR MINGGU,23731,7,23259,425,40,47,2021-10-06
317505,JAKARTA TIMUR,PASAR REBO,17602,8,17257,326,11,19,2021-10-06
310102,KAB.ADM.KEP.SERIBU,KEP. SERIBU SELATAN,703,0,692,10,1,1,2021-10-06
317201,JAKARTA UTARA,PENJARINGAN,18560,13,18248,229,70,83,2021-10-06
317502,JAKARTA TIMUR,PULO GADUNG,21721,9,21293,398,21,30,2021-10-06
317102,JAKARTA PUSAT,SAWAH BESAR,9106,4,8912,172,18,22,2021-10-06
317104,JAKARTA PUSAT,SENEN,9359,7,9180,168,4,11,2021-10-06
317402,JAKARTA SELATAN,SETIA BUDI,11912,30,11664,182,36,66,2021-10-06
317303,JAKARTA BARAT,TAMAN SARI,8734,2,8590,140,2,4,2021-10-06
317304,JAKARTA BARAT,TAMBORA,14074,4,13815,252,3,7,2021-10-06
317107,JAKARTA PUSAT,TANAH ABANG,11000,7,10763,222,8,15,2021-10-06
317202,JAKARTA UTARA,TANJUNG PRIOK,25648,8,25177,424,39,47,2021-10-06
317401,JAKARTA SELATAN,TEBET,16887,5,16587,278,17,22,2021-10-06
317410,JAKARTA SELATAN,PESANGGRAHAN,16304,18,16029,251,6,24,2021-10-06
317308,JAKARTA BARAT,KEMBANGAN,20178,5,19854,302,17,22,2021-10-06
317203,JAKARTA UTARA,KOJA,17104,5,16743,337,19,24,2021-10-06
317206,JAKARTA UTARA,KELAPA GADING,12541,4,12331,192,14,18,2021-10-06
317506,JAKARTA TIMUR,CAKUNG,22560,8,22122,410,20,28,2021-10-06
317105,JAKARTA PUSAT,CEMPAKA PUTIH,10449,3,10267,167,12,15,2021-10-06
317301,JAKARTA BARAT,CENGKARENG,28493,22,27898,556,17,39,2021-10-06
317406,JAKARTA SELATAN,CILANDAK,17618,4,17339,261,14,18,2021-10-06
317204,JAKARTA UTARA,CILINCING,17259,8,16831,340,80,88,2021-10-06
317103,JAKARTA PUSAT,KEMAYORAN,19885,6,19499,372,8,14,2021-10-06
317509,JAKARTA TIMUR,CIRACAS,22357,3,21959,379,16,19,2021-10-06
317507,JAKARTA TIMUR,DUREN SAWIT,29364,2,28736,610,16,18,2021-10-06
317101,JAKARTA PUSAT,GAMBIR,8521,2,8374,132,13,15,2021-10-06
317510,JAKARTA TIMUR,CIPAYUNG,25121,7,24830,267,17,24,2021-10-06
317409,JAKARTA SELATAN,JAGAKARSA,26520,13,26082,405,20,33,2021-10-06
317503,JAKARTA TIMUR,JATINEGARA,19451,6,19055,381,9,15,2021-10-06
317108,JAKARTA PUSAT,JOHAR BARU,8646,1,8481,157,7,8,2021-10-06
317306,JAKARTA BARAT,KALI DERES,17953,13,17614,316,10,23,2021-10-06
317407,JAKARTA SELATAN,KEBAYORAN BARU,13821,9,13610,184,18,27,2021-10-06
317405,JAKARTA SELATAN,KEBAYORAN LAMA,19987,7,19606,361,13,20,2021-10-06
317305,JAKARTA BARAT,KEBON JERUK,22016,8,21625,373,10,18,2021-10-06
317302,JAKARTA BARAT,GROGOL PETAMBURAN,19041,7,18729,298,7,14,2021-10-06
317501,JAKARTA TIMUR,MATRAMAN,14171,5,13881,278,7,12,2021-10-07
317404,JAKARTA SELATAN,PASAR MINGGU,23738,8,23265,425,40,48,2021-10-07
317408,JAKARTA SELATAN,PANCORAN,14269,2,14028,227,12,14,2021-10-07
317307,JAKARTA BARAT,PALMERAH,15800,6,15456,327,11,17,2021-10-07
317205,JAKARTA UTARA,PADEMANGAN,12669,6,12415,163,85,91,2021-10-07
317403,JAKARTA SELATAN,MAMPANG PRAPATAN,11463,2,11274,179,8,10,2021-10-07
317504,JAKARTA TIMUR,KRAMAT JATI,21563,5,21150,401,7,12,2021-10-07
317508,JAKARTA TIMUR,MAKASAR,17438,4,17132,296,6,10,2021-10-07
317505,JAKARTA TIMUR,PASAR REBO,17602,7,17258,326,11,18,2021-10-07
317106,JAKARTA PUSAT,MENTENG,6419,2,6296,119,2,4,2021-10-07
317201,JAKARTA UTARA,PENJARINGAN,18565,12,18249,229,75,87,2021-10-07
317308,JAKARTA BARAT,KEMBANGAN,20184,5,19854,302,23,28,2021-10-07
317502,JAKARTA TIMUR,PULO GADUNG,21721,8,21298,398,17,25,2021-10-07
317102,JAKARTA PUSAT,SAWAH BESAR,9112,3,8913,172,24,27,2021-10-07
317104,JAKARTA PUSAT,SENEN,9359,5,9183,168,3,8,2021-10-07
317402,JAKARTA SELATAN,SETIA BUDI,11915,31,11666,182,36,67,2021-10-07
317303,JAKARTA BARAT,TAMAN SARI,8735,2,8591,140,2,4,2021-10-07
317304,JAKARTA BARAT,TAMBORA,14076,6,13815,252,3,9,2021-10-07
317203,JAKARTA UTARA,KOJA,17114,5,16743,337,29,34,2021-10-07
317107,JAKARTA PUSAT,TANAH ABANG,11001,5,10765,222,9,14,2021-10-07
317202,JAKARTA UTARA,TANJUNG PRIOK,25657,9,25180,424,44,53,2021-10-07
317401,JAKARTA SELATAN,TEBET,16890,6,16594,278,12,18,2021-10-07
317410,JAKARTA SELATAN,PESANGGRAHAN,16306,18,16030,251,7,25,2021-10-07
310101,KAB.ADM.KEP.SERIBU,KEP. SERIBU UTARA,633,0,621,6,6,6,2021-10-07
317507,JAKARTA TIMUR,DUREN SAWIT,29368,2,28739,610,17,19,2021-10-07
111111,Luar DKI & Proses Update,Luar DKI & Proses Update,143008,137,141294,1273,304,441,2021-10-07
310102,KAB.ADM.KEP.SERIBU,KEP. SERIBU SELATAN,703,0,692,10,1,1,2021-10-07
317506,JAKARTA TIMUR,CAKUNG,22563,7,22124,410,22,29,2021-10-07
317105,JAKARTA PUSAT,CEMPAKA PUTIH,10452,5,10268,167,12,17,2021-10-07
317301,JAKARTA BARAT,CENGKARENG,28499,19,27903,556,21,40,2021-10-07
317406,JAKARTA SELATAN,CILANDAK,17620,4,17340,261,15,19,2021-10-07
317204,JAKARTA UTARA,CILINCING,17266,7,16837,340,82,89,2021-10-07
317509,JAKARTA TIMUR,CIRACAS,22361,2,21963,379,17,19,2021-10-07
317101,JAKARTA PUSAT,GAMBIR,8523,3,8374,133,13,16,2021-10-07
317302,JAKARTA BARAT,GROGOL PETAMBURAN,19043,8,18729,298,8,16,2021-10-07
317510,JAKARTA TIMUR,CIPAYUNG,25121,7,24831,267,16,23,2021-10-07
317503,JAKARTA TIMUR,JATINEGARA,19453,6,19059,381,7,13,2021-10-07
317409,JAKARTA SELATAN,JAGAKARSA,26525,10,26085,405,25,35,2021-10-07
317206,JAKARTA UTARA,KELAPA GADING,12546,4,12334,192,16,20,2021-10-07
317305,JAKARTA BARAT,KEBON JERUK,22017,6,21627,373,11,17,2021-10-07
317405,JAKARTA SELATAN,KEBAYORAN LAMA,19988,7,19608,361,12,19,2021-10-07
317103,JAKARTA PUSAT,KEMAYORAN,19887,6,19500,372,9,15,2021-10-07
317306,JAKARTA BARAT,KALI DERES,17953,13,17616,316,8,21,2021-10-07
317108,JAKARTA PUSAT,JOHAR BARU,8647,2,8482,157,6,8,2021-10-07
317407,JAKARTA SELATAN,KEBAYORAN BARU,13821,9,13613,184,15,24,2021-10-07
317307,JAKARTA BARAT,PALMERAH,15800,6,15458,327,9,15,2021-10-08
310101,KAB.ADM.KEP.SERIBU,KEP. SERIBU UTARA,633,0,621,6,6,6,2021-10-08
317203,JAKARTA UTARA,KOJA,17118,4,16744,337,33,37,2021-10-08
317504,JAKARTA TIMUR,KRAMAT JATI,21564,5,21150,401,8,13,2021-10-08
317508,JAKARTA TIMUR,MAKASAR,17440,3,17133,296,8,11,2021-10-08
317403,JAKARTA SELATAN,MAMPANG PRAPATAN,11467,5,11276,179,7,12,2021-10-08
317501,JAKARTA TIMUR,MATRAMAN,14173,4,13882,278,9,13,2021-10-08
317106,JAKARTA PUSAT,MENTENG,6419,2,6296,119,2,4,2021-10-08
317205,JAKARTA UTARA,PADEMANGAN,12674,5,12440,163,66,71,2021-10-08
317408,JAKARTA SELATAN,PANCORAN,14270,2,14032,227,9,11,2021-10-08
317402,JAKARTA SELATAN,SETIA BUDI,11918,28,11685,182,23,51,2021-10-08
317505,JAKARTA TIMUR,PASAR REBO,17604,5,17261,326,12,17,2021-10-08
317201,JAKARTA UTARA,PENJARINGAN,18568,12,18259,229,68,80,2021-10-08
317410,JAKARTA SELATAN,PESANGGRAHAN,16309,18,16032,251,8,26,2021-10-08
317502,JAKARTA TIMUR,PULO GADUNG,21726,8,21298,398,22,30,2021-10-08
317102,JAKARTA PUSAT,SAWAH BESAR,9112,2,8916,172,22,24,2021-10-08
317104,JAKARTA PUSAT,SENEN,9359,5,9183,168,3,8,2021-10-08
317202,JAKARTA UTARA,TANJUNG PRIOK,25662,10,25188,424,40,50,2021-10-08
317401,JAKARTA SELATAN,TEBET,16890,6,16594,278,12,18,2021-10-08
310102,KAB.ADM.KEP.SERIBU,KEP. SERIBU SELATAN,703,0,692,10,1,1,2021-10-08
317404,JAKARTA SELATAN,PASAR MINGGU,23738,8,23266,425,39,47,2021-10-08
317308,JAKARTA BARAT,KEMBANGAN,20185,5,19859,302,19,24,2021-10-08
317303,JAKARTA BARAT,TAMAN SARI,8736,2,8593,140,1,3,2021-10-08
317206,JAKARTA UTARA,KELAPA GADING,12550,4,12336,192,18,22,2021-10-08
111111,Luar DKI & Proses Update,Luar DKI & Proses Update,143008,137,141294,1273,304,441,2021-10-08
317107,JAKARTA PUSAT,TANAH ABANG,11002,6,10765,222,9,15,2021-10-08
317506,JAKARTA TIMUR,CAKUNG,22568,5,22133,410,20,25,2021-10-08
317105,JAKARTA PUSAT,CEMPAKA PUTIH,10452,5,10269,167,11,16,2021-10-08
317301,JAKARTA BARAT,CENGKARENG,28506,20,27906,556,24,44,2021-10-08
317406,JAKARTA SELATAN,CILANDAK,17622,5,17344,261,12,17,2021-10-08
317204,JAKARTA UTARA,CILINCING,17282,6,16845,340,91,97,2021-10-08
317510,JAKARTA TIMUR,CIPAYUNG,25122,6,24838,267,11,17,2021-10-08
317103,JAKARTA PUSAT,KEMAYORAN,19888,6,19503,372,7,13,2021-10-08
317509,JAKARTA TIMUR,CIRACAS,22363,0,21967,379,17,17,2021-10-08
317101,JAKARTA PUSAT,GAMBIR,8524,3,8377,133,11,14,2021-10-08
317302,JAKARTA BARAT,GROGOL PETAMBURAN,19043,8,18729,298,8,16,2021-10-08
317409,JAKARTA SELATAN,JAGAKARSA,26534,12,26094,405,23,35,2021-10-08
317503,JAKARTA TIMUR,JATINEGARA,19458,4,19061,381,12,16,2021-10-08
317108,JAKARTA PUSAT,JOHAR BARU,8647,2,8485,157,3,5,2021-10-08
317306,JAKARTA BARAT,KALI DERES,17953,12,17617,316,8,20,2021-10-08
317407,JAKARTA SELATAN,KEBAYORAN BARU,13823,9,13618,184,12,21,2021-10-08
317405,JAKARTA SELATAN,KEBAYORAN LAMA,19990,7,19609,361,13,20,2021-10-08
317305,JAKARTA BARAT,KEBON JERUK,22021,7,21628,373,13,20,2021-10-08
317507,JAKARTA TIMUR,DUREN SAWIT,29375,2,28742,610,21,23,2021-10-08
317304,JAKARTA BARAT,TAMBORA,14076,6,13815,252,3,9,2021-10-08
111111,Luar DKI & Proses Update,Luar DKI & Proses Update,143008,137,141294,1273,304,441,2021-10-09
317408,JAKARTA SELATAN,PANCORAN,14272,2,14032,227,11,13,2021-10-09
317506,JAKARTA TIMUR,CAKUNG,22571,7,22133,410,21,28,2021-10-09
317508,JAKARTA TIMUR,MAKASAR,17440,3,17133,296,8,11,2021-10-09
317403,JAKARTA SELATAN,MAMPANG PRAPATAN,11469,5,11277,179,8,13,2021-10-09
317501,JAKARTA TIMUR,MATRAMAN,14173,4,13882,278,9,13,2021-10-09
317106,JAKARTA PUSAT,MENTENG,6421,4,6296,119,2,6,2021-10-09
317205,JAKARTA UTARA,PADEMANGAN,12675,3,12442,163,67,70,2021-10-09
317307,JAKARTA BARAT,PALMERAH,15802,6,15462,328,6,12,2021-10-09
317404,JAKARTA SELATAN,PASAR MINGGU,23739,8,23267,425,39,47,2021-10-09
317505,JAKARTA TIMUR,PASAR REBO,17604,5,17261,326,12,17,2021-10-09
317504,JAKARTA TIMUR,KRAMAT JATI,21565,6,21152,401,6,12,2021-10-09
317410,JAKARTA SELATAN,PESANGGRAHAN,16314,16,16034,251,13,29,2021-10-09
317102,JAKARTA PUSAT,SAWAH BESAR,9112,2,8917,172,21,23,2021-10-09
317104,JAKARTA PUSAT,SENEN,9359,5,9183,168,3,8,2021-10-09
317402,JAKARTA SELATAN,SETIA BUDI,11919,22,11692,182,23,45,2021-10-09
317303,JAKARTA BARAT,TAMAN SARI,8736,2,8593,140,1,3,2021-10-09
317304,JAKARTA BARAT,TAMBORA,14076,6,13815,252,3,9,2021-10-09
317107,JAKARTA PUSAT,TANAH ABANG,11003,5,10766,222,10,15,2021-10-09
317202,JAKARTA UTARA,TANJUNG PRIOK,25667,10,25189,424,44,54,2021-10-09
317401,JAKARTA SELATAN,TEBET,16890,6,16594,278,12,18,2021-10-09
317502,JAKARTA TIMUR,PULO GADUNG,21727,9,21298,398,22,31,2021-10-09
317203,JAKARTA UTARA,KOJA,17123,3,16745,337,38,41,2021-10-09
317201,JAKARTA UTARA,PENJARINGAN,18569,11,18260,229,69,80,2021-10-09
310102,KAB.ADM.KEP.SERIBU,KEP. SERIBU SELATAN,703,0,692,10,1,1,2021-10-09
310101,KAB.ADM.KEP.SERIBU,KEP. SERIBU UTARA,636,0,624,6,6,6,2021-10-09
317105,JAKARTA PUSAT,CEMPAKA PUTIH,10453,5,10269,167,12,17,2021-10-09
317301,JAKARTA BARAT,CENGKARENG,28508,19,27910,556,23,42,2021-10-09
317406,JAKARTA SELATAN,CILANDAK,17622,5,17345,261,11,16,2021-10-09
317204,JAKARTA UTARA,CILINCING,17284,6,16845,340,93,99,2021-10-09
317510,JAKARTA TIMUR,CIPAYUNG,25123,7,24838,267,11,18,2021-10-09
317507,JAKARTA TIMUR,DUREN SAWIT,29377,2,28743,610,22,24,2021-10-09
317101,JAKARTA PUSAT,GAMBIR,8524,3,8379,133,9,12,2021-10-09
317302,JAKARTA BARAT,GROGOL PETAMBURAN,19044,8,18729,298,9,17,2021-10-09
317409,JAKARTA SELATAN,JAGAKARSA,26536,10,26096,405,25,35,2021-10-09
317509,JAKARTA TIMUR,CIRACAS,22364,0,21968,379,17,17,2021-10-09
317503,JAKARTA TIMUR,JATINEGARA,19460,4,19061,381,14,18,2021-10-09
317103,JAKARTA PUSAT,KEMAYORAN,19893,9,19504,372,8,17,2021-10-09
317206,JAKARTA UTARA,KELAPA GADING,12550,2,12338,192,18,20,2021-10-09
317305,JAKARTA BARAT,KEBON JERUK,22023,8,21630,373,12,20,2021-10-09
317405,JAKARTA SELATAN,KEBAYORAN LAMA,19994,7,19609,362,16,23,2021-10-09
317308,JAKARTA BARAT,KEMBANGAN,20185,5,19860,302,18,23,2021-10-09
317306,JAKARTA BARAT,KALI DERES,17954,12,17618,316,8,20,2021-10-09
317108,JAKARTA PUSAT,JOHAR BARU,8649,3,8485,157,4,7,2021-10-09
317407,JAKARTA SELATAN,KEBAYORAN BARU,13823,9,13618,184,12,21,2021-10-09
317201,JAKARTA UTARA,PENJARINGAN,18570,11,18260,229,70,81,2021-10-10
317403,JAKARTA SELATAN,MAMPANG PRAPATAN,11470,5,11277,179,9,14,2021-10-10
317501,JAKARTA TIMUR,MATRAMAN,14175,4,13882,278,11,15,2021-10-10
317106,JAKARTA PUSAT,MENTENG,6421,4,6296,119,2,6,2021-10-10
317205,JAKARTA UTARA,PADEMANGAN,12679,4,12442,163,70,74,2021-10-10
317307,JAKARTA BARAT,PALMERAH,15802,5,15463,328,6,11,2021-10-10
317408,JAKARTA SELATAN,PANCORAN,14274,2,14032,227,13,15,2021-10-10
317404,JAKARTA SELATAN,PASAR MINGGU,23742,7,23268,425,42,49,2021-10-10
317505,JAKARTA TIMUR,PASAR REBO,17604,5,17261,326,12,17,2021-10-10
317410,JAKARTA SELATAN,PESANGGRAHAN,16315,13,16037,251,14,27,2021-10-10
111111,Luar DKI & Proses Update,Luar DKI & Proses Update,143008,137,141294,1273,304,441,2021-10-10
317102,JAKARTA PUSAT,SAWAH BESAR,9114,2,8919,172,21,23,2021-10-10
317104,JAKARTA PUSAT,SENEN,9359,5,9183,168,3,8,2021-10-10
317402,JAKARTA SELATAN,SETIA BUDI,11923,22,11692,182,27,49,2021-10-10
317303,JAKARTA BARAT,TAMAN SARI,8737,1,8594,140,2,3,2021-10-10
317304,JAKARTA BARAT,TAMBORA,14076,5,13816,252,3,8,2021-10-10
317107,JAKARTA PUSAT,TANAH ABANG,11003,3,10768,222,10,13,2021-10-10
317202,JAKARTA UTARA,TANJUNG PRIOK,25671,10,25189,424,48,58,2021-10-10
317401,JAKARTA SELATAN,TEBET,16890,6,16595,278,11,17,2021-10-10
317508,JAKARTA TIMUR,MAKASAR,17440,3,17134,296,7,10,2021-10-10
317502,JAKARTA TIMUR,PULO GADUNG,21730,11,21298,398,23,34,2021-10-10
317203,JAKARTA UTARA,KOJA,17124,3,16745,337,39,42,2021-10-10
317504,JAKARTA TIMUR,KRAMAT JATI,21567,6,21152,402,7,13,2021-10-10
317509,JAKARTA TIMUR,CIRACAS,22365,0,21968,379,18,18,2021-10-10
317506,JAKARTA TIMUR,CAKUNG,22572,7,22133,410,22,29,2021-10-10
317105,JAKARTA PUSAT,CEMPAKA PUTIH,10456,6,10269,167,14,20,2021-10-10
317301,JAKARTA BARAT,CENGKARENG,28509,19,27910,556,24,43,2021-10-10
317406,JAKARTA SELATAN,CILANDAK,17625,5,17345,261,14,19,2021-10-10
317204,JAKARTA UTARA,CILINCING,17295,7,16846,340,102,109,2021-10-10
317510,JAKARTA TIMUR,CIPAYUNG,25125,7,24838,267,13,20,2021-10-10
310101,KAB.ADM.KEP.SERIBU,KEP. SERIBU UTARA,636,0,624,6,6,6,2021-10-10
317507,JAKARTA TIMUR,DUREN SAWIT,29378,1,28743,611,23,24,2021-10-10
317101,JAKARTA PUSAT,GAMBIR,8524,3,8379,133,9,12,2021-10-10
317409,JAKARTA SELATAN,JAGAKARSA,26542,10,26097,405,30,40,2021-10-10
317302,JAKARTA BARAT,GROGOL PETAMBURAN,19045,7,18731,298,9,16,2021-10-10
317108,JAKARTA PUSAT,JOHAR BARU,8650,3,8485,157,5,8,2021-10-10
317306,JAKARTA BARAT,KALI DERES,17957,11,17621,316,9,20,2021-10-10
317407,JAKARTA SELATAN,KEBAYORAN BARU,13824,9,13619,184,12,21,2021-10-10
317405,JAKARTA SELATAN,KEBAYORAN LAMA,19994,7,19609,362,16,23,2021-10-10
317305,JAKARTA BARAT,KEBON JERUK,22024,7,21631,374,12,19,2021-10-10
317206,JAKARTA UTARA,KELAPA GADING,12555,1,12339,192,23,24,2021-10-10
317103,JAKARTA PUSAT,KEMAYORAN,19896,10,19504,372,10,20,2021-10-10
317308,JAKARTA BARAT,KEMBANGAN,20186,5,19860,302,19,24,2021-10-10
310102,KAB.ADM.KEP.SERIBU,KEP. SERIBU SELATAN,703,0,692,10,1,1,2021-10-10
317503,JAKARTA TIMUR,JATINEGARA,19461,4,19061,381,15,19,2021-10-10
317307,JAKARTA BARAT,PALMERAH,15802,5,15465,328,4,9,2021-10-11
317404,JAKARTA SELATAN,PASAR MINGGU,23743,4,23291,425,23,27,2021-10-11
317408,JAKARTA SELATAN,PANCORAN,14277,2,14034,227,14,16,2021-10-11
317205,JAKARTA UTARA,PADEMANGAN,12680,4,12458,163,55,59,2021-10-11
317401,JAKARTA SELATAN,TEBET,16890,4,16598,278,10,14,2021-10-11
317501,JAKARTA TIMUR,MATRAMAN,14176,4,13886,278,8,12,2021-10-11
317403,JAKARTA SELATAN,MAMPANG PRAPATAN,11470,4,11280,179,7,11,2021-10-11
317508,JAKARTA TIMUR,MAKASAR,17443,2,17135,296,10,12,2021-10-11
317106,JAKARTA PUSAT,MENTENG,6422,4,6296,119,3,7,2021-10-11
317505,JAKARTA TIMUR,PASAR REBO,17604,2,17267,326,9,11,2021-10-11
111111,Luar DKI & Proses Update,Luar DKI & Proses Update,143008,137,141294,1273,304,441,2021-10-11
317410,JAKARTA SELATAN,PESANGGRAHAN,16315,12,16038,251,14,26,2021-10-11
317502,JAKARTA TIMUR,PULO GADUNG,21730,10,21303,398,19,29,2021-10-11
317102,JAKARTA PUSAT,SAWAH BESAR,9114,1,8926,172,15,16,2021-10-11
317104,JAKARTA PUSAT,SENEN,9360,5,9185,168,2,7,2021-10-11
317402,JAKARTA SELATAN,SETIA BUDI,11923,22,11696,182,23,45,2021-10-11
317303,JAKARTA BARAT,TAMAN SARI,8737,1,8594,140,2,3,2021-10-11
317304,JAKARTA BARAT,TAMBORA,14076,5,13817,252,2,7,2021-10-11
317107,JAKARTA PUSAT,TANAH ABANG,11003,3,10772,222,6,9,2021-10-11
317504,JAKARTA TIMUR,KRAMAT JATI,21567,1,21158,402,6,7,2021-10-11
317201,JAKARTA UTARA,PENJARINGAN,18570,9,18266,229,66,75,2021-10-11
317203,JAKARTA UTARA,KOJA,17124,3,16753,337,31,34,2021-10-11
317503,JAKARTA TIMUR,JATINEGARA,19462,3,19065,382,12,15,2021-10-11
310102,KAB.ADM.KEP.SERIBU,KEP. SERIBU SELATAN,703,0,693,10,0,0,2021-10-11
317506,JAKARTA TIMUR,CAKUNG,22572,5,22137,410,20,25,2021-10-11
317105,JAKARTA PUSAT,CEMPAKA PUTIH,10456,5,10274,167,10,15,2021-10-11
317301,JAKARTA BARAT,CENGKARENG,28509,14,27915,557,23,37,2021-10-11
317406,JAKARTA SELATAN,CILANDAK,17627,5,17350,261,11,16,2021-10-11
317204,JAKARTA UTARA,CILINCING,17297,6,16858,340,93,99,2021-10-11
317510,JAKARTA TIMUR,CIPAYUNG,25126,6,24842,267,11,17,2021-10-11
317509,JAKARTA TIMUR,CIRACAS,22354,0,21965,379,10,10,2021-10-11
317507,JAKARTA TIMUR,DUREN SAWIT,29378,1,28747,611,19,20,2021-10-11
317101,JAKARTA PUSAT,GAMBIR,8528,3,8382,133,10,13,2021-10-11
310101,KAB.ADM.KEP.SERIBU,KEP. SERIBU UTARA,636,0,625,6,5,5,2021-10-11
317202,JAKARTA UTARA,TANJUNG PRIOK,25671,9,25198,424,40,49,2021-10-11
317409,JAKARTA SELATAN,JAGAKARSA,26544,9,26102,405,28,37,2021-10-11
317108,JAKARTA PUSAT,JOHAR BARU,8650,3,8487,157,3,6,2021-10-11
317306,JAKARTA BARAT,KALI DERES,17958,11,17624,316,7,18,2021-10-11
317407,JAKARTA SELATAN,KEBAYORAN BARU,13824,7,13631,184,2,9,2021-10-11
317405,JAKARTA SELATAN,KEBAYORAN LAMA,19995,4,19615,362,14,18,2021-10-11
317305,JAKARTA BARAT,KEBON JERUK,22025,8,21632,374,11,19,2021-10-11
317206,JAKARTA UTARA,KELAPA GADING,12555,1,12343,192,19,20,2021-10-11
317103,JAKARTA PUSAT,KEMAYORAN,19896,10,19505,372,9,19,2021-10-11
317308,JAKARTA BARAT,KEMBANGAN,20188,3,19865,302,18,21,2021-10-11
317302,JAKARTA BARAT,GROGOL PETAMBURAN,19046,6,18737,298,5,11,2021-10-11
111111,Luar DKI & Proses Update,Luar DKI & Proses Update,143008,137,141294,1273,304,441,2021-10-12
317502,JAKARTA TIMUR,PULO GADUNG,21730,6,21313,398,13,19,2021-10-12
317404,JAKARTA SELATAN,PASAR MINGGU,23743,3,23296,425,19,22,2021-10-12
317504,JAKARTA TIMUR,KRAMAT JATI,21567,1,21159,402,5,6,2021-10-12
317508,JAKARTA TIMUR,MAKASAR,17443,2,17138,296,7,9,2021-10-12
317501,JAKARTA TIMUR,MATRAMAN,14176,1,13889,278,8,9,2021-10-12
317106,JAKARTA PUSAT,MENTENG,6422,4,6297,119,2,6,2021-10-12
317205,JAKARTA UTARA,PADEMANGAN,12682,3,12482,163,34,37,2021-10-12
317307,JAKARTA BARAT,PALMERAH,15802,3,15469,328,2,5,2021-10-12
317408,JAKARTA SELATAN,PANCORAN,14277,1,14035,227,14,15,2021-10-12
317505,JAKARTA TIMUR,PASAR REBO,17604,1,17270,326,7,8,2021-10-12
317203,JAKARTA UTARA,KOJA,17129,4,16761,337,27,31,2021-10-12
317201,JAKARTA UTARA,PENJARINGAN,18570,6,18271,229,64,70,2021-10-12
317102,JAKARTA PUSAT,SAWAH BESAR,9116,0,8931,172,13,13,2021-10-12
317104,JAKARTA PUSAT,SENEN,9360,4,9186,168,2,6,2021-10-12
317402,JAKARTA SELATAN,SETIA BUDI,11929,12,11718,182,17,29,2021-10-12
317303,JAKARTA BARAT,TAMAN SARI,8738,2,8594,140,2,4,2021-10-12
317304,JAKARTA BARAT,TAMBORA,14078,5,13817,252,4,9,2021-10-12
317107,JAKARTA PUSAT,TANAH ABANG,11003,3,10775,222,3,6,2021-10-12
317202,JAKARTA UTARA,TANJUNG PRIOK,25677,7,25207,424,39,46,2021-10-12
317401,JAKARTA SELATAN,TEBET,16890,4,16604,278,4,8,2021-10-12
317410,JAKARTA SELATAN,PESANGGRAHAN,16315,8,16044,251,12,20,2021-10-12
310101,KAB.ADM.KEP.SERIBU,KEP. SERIBU UTARA,636,0,625,6,5,5,2021-10-12
317403,JAKARTA SELATAN,MAMPANG PRAPATAN,11470,4,11281,179,6,10,2021-10-12
317308,JAKARTA BARAT,KEMBANGAN,20188,3,19870,302,13,16,2021-10-12
317506,JAKARTA TIMUR,CAKUNG,22573,5,22140,411,17,22,2021-10-12
317105,JAKARTA PUSAT,CEMPAKA PUTIH,10459,8,10275,167,9,17,2021-10-12
317301,JAKARTA BARAT,CENGKARENG,28509,12,27919,557,21,33,2021-10-12
317406,JAKARTA SELATAN,CILANDAK,17636,5,17352,261,18,23,2021-10-12
317204,JAKARTA UTARA,CILINCING,17311,5,16872,340,94,99,2021-10-12
317510,JAKARTA TIMUR,CIPAYUNG,25126,5,24848,267,6,11,2021-10-12
310102,KAB.ADM.KEP.SERIBU,KEP. SERIBU SELATAN,703,0,693,10,0,0,2021-10-12
317507,JAKARTA TIMUR,DUREN SAWIT,29379,1,28748,611,19,20,2021-10-12
317101,JAKARTA PUSAT,GAMBIR,8529,4,8383,133,9,13,2021-10-12
317302,JAKARTA BARAT,GROGOL PETAMBURAN,19046,5,18740,298,3,8,2021-10-12
317509,JAKARTA TIMUR,CIRACAS,22365,0,21977,379,9,9,2021-10-12
317103,JAKARTA PUSAT,KEMAYORAN,19897,8,19509,372,8,16,2021-10-12
317503,JAKARTA TIMUR,JATINEGARA,19462,1,19067,382,12,13,2021-10-12
317108,JAKARTA PUSAT,JOHAR BARU,8651,3,8489,157,2,5,2021-10-12
317306,JAKARTA BARAT,KALI DERES,17958,4,17632,316,6,10,2021-10-12
317407,JAKARTA SELATAN,KEBAYORAN BARU,13824,3,13635,184,2,5,2021-10-12
317405,JAKARTA SELATAN,KEBAYORAN LAMA,19997,5,19618,362,12,17,2021-10-12
317305,JAKARTA BARAT,KEBON JERUK,22026,5,21636,374,11,16,2021-10-12
317206,JAKARTA UTARA,KELAPA GADING,12555,1,12347,192,15,16,2021-10-12
317409,JAKARTA SELATAN,JAGAKARSA,26547,10,26104,405,28,38,2021-10-12
317505,JAKARTA TIMUR,PASAR REBO,17604,1,17270,326,7,8,2021-10-13
317404,JAKARTA SELATAN,PASAR MINGGU,23745,3,23299,425,18,21,2021-10-13
317408,JAKARTA SELATAN,PANCORAN,14284,4,14035,227,18,22,2021-10-13
317307,JAKARTA BARAT,PALMERAH,15802,3,15470,328,1,4,2021-10-13
317508,JAKARTA TIMUR,MAKASAR,17444,1,17141,296,6,7,2021-10-13
317501,JAKARTA TIMUR,MATRAMAN,14177,2,13890,278,7,9,2021-10-13
317403,JAKARTA SELATAN,MAMPANG PRAPATAN,11471,3,11282,179,7,10,2021-10-13
317410,JAKARTA SELATAN,PESANGGRAHAN,16317,7,16048,251,11,18,2021-10-13
317205,JAKARTA UTARA,PADEMANGAN,12694,3,12497,163,31,34,2021-10-13
317502,JAKARTA TIMUR,PULO GADUNG,21731,6,21316,398,11,17,2021-10-13
317201,JAKARTA UTARA,PENJARINGAN,18574,6,18324,229,15,21,2021-10-13
317104,JAKARTA PUSAT,SENEN,9360,3,9188,168,1,4,2021-10-13
317402,JAKARTA SELATAN,SETIA BUDI,11935,10,11721,182,22,32,2021-10-13
317303,JAKARTA BARAT,TAMAN SARI,8739,2,8594,140,3,5,2021-10-13
317304,JAKARTA BARAT,TAMBORA,14078,4,13819,252,3,7,2021-10-13
317107,JAKARTA PUSAT,TANAH ABANG,11006,3,10776,222,5,8,2021-10-13
317202,JAKARTA UTARA,TANJUNG PRIOK,25683,6,25216,424,37,43,2021-10-13
317401,JAKARTA SELATAN,TEBET,16890,4,16606,278,2,6,2021-10-13
111111,Luar DKI & Proses Update,Luar DKI & Proses Update,143008,137,141294,1273,304,441,2021-10-13
317504,JAKARTA TIMUR,KRAMAT JATI,21568,1,21160,402,5,6,2021-10-13
317102,JAKARTA PUSAT,SAWAH BESAR,9123,1,8931,172,19,20,2021-10-13
317203,JAKARTA UTARA,KOJA,17142,5,16764,337,36,41,2021-10-13
317106,JAKARTA PUSAT,MENTENG,6422,4,6297,119,2,6,2021-10-13
310102,KAB.ADM.KEP.SERIBU,KEP. SERIBU SELATAN,703,0,693,10,0,0,2021-10-13
310101,KAB.ADM.KEP.SERIBU,KEP. SERIBU UTARA,636,0,625,6,5,5,2021-10-13
317301,JAKARTA BARAT,CENGKARENG,28522,13,27931,557,21,34,2021-10-13
317406,JAKARTA SELATAN,CILANDAK,17639,5,17354,261,19,24,2021-10-13
317204,JAKARTA UTARA,CILINCING,17317,5,16896,340,76,81,2021-10-13
317510,JAKARTA TIMUR,CIPAYUNG,25126,5,24849,267,5,10,2021-10-13
317509,JAKARTA TIMUR,CIRACAS,22369,1,21977,379,12,13,2021-10-13
317507,JAKARTA TIMUR,DUREN SAWIT,29380,1,28750,611,18,19,2021-10-13
317101,JAKARTA PUSAT,GAMBIR,8531,5,8383,133,10,15,2021-10-13
317302,JAKARTA BARAT,GROGOL PETAMBURAN,19046,4,18741,298,3,7,2021-10-13
317409,JAKARTA SELATAN,JAGAKARSA,26549,12,26108,405,24,36,2021-10-13
317105,JAKARTA PUSAT,CEMPAKA PUTIH,10460,6,10279,167,8,14,2021-10-13
317503,JAKARTA TIMUR,JATINEGARA,19471,5,19068,382,16,21,2021-10-13
317108,JAKARTA PUSAT,JOHAR BARU,8654,4,8489,157,4,8,2021-10-13
317306,JAKARTA BARAT,KALI DERES,17960,3,17636,316,5,8,2021-10-13
317407,JAKARTA SELATAN,KEBAYORAN BARU,13827,4,13636,184,3,7,2021-10-13
317405,JAKARTA SELATAN,KEBAYORAN LAMA,20000,4,19620,362,14,18,2021-10-13
317506,JAKARTA TIMUR,CAKUNG,22577,4,22144,411,18,22,2021-10-13
317305,JAKARTA BARAT,KEBON JERUK,22029,5,21639,374,11,16,2021-10-13
317206,JAKARTA UTARA,KELAPA GADING,12562,1,12349,192,20,21,2021-10-13
317103,JAKARTA PUSAT,KEMAYORAN,19899,8,19510,372,9,17,2021-10-13
317308,JAKARTA BARAT,KEMBANGAN,20190,3,19871,302,14,17,2021-10-13
317404,JAKARTA SELATAN,PASAR MINGGU,23748,4,23300,425,19,23,2021-10-14
317408,JAKARTA SELATAN,PANCORAN,14286,4,14038,227,17,21,2021-10-14
317307,JAKARTA BARAT,PALMERAH,15802,2,15471,328,1,3,2021-10-14
317403,JAKARTA SELATAN,MAMPANG PRAPATAN,11471,3,11282,179,7,10,2021-10-14
317106,JAKARTA PUSAT,MENTENG,6422,4,6298,119,1,5,2021-10-14
317501,JAKARTA TIMUR,MATRAMAN,14178,2,13890,278,8,10,2021-10-14
317505,JAKARTA TIMUR,PASAR REBO,17607,2,17271,326,8,10,2021-10-14
317205,JAKARTA UTARA,PADEMANGAN,12700,2,12499,163,36,38,2021-10-14
317201,JAKARTA UTARA,PENJARINGAN,18579,7,18325,229,18,25,2021-10-14
317402,JAKARTA SELATAN,SETIA BUDI,11935,9,11724,182,20,29,2021-10-14
317502,JAKARTA TIMUR,PULO GADUNG,21732,6,21317,398,11,17,2021-10-14
317102,JAKARTA PUSAT,SAWAH BESAR,9125,2,8931,172,20,22,2021-10-14
317104,JAKARTA PUSAT,SENEN,9362,2,9190,168,2,4,2021-10-14
111111,Luar DKI & Proses Update,Luar DKI & Proses Update,143008,137,141294,1273,304,441,2021-10-14
317303,JAKARTA BARAT,TAMAN SARI,8740,3,8594,140,3,6,2021-10-14
317304,JAKARTA BARAT,TAMBORA,14080,5,13819,252,4,9,2021-10-14
317107,JAKARTA PUSAT,TANAH ABANG,11006,3,10776,222,5,8,2021-10-14
317202,JAKARTA UTARA,TANJUNG PRIOK,25688,10,25217,424,37,47,2021-10-14
317401,JAKARTA SELATAN,TEBET,16891,4,16606,278,3,7,2021-10-14
317508,JAKARTA TIMUR,MAKASAR,17444,1,17141,296,6,7,2021-10-14
317410,JAKARTA SELATAN,PESANGGRAHAN,16321,7,16049,251,14,21,2021-10-14
317504,JAKARTA TIMUR,KRAMAT JATI,21568,1,21161,402,4,5,2021-10-14
317305,JAKARTA BARAT,KEBON JERUK,22032,6,21639,374,13,19,2021-10-14
310101,KAB.ADM.KEP.SERIBU,KEP. SERIBU UTARA,637,0,627,6,4,4,2021-10-14
317506,JAKARTA TIMUR,CAKUNG,22577,4,22144,411,18,22,2021-10-14
317105,JAKARTA PUSAT,CEMPAKA PUTIH,10463,6,10279,167,11,17,2021-10-14
317301,JAKARTA BARAT,CENGKARENG,28523,10,27934,557,22,32,2021-10-14
317406,JAKARTA SELATAN,CILANDAK,17639,4,17355,261,19,23,2021-10-14
317204,JAKARTA UTARA,CILINCING,17322,5,16916,340,61,66,2021-10-14
317203,JAKARTA UTARA,KOJA,17147,8,16767,337,35,43,2021-10-14
317509,JAKARTA TIMUR,CIRACAS,22375,1,21977,379,18,19,2021-10-14
317507,JAKARTA TIMUR,DUREN SAWIT,29381,2,28750,611,18,20,2021-10-14
317101,JAKARTA PUSAT,GAMBIR,8531,5,8383,133,10,15,2021-10-14
317302,JAKARTA BARAT,GROGOL PETAMBURAN,19046,4,18742,298,2,6,2021-10-14
317510,JAKARTA TIMUR,CIPAYUNG,25126,3,24851,267,5,8,2021-10-14
317503,JAKARTA TIMUR,JATINEGARA,19472,5,19068,382,17,22,2021-10-14
317108,JAKARTA PUSAT,JOHAR BARU,8656,5,8489,157,5,10,2021-10-14
317306,JAKARTA BARAT,KALI DERES,17962,3,17636,316,7,10,2021-10-14
317407,JAKARTA SELATAN,KEBAYORAN BARU,13829,4,13636,184,5,9,2021-10-14
317405,JAKARTA SELATAN,KEBAYORAN LAMA,20002,4,19622,362,14,18,2021-10-14
317206,JAKARTA UTARA,KELAPA GADING,12566,1,12349,192,24,25,2021-10-14
317103,JAKARTA PUSAT,KEMAYORAN,19900,8,19511,372,9,17,2021-10-14
317308,JAKARTA BARAT,KEMBANGAN,20191,2,19873,302,14,16,2021-10-14
310102,KAB.ADM.KEP.SERIBU,KEP. SERIBU SELATAN,703,0,693,10,0,0,2021-10-14
317409,JAKARTA SELATAN,JAGAKARSA,26550,11,26109,405,25,36,2021-10-14
317201,JAKARTA UTARA,PENJARINGAN,18579,7,18326,229,17,24,2021-10-15
317505,JAKARTA TIMUR,PASAR REBO,17608,2,17272,326,8,10,2021-10-15
317404,JAKARTA SELATAN,PASAR MINGGU,23752,6,23300,425,21,27,2021-10-15
317408,JAKARTA SELATAN,PANCORAN,14287,4,14038,227,18,22,2021-10-15
317106,JAKARTA PUSAT,MENTENG,6423,3,6299,119,2,5,2021-10-15
317205,JAKARTA UTARA,PADEMANGAN,12704,1,12501,163,39,40,2021-10-15
317410,JAKARTA SELATAN,PESANGGRAHAN,16323,6,16050,251,16,22,2021-10-15
317501,JAKARTA TIMUR,MATRAMAN,14178,2,13890,278,8,10,2021-10-15
317307,JAKARTA BARAT,PALMERAH,15803,2,15471,328,2,4,2021-10-15
317502,JAKARTA TIMUR,PULO GADUNG,21734,6,21318,398,12,18,2021-10-15
317206,JAKARTA UTARA,KELAPA GADING,12566,1,12349,192,24,25,2021-10-15
317104,JAKARTA PUSAT,SENEN,9362,2,9190,168,2,4,2021-10-15
317402,JAKARTA SELATAN,SETIA BUDI,11938,9,11725,182,22,31,2021-10-15
317303,JAKARTA BARAT,TAMAN SARI,8741,3,8594,140,4,7,2021-10-15
317304,JAKARTA BARAT,TAMBORA,14080,5,13819,252,4,9,2021-10-15
317107,JAKARTA PUSAT,TANAH ABANG,11007,1,10778,222,6,7,2021-10-15
317202,JAKARTA UTARA,TANJUNG PRIOK,25688,10,25222,424,32,42,2021-10-15
317401,JAKARTA SELATAN,TEBET,16902,7,16606,278,11,18,2021-10-15
111111,Luar DKI & Proses Update,Luar DKI & Proses Update,143008,137,141294,1273,304,441,2021-10-15
317403,JAKARTA SELATAN,MAMPANG PRAPATAN,11473,3,11283,179,8,11,2021-10-15
317102,JAKARTA PUSAT,SAWAH BESAR,9125,2,8933,172,18,20,2021-10-15
317508,JAKARTA TIMUR,MAKASAR,17445,1,17141,296,7,8,2021-10-15
317108,JAKARTA PUSAT,JOHAR BARU,8659,7,8489,157,6,13,2021-10-15
317203,JAKARTA UTARA,KOJA,17153,11,16768,337,37,48,2021-10-15
317506,JAKARTA TIMUR,CAKUNG,22579,4,22144,411,20,24,2021-10-15
317504,JAKARTA TIMUR,KRAMAT JATI,21573,2,21162,402,7,9,2021-10-15
317406,JAKARTA SELATAN,CILANDAK,17640,4,17356,261,19,23,2021-10-15
317204,JAKARTA UTARA,CILINCING,17325,6,16916,340,63,69,2021-10-15
317510,JAKARTA TIMUR,CIPAYUNG,25136,3,24851,267,15,18,2021-10-15
317509,JAKARTA TIMUR,CIRACAS,22376,1,21977,379,19,20,2021-10-15
317507,JAKARTA TIMUR,DUREN SAWIT,29381,2,28750,611,18,20,2021-10-15
317101,JAKARTA PUSAT,GAMBIR,8535,7,8385,133,10,17,2021-10-15
317302,JAKARTA BARAT,GROGOL PETAMBURAN,19046,4,18742,298,2,6,2021-10-15
317409,JAKARTA SELATAN,JAGAKARSA,26552,13,26113,405,21,34,2021-10-15
317105,JAKARTA PUSAT,CEMPAKA PUTIH,10464,6,10279,167,12,18,2021-10-15
317301,JAKARTA BARAT,CENGKARENG,28527,9,27935,557,26,35,2021-10-15
317503,JAKARTA TIMUR,JATINEGARA,19473,5,19069,382,17,22,2021-10-15
310102,KAB.ADM.KEP.SERIBU,KEP. SERIBU SELATAN,703,0,693,10,0,0,2021-10-15
317308,JAKARTA BARAT,KEMBANGAN,20193,2,19875,302,14,16,2021-10-15
317103,JAKARTA PUSAT,KEMAYORAN,19902,8,19511,372,11,19,2021-10-15
310101,KAB.ADM.KEP.SERIBU,KEP. SERIBU UTARA,638,0,627,6,5,5,2021-10-15
317405,JAKARTA SELATAN,KEBAYORAN LAMA,20004,5,19622,362,15,20,2021-10-15
317407,JAKARTA SELATAN,KEBAYORAN BARU,13830,4,13636,184,6,10,2021-10-15
317306,JAKARTA BARAT,KALI DERES,17964,3,17637,316,8,11,2021-10-15
317305,JAKARTA BARAT,KEBON JERUK,22032,6,21640,374,12,18,2021-10-15
317106,JAKARTA PUSAT,MENTENG,6423,3,6299,119,2,5,2021-10-16
317410,JAKARTA SELATAN,PESANGGRAHAN,16326,6,16052,251,17,23,2021-10-16
317205,JAKARTA UTARA,PADEMANGAN,12717,1,12505,163,48,49,2021-10-16
317307,JAKARTA BARAT,PALMERAH,15806,2,15472,328,4,6,2021-10-16
317408,JAKARTA SELATAN,PANCORAN,14287,3,14040,227,17,20,2021-10-16
317404,JAKARTA SELATAN,PASAR MINGGU,23754,6,23305,425,18,24,2021-10-16
317505,JAKARTA TIMUR,PASAR REBO,17608,1,17276,326,5,6,2021-10-16
317201,JAKARTA UTARA,PENJARINGAN,18580,6,18330,229,15,21,2021-10-16
317502,JAKARTA TIMUR,PULO GADUNG,21734,5,21321,398,10,15,2021-10-16
317304,JAKARTA BARAT,TAMBORA,14084,3,13822,252,7,10,2021-10-16
317104,JAKARTA PUSAT,SENEN,9362,1,9191,168,2,3,2021-10-16
317402,JAKARTA SELATAN,SETIA BUDI,11942,6,11730,182,24,30,2021-10-16
317303,JAKARTA BARAT,TAMAN SARI,8741,3,8594,140,4,7,2021-10-16
317107,JAKARTA PUSAT,TANAH ABANG,11010,3,10778,222,7,10,2021-10-16
317202,JAKARTA UTARA,TANJUNG PRIOK,25689,9,25229,424,27,36,2021-10-16
317401,JAKARTA SELATAN,TEBET,16902,4,16610,278,10,14,2021-10-16
111111,Luar DKI & Proses Update,Luar DKI & Proses Update,143008,137,141294,1273,304,441,2021-10-16
317501,JAKARTA TIMUR,MATRAMAN,14179,3,13891,278,7,10,2021-10-16
317102,JAKARTA PUSAT,SAWAH BESAR,9127,4,8940,172,11,15,2021-10-16
317403,JAKARTA SELATAN,MAMPANG PRAPATAN,11473,1,11286,179,7,8,2021-10-16
317508,JAKARTA TIMUR,MAKASAR,17448,2,17141,296,9,11,2021-10-16
317301,JAKARTA BARAT,CENGKARENG,28531,11,27936,557,27,38,2021-10-16
317506,JAKARTA TIMUR,CAKUNG,22583,5,22149,411,18,23,2021-10-16
317105,JAKARTA PUSAT,CEMPAKA PUTIH,10465,6,10281,167,11,17,2021-10-16
317504,JAKARTA TIMUR,KRAMAT JATI,21573,2,21162,402,7,9,2021-10-16
317406,JAKARTA SELATAN,CILANDAK,17641,3,17358,261,19,22,2021-10-16
317204,JAKARTA UTARA,CILINCING,17332,7,16934,340,51,58,2021-10-16
317510,JAKARTA TIMUR,CIPAYUNG,25136,3,24853,267,13,16,2021-10-16
317509,JAKARTA TIMUR,CIRACAS,22384,1,21978,379,26,27,2021-10-16
317101,JAKARTA PUSAT,GAMBIR,8537,8,8387,133,9,17,2021-10-16
317302,JAKARTA BARAT,GROGOL PETAMBURAN,19050,3,18743,298,6,9,2021-10-16
317409,JAKARTA SELATAN,JAGAKARSA,26552,13,26114,405,20,33,2021-10-16
317503,JAKARTA TIMUR,JATINEGARA,19480,5,19069,383,23,28,2021-10-16
317507,JAKARTA TIMUR,DUREN SAWIT,29383,4,28753,611,15,19,2021-10-16
317306,JAKARTA BARAT,KALI DERES,17965,3,17637,316,9,12,2021-10-16
317203,JAKARTA UTARA,KOJA,17157,12,16781,337,27,39,2021-10-16
317108,JAKARTA PUSAT,JOHAR BARU,8660,7,8489,157,7,14,2021-10-16
310102,KAB.ADM.KEP.SERIBU,KEP. SERIBU SELATAN,703,0,693,10,0,0,2021-10-16
317308,JAKARTA BARAT,KEMBANGAN,20197,1,19876,302,18,19,2021-10-16
317103,JAKARTA PUSAT,KEMAYORAN,19905,9,19514,372,10,19,2021-10-16
310101,KAB.ADM.KEP.SERIBU,KEP. SERIBU UTARA,638,0,630,6,2,2,2021-10-16
317305,JAKARTA BARAT,KEBON JERUK,22032,4,21642,374,12,16,2021-10-16
317405,JAKARTA SELATAN,KEBAYORAN LAMA,20006,7,19625,362,12,19,2021-10-16
317407,JAKARTA SELATAN,KEBAYORAN BARU,13831,4,13637,184,6,10,2021-10-16
317206,JAKARTA UTARA,KELAPA GADING,12569,1,12353,192,23,24,2021-10-16
317410,JAKARTA SELATAN,PESANGGRAHAN,16330,5,16055,251,19,24,2021-10-17
317106,JAKARTA PUSAT,MENTENG,6423,3,6299,119,2,5,2021-10-17
317205,JAKARTA UTARA,PADEMANGAN,12737,2,12506,163,66,68,2021-10-17
317307,JAKARTA BARAT,PALMERAH,15806,2,15472,328,4,6,2021-10-17
317408,JAKARTA SELATAN,PANCORAN,14286,3,14042,227,14,17,2021-10-17
317404,JAKARTA SELATAN,PASAR MINGGU,23754,5,23312,425,12,17,2021-10-17
317505,JAKARTA TIMUR,PASAR REBO,17608,1,17276,326,5,6,2021-10-17
317201,JAKARTA UTARA,PENJARINGAN,18582,6,18336,229,11,17,2021-10-17
317502,JAKARTA TIMUR,PULO GADUNG,21734,3,21323,398,10,13,2021-10-17
317501,JAKARTA TIMUR,MATRAMAN,14181,3,13893,278,7,10,2021-10-17
317104,JAKARTA PUSAT,SENEN,9364,2,9191,168,3,5,2021-10-17
317402,JAKARTA SELATAN,SETIA BUDI,11945,6,11732,182,25,31,2021-10-17
317303,JAKARTA BARAT,TAMAN SARI,8741,2,8596,140,3,5,2021-10-17
317304,JAKARTA BARAT,TAMBORA,14085,2,13823,252,8,10,2021-10-17
317107,JAKARTA PUSAT,TANAH ABANG,11011,3,10778,222,8,11,2021-10-17
317202,JAKARTA UTARA,TANJUNG PRIOK,25696,13,25234,424,25,38,2021-10-17
317401,JAKARTA SELATAN,TEBET,16902,3,16612,278,9,12,2021-10-17
111111,Luar DKI & Proses Update,Luar DKI & Proses Update,143008,137,141294,1273,304,441,2021-10-17
317102,JAKARTA PUSAT,SAWAH BESAR,9130,5,8940,172,13,18,2021-10-17
317403,JAKARTA SELATAN,MAMPANG PRAPATAN,11475,1,11287,179,8,9,2021-10-17
317406,JAKARTA SELATAN,CILANDAK,17642,2,17360,261,19,21,2021-10-17
317504,JAKARTA TIMUR,KRAMAT JATI,21576,3,21162,402,9,12,2021-10-17
317204,JAKARTA UTARA,CILINCING,17339,8,16937,340,54,62,2021-10-17
317301,JAKARTA BARAT,CENGKARENG,28532,9,27943,557,23,32,2021-10-17
317105,JAKARTA PUSAT,CEMPAKA PUTIH,10465,6,10283,167,9,15,2021-10-17
317508,JAKARTA TIMUR,MAKASAR,17450,2,17143,296,9,11,2021-10-17
317506,JAKARTA TIMUR,CAKUNG,22586,5,22152,411,18,23,2021-10-17
317510,JAKARTA TIMUR,CIPAYUNG,25136,2,24854,267,13,15,2021-10-17
317509,JAKARTA TIMUR,CIRACAS,22384,1,21981,379,23,24,2021-10-17
317507,JAKARTA TIMUR,DUREN SAWIT,29384,4,28758,611,11,15,2021-10-17
317302,JAKARTA BARAT,GROGOL PETAMBURAN,19050,2,18744,298,6,8,2021-10-17
317409,JAKARTA SELATAN,JAGAKARSA,26553,13,26121,405,14,27,2021-10-17
317503,JAKARTA TIMUR,JATINEGARA,19481,5,19070,383,23,28,2021-10-17
317101,JAKARTA PUSAT,GAMBIR,8538,6,8390,133,9,15,2021-10-17
317306,JAKARTA BARAT,KALI DERES,17971,5,17637,316,13,18,2021-10-17
317203,JAKARTA UTARA,KOJA,17159,13,16781,337,28,41,2021-10-17
310101,KAB.ADM.KEP.SERIBU,KEP. SERIBU UTARA,638,0,630,6,2,2,2021-10-17
310102,KAB.ADM.KEP.SERIBU,KEP. SERIBU SELATAN,703,0,693,10,0,0,2021-10-17
317308,JAKARTA BARAT,KEMBANGAN,20199,1,19882,302,14,15,2021-10-17
317108,JAKARTA PUSAT,JOHAR BARU,8665,8,8489,157,11,19,2021-10-17
317103,JAKARTA PUSAT,KEMAYORAN,19910,14,19515,372,9,23,2021-10-17
317206,JAKARTA UTARA,KELAPA GADING,12569,1,12354,192,22,23,2021-10-17
317305,JAKARTA BARAT,KEBON JERUK,22032,4,21644,374,10,14,2021-10-17
317405,JAKARTA SELATAN,KEBAYORAN LAMA,20008,7,19625,362,14,21,2021-10-17
317407,JAKARTA SELATAN,KEBAYORAN BARU,13834,6,13637,184,7,13,2021-10-17
317103,JAKARTA PUSAT,KEMAYORAN,19910,12,19517,372,9,21,2021-10-18
317407,JAKARTA SELATAN,KEBAYORAN BARU,13838,5,13639,184,10,15,2021-10-18
317206,JAKARTA UTARA,KELAPA GADING,12574,0,12358,192,24,24,2021-10-18
317305,JAKARTA BARAT,KEBON JERUK,22036,4,21648,374,10,14,2021-10-18
317405,JAKARTA SELATAN,KEBAYORAN LAMA,20011,7,19628,362,14,21,2021-10-18
111111,Luar DKI & Proses Update,Luar DKI & Proses Update,143008,137,141294,1273,304,441,2021-10-18
317306,JAKARTA BARAT,KALI DERES,17972,6,17637,316,13,19,2021-10-18
317406,JAKARTA SELATAN,CILANDAK,17642,2,17361,261,18,20,2021-10-18
317503,JAKARTA TIMUR,JATINEGARA,19484,4,19076,383,21,25,2021-10-18
317409,JAKARTA SELATAN,JAGAKARSA,26553,11,26125,405,12,23,2021-10-18
317302,JAKARTA BARAT,GROGOL PETAMBURAN,19051,3,18745,298,5,8,2021-10-18
317101,JAKARTA PUSAT,GAMBIR,8540,5,8391,134,10,15,2021-10-18
317507,JAKARTA TIMUR,DUREN SAWIT,29386,3,28764,611,8,11,2021-10-18
317509,JAKARTA TIMUR,CIRACAS,22386,1,21984,379,22,23,2021-10-18
317510,JAKARTA TIMUR,CIPAYUNG,25139,1,24855,267,16,17,2021-10-18
317204,JAKARTA UTARA,CILINCING,17341,8,16953,340,40,48,2021-10-18
317301,JAKARTA BARAT,CENGKARENG,28539,9,27949,557,24,33,2021-10-18
317105,JAKARTA PUSAT,CEMPAKA PUTIH,10465,4,10285,167,9,13,2021-10-18
317506,JAKARTA TIMUR,CAKUNG,22586,4,22157,411,14,18,2021-10-18
317108,JAKARTA PUSAT,JOHAR BARU,8665,6,8491,157,11,17,2021-10-18
317308,JAKARTA BARAT,KEMBANGAN,20199,1,19883,302,13,14,2021-10-18
310102,KAB.ADM.KEP.SERIBU,KEP. SERIBU SELATAN,703,0,693,10,0,0,2021-10-18
310101,KAB.ADM.KEP.SERIBU,KEP. SERIBU UTARA,638,0,630,6,2,2,2021-10-18
317401,JAKARTA SELATAN,TEBET,16910,3,16612,278,17,20,2021-10-18
317202,JAKARTA UTARA,TANJUNG PRIOK,25697,12,25238,424,23,35,2021-10-18
317107,JAKARTA PUSAT,TANAH ABANG,11011,2,10781,222,6,8,2021-10-18
317304,JAKARTA BARAT,TAMBORA,14085,1,13824,252,8,9,2021-10-18
317303,JAKARTA BARAT,TAMAN SARI,8741,2,8596,140,3,5,2021-10-18
317402,JAKARTA SELATAN,SETIA BUDI,11946,5,11735,182,24,29,2021-10-18
317104,JAKARTA PUSAT,SENEN,9364,2,9191,168,3,5,2021-10-18
317102,JAKARTA PUSAT,SAWAH BESAR,9131,6,8940,172,13,19,2021-10-18
317502,JAKARTA TIMUR,PULO GADUNG,21736,3,21328,398,7,10,2021-10-18
317410,JAKARTA SELATAN,PESANGGRAHAN,16333,4,16058,251,20,24,2021-10-18
317201,JAKARTA UTARA,PENJARINGAN,18583,6,18339,229,9,15,2021-10-18
317203,JAKARTA UTARA,KOJA,17161,13,16783,337,28,41,2021-10-18
317404,JAKARTA SELATAN,PASAR MINGGU,23756,5,23313,425,13,18,2021-10-18
317504,JAKARTA TIMUR,KRAMAT JATI,21576,3,21163,402,8,11,2021-10-18
317403,JAKARTA SELATAN,MAMPANG PRAPATAN,11476,1,11288,179,8,9,2021-10-18
317501,JAKARTA TIMUR,MATRAMAN,14183,3,13895,278,7,10,2021-10-18
317106,JAKARTA PUSAT,MENTENG,6423,2,6300,119,2,4,2021-10-18
317508,JAKARTA TIMUR,MAKASAR,17450,2,17144,296,8,10,2021-10-18
317505,JAKARTA TIMUR,PASAR REBO,17608,1,17278,326,3,4,2021-10-18
317205,JAKARTA UTARA,PADEMANGAN,12742,2,12511,163,66,68,2021-10-18
317307,JAKARTA BARAT,PALMERAH,15808,2,15474,328,4,6,2021-10-18
317408,JAKARTA SELATAN,PANCORAN,14287,3,14043,227,14,17,2021-10-18
317505,JAKARTA TIMUR,PASAR REBO,17608,1,17278,326,3,4,2021-10-19
317508,JAKARTA TIMUR,MAKASAR,17452,2,17144,296,10,12,2021-10-19
317403,JAKARTA SELATAN,MAMPANG PRAPATAN,11476,1,11290,179,6,7,2021-10-19
317501,JAKARTA TIMUR,MATRAMAN,14183,3,13896,278,6,9,2021-10-19
317205,JAKARTA UTARA,PADEMANGAN,12757,3,12513,163,78,81,2021-10-19
317307,JAKARTA BARAT,PALMERAH,15808,2,15475,328,3,5,2021-10-19
317408,JAKARTA SELATAN,PANCORAN,14287,3,14046,227,11,14,2021-10-19
317404,JAKARTA SELATAN,PASAR MINGGU,23756,6,23312,425,13,19,2021-10-19
317504,JAKARTA TIMUR,KRAMAT JATI,21577,3,21164,402,8,11,2021-10-19
317201,JAKARTA UTARA,PENJARINGAN,18583,6,18339,229,9,15,2021-10-19
317402,JAKARTA SELATAN,SETIA BUDI,11950,5,11737,182,26,31,2021-10-19
317502,JAKARTA TIMUR,PULO GADUNG,21737,2,21329,398,8,10,2021-10-19
317102,JAKARTA PUSAT,SAWAH BESAR,9138,6,8941,172,19,25,2021-10-19
317104,JAKARTA PUSAT,SENEN,9364,2,9191,168,3,5,2021-10-19
317203,JAKARTA UTARA,KOJA,17162,13,16787,337,25,38,2021-10-19
317303,JAKARTA BARAT,TAMAN SARI,8741,2,8596,140,3,5,2021-10-19
317304,JAKARTA BARAT,TAMBORA,14085,1,13823,252,9,10,2021-10-19
317107,JAKARTA PUSAT,TANAH ABANG,11011,2,10780,222,7,9,2021-10-19
317202,JAKARTA UTARA,TANJUNG PRIOK,25702,16,25242,424,20,36,2021-10-19
317401,JAKARTA SELATAN,TEBET,16912,4,16613,278,17,21,2021-10-19
317410,JAKARTA SELATAN,PESANGGRAHAN,16333,4,16063,251,15,19,2021-10-19
310101,KAB.ADM.KEP.SERIBU,KEP. SERIBU UTARA,638,0,630,6,2,2,2021-10-19
317106,JAKARTA PUSAT,MENTENG,6423,2,6300,119,2,4,2021-10-19
317308,JAKARTA BARAT,KEMBANGAN,20199,1,19883,302,13,14,2021-10-19
111111,Luar DKI & Proses Update,Luar DKI & Proses Update,143008,137,141294,1273,304,441,2021-10-19
310102,KAB.ADM.KEP.SERIBU,KEP. SERIBU SELATAN,703,0,693,10,0,0,2021-10-19
317506,JAKARTA TIMUR,CAKUNG,22590,5,22158,411,16,21,2021-10-19
317105,JAKARTA PUSAT,CEMPAKA PUTIH,10465,4,10286,167,8,12,2021-10-19
317301,JAKARTA BARAT,CENGKARENG,28541,10,27950,557,24,34,2021-10-19
317406,JAKARTA SELATAN,CILANDAK,17642,2,17361,261,18,20,2021-10-19
317204,JAKARTA UTARA,CILINCING,17341,8,16957,340,36,44,2021-10-19
317509,JAKARTA TIMUR,CIRACAS,22386,1,21984,379,22,23,2021-10-19
317507,JAKARTA TIMUR,DUREN SAWIT,29388,4,28767,611,6,10,2021-10-19
317101,JAKARTA PUSAT,GAMBIR,8539,5,8390,134,10,15,2021-10-19
317510,JAKARTA TIMUR,CIPAYUNG,25139,0,24857,267,15,15,2021-10-19
317409,JAKARTA SELATAN,JAGAKARSA,26554,7,26132,405,10,17,2021-10-19
317103,JAKARTA PUSAT,KEMAYORAN,19908,12,19516,372,8,20,2021-10-19
317302,JAKARTA BARAT,GROGOL PETAMBURAN,19052,4,18746,298,4,8,2021-10-19
317305,JAKARTA BARAT,KEBON JERUK,22035,4,21650,374,7,11,2021-10-19
317405,JAKARTA SELATAN,KEBAYORAN LAMA,20011,6,19634,362,9,15,2021-10-19
317206,JAKARTA UTARA,KELAPA GADING,12576,0,12358,192,26,26,2021-10-19
317306,JAKARTA BARAT,KALI DERES,17972,5,17638,316,13,18,2021-10-19
317108,JAKARTA PUSAT,JOHAR BARU,8666,6,8492,157,11,17,2021-10-19
317503,JAKARTA TIMUR,JATINEGARA,19484,4,19078,383,19,23,2021-10-19
317407,JAKARTA SELATAN,KEBAYORAN BARU,13838,5,13640,184,9,14,2021-10-19
317508,JAKARTA TIMUR,MAKASAR,17452,2,17144,296,10,12,2021-10-20
317404,JAKARTA SELATAN,PASAR MINGGU,23760,6,23318,425,11,17,2021-10-20
317403,JAKARTA SELATAN,MAMPANG PRAPATAN,11478,1,11291,179,7,8,2021-10-20
317501,JAKARTA TIMUR,MATRAMAN,14183,3,13898,278,4,7,2021-10-20
317106,JAKARTA PUSAT,MENTENG,6423,0,6302,119,2,2,2021-10-20
317205,JAKARTA UTARA,PADEMANGAN,12761,3,12517,163,78,81,2021-10-20
317307,JAKARTA BARAT,PALMERAH,15809,3,15475,328,3,6,2021-10-20
317408,JAKARTA SELATAN,PANCORAN,14289,3,14050,227,9,12,2021-10-20
317505,JAKARTA TIMUR,PASAR REBO,17609,2,17278,326,3,5,2021-10-20
317401,JAKARTA SELATAN,TEBET,16913,4,16613,278,18,22,2021-10-20
317410,JAKARTA SELATAN,PESANGGRAHAN,16337,4,16064,251,18,22,2021-10-20
317502,JAKARTA TIMUR,PULO GADUNG,21739,1,21333,398,7,8,2021-10-20
317102,JAKARTA PUSAT,SAWAH BESAR,9138,6,8942,172,18,24,2021-10-20
317104,JAKARTA PUSAT,SENEN,9365,2,9191,168,4,6,2021-10-20
317402,JAKARTA SELATAN,SETIA BUDI,11951,5,11741,182,23,28,2021-10-20
317303,JAKARTA BARAT,TAMAN SARI,8741,2,8597,140,2,4,2021-10-20
317304,JAKARTA BARAT,TAMBORA,14087,1,13824,252,10,11,2021-10-20
317107,JAKARTA PUSAT,TANAH ABANG,11012,2,10781,222,7,9,2021-10-20
317202,JAKARTA UTARA,TANJUNG PRIOK,25707,17,25246,424,20,37,2021-10-20
317504,JAKARTA TIMUR,KRAMAT JATI,21579,4,21165,402,8,12,2021-10-20
317201,JAKARTA UTARA,PENJARINGAN,18584,7,18340,229,8,15,2021-10-20
317203,JAKARTA UTARA,KOJA,17170,13,16790,337,30,43,2021-10-20
317108,JAKARTA PUSAT,JOHAR BARU,8666,6,8492,157,11,17,2021-10-20
310102,KAB.ADM.KEP.SERIBU,KEP. SERIBU SELATAN,703,0,693,10,0,0,2021-10-20
310101,KAB.ADM.KEP.SERIBU,KEP. SERIBU UTARA,638,0,630,6,2,2,2021-10-20
111111,Luar DKI & Proses Update,Luar DKI & Proses Update,143008,137,141294,1273,304,441,2021-10-20
317506,JAKARTA TIMUR,CAKUNG,22601,7,22161,411,22,29,2021-10-20
317105,JAKARTA PUSAT,CEMPAKA PUTIH,10467,4,10288,167,8,12,2021-10-20
317301,JAKARTA BARAT,CENGKARENG,28544,12,27952,557,23,35,2021-10-20
317406,JAKARTA SELATAN,CILANDAK,17645,3,17363,261,18,21,2021-10-20
317204,JAKARTA UTARA,CILINCING,17348,6,16967,340,35,41,2021-10-20
317509,JAKARTA TIMUR,CIRACAS,22387,1,21986,379,21,22,2021-10-20
317507,JAKARTA TIMUR,DUREN SAWIT,29389,5,28768,611,5,10,2021-10-20
317101,JAKARTA PUSAT,GAMBIR,8540,5,8391,134,10,15,2021-10-20
317510,JAKARTA TIMUR,CIPAYUNG,25140,1,24859,267,13,14,2021-10-20
317409,JAKARTA SELATAN,JAGAKARSA,26556,7,26138,405,6,13,2021-10-20
317503,JAKARTA TIMUR,JATINEGARA,19484,4,19079,383,18,22,2021-10-20
317306,JAKARTA BARAT,KALI DERES,17972,5,17640,316,11,16,2021-10-20
317407,JAKARTA SELATAN,KEBAYORAN BARU,13838,4,13641,184,9,13,2021-10-20
317405,JAKARTA SELATAN,KEBAYORAN LAMA,20012,6,19635,362,9,15,2021-10-20
317305,JAKARTA BARAT,KEBON JERUK,22036,4,21651,374,7,11,2021-10-20
317206,JAKARTA UTARA,KELAPA GADING,12578,0,12362,192,24,24,2021-10-20
317103,JAKARTA PUSAT,KEMAYORAN,19911,9,19523,372,7,16,2021-10-20
317302,JAKARTA BARAT,GROGOL PETAMBURAN,19053,3,18747,298,5,8,2021-10-20
317308,JAKARTA BARAT,KEMBANGAN,20207,3,19884,302,18,21,2021-10-20
310102,KAB.ADM.KEP.SERIBU,KEP. SERIBU SELATAN,703,0,693,10,0,0,2021-10-21
310101,KAB.ADM.KEP.SERIBU,KEP. SERIBU UTARA,638,0,632,6,0,0,2021-10-21
317203,JAKARTA UTARA,KOJA,17170,13,16790,337,30,43,2021-10-21
317504,JAKARTA TIMUR,KRAMAT JATI,21581,5,21165,402,9,14,2021-10-21
317508,JAKARTA TIMUR,MAKASAR,17452,2,17146,296,8,10,2021-10-21
317403,JAKARTA SELATAN,MAMPANG PRAPATAN,11479,1,11291,179,8,9,2021-10-21
317307,JAKARTA BARAT,PALMERAH,15813,3,15475,328,7,10,2021-10-21
317106,JAKARTA PUSAT,MENTENG,6423,0,6302,119,2,2,2021-10-21
317205,JAKARTA UTARA,PADEMANGAN,12761,3,12519,163,76,79,2021-10-21
317308,JAKARTA BARAT,KEMBANGAN,20207,3,19886,302,16,19,2021-10-21
317408,JAKARTA SELATAN,PANCORAN,14289,3,14050,227,9,12,2021-10-21
317404,JAKARTA SELATAN,PASAR MINGGU,23762,6,23318,425,13,19,2021-10-21
317505,JAKARTA TIMUR,PASAR REBO,17609,2,17278,326,3,5,2021-10-21
317201,JAKARTA UTARA,PENJARINGAN,18584,7,18341,229,7,14,2021-10-21
317501,JAKARTA TIMUR,MATRAMAN,14184,3,13899,278,4,7,2021-10-21
317103,JAKARTA PUSAT,KEMAYORAN,19911,9,19524,372,6,15,2021-10-21
317306,JAKARTA BARAT,KALI DERES,17974,4,17641,316,13,17,2021-10-21
317305,JAKARTA BARAT,KEBON JERUK,22039,3,21652,374,10,13,2021-10-21
317410,JAKARTA SELATAN,PESANGGRAHAN,16337,4,16064,251,18,22,2021-10-21
317506,JAKARTA TIMUR,CAKUNG,22604,6,22161,412,25,31,2021-10-21
317105,JAKARTA PUSAT,CEMPAKA PUTIH,10470,3,10289,167,11,14,2021-10-21
317301,JAKARTA BARAT,CENGKARENG,28552,12,27952,557,31,43,2021-10-21
317406,JAKARTA SELATAN,CILANDAK,17645,2,17366,261,16,18,2021-10-21
317204,JAKARTA UTARA,CILINCING,17351,5,16970,340,36,41,2021-10-21
317510,JAKARTA TIMUR,CIPAYUNG,25141,1,24860,267,13,14,2021-10-21
317509,JAKARTA TIMUR,CIRACAS,22394,1,21986,379,28,29,2021-10-21
317101,JAKARTA PUSAT,GAMBIR,8540,5,8395,134,6,11,2021-10-21
317302,JAKARTA BARAT,GROGOL PETAMBURAN,19054,2,18748,298,6,8,2021-10-21
317409,JAKARTA SELATAN,JAGAKARSA,26556,5,26142,405,4,9,2021-10-21
317503,JAKARTA TIMUR,JATINEGARA,19491,5,19079,383,24,29,2021-10-21
317108,JAKARTA PUSAT,JOHAR BARU,8666,5,8494,157,10,15,2021-10-21
317407,JAKARTA SELATAN,KEBAYORAN BARU,13838,4,13641,184,9,13,2021-10-21
317405,JAKARTA SELATAN,KEBAYORAN LAMA,20012,6,19635,362,9,15,2021-10-21
317206,JAKARTA UTARA,KELAPA GADING,12578,0,12363,192,23,23,2021-10-21
317507,JAKARTA TIMUR,DUREN SAWIT,29392,5,28768,611,8,13,2021-10-21
317102,JAKARTA PUSAT,SAWAH BESAR,9139,5,8945,172,17,22,2021-10-21
317104,JAKARTA PUSAT,SENEN,9366,2,9191,168,5,7,2021-10-21
317402,JAKARTA SELATAN,SETIA BUDI,11959,5,11742,182,30,35,2021-10-21
317303,JAKARTA BARAT,TAMAN SARI,8741,1,8598,140,2,3,2021-10-21
317304,JAKARTA BARAT,TAMBORA,14087,1,13825,252,9,10,2021-10-21
317107,JAKARTA PUSAT,TANAH ABANG,11012,2,10782,222,6,8,2021-10-21
317202,JAKARTA UTARA,TANJUNG PRIOK,25708,17,25247,424,20,37,2021-10-21
317401,JAKARTA SELATAN,TEBET,16915,4,16613,278,20,24,2021-10-21
111111,Luar DKI & Proses Update,Luar DKI & Proses Update,143008,137,141294,1273,304,441,2021-10-21
317502,JAKARTA TIMUR,PULO GADUNG,21741,1,21333,398,9,10,2021-10-21
317505,JAKARTA TIMUR,PASAR REBO,17609,2,17278,326,3,5,2021-10-22
317404,JAKARTA SELATAN,PASAR MINGGU,23762,6,23318,425,13,19,2021-10-22
317408,JAKARTA SELATAN,PANCORAN,14289,3,14050,227,9,12,2021-10-22
317403,JAKARTA SELATAN,MAMPANG PRAPATAN,11479,1,11291,179,8,9,2021-10-22
317106,JAKARTA PUSAT,MENTENG,6424,1,6303,119,1,2,2021-10-22
317501,JAKARTA TIMUR,MATRAMAN,14184,3,13899,278,4,7,2021-10-22
317201,JAKARTA UTARA,PENJARINGAN,18585,7,18342,229,7,14,2021-10-22
317205,JAKARTA UTARA,PADEMANGAN,12761,3,12528,163,67,70,2021-10-22
317410,JAKARTA SELATAN,PESANGGRAHAN,16338,4,16064,251,19,23,2021-10-22
317402,JAKARTA SELATAN,SETIA BUDI,11961,6,11751,182,22,28,2021-10-22
317102,JAKARTA PUSAT,SAWAH BESAR,9140,5,8948,172,15,20,2021-10-22
317104,JAKARTA PUSAT,SENEN,9366,1,9192,168,5,6,2021-10-22
317508,JAKARTA TIMUR,MAKASAR,17452,2,17147,296,7,9,2021-10-22
317303,JAKARTA BARAT,TAMAN SARI,8742,2,8598,140,2,4,2021-10-22
317304,JAKARTA BARAT,TAMBORA,14089,3,13825,252,9,12,2021-10-22
317107,JAKARTA PUSAT,TANAH ABANG,11013,3,10783,222,5,8,2021-10-22
317202,JAKARTA UTARA,TANJUNG PRIOK,25708,17,25249,424,18,35,2021-10-22
317401,JAKARTA SELATAN,TEBET,16915,4,16613,278,20,24,2021-10-22
111111,Luar DKI & Proses Update,Luar DKI & Proses Update,143008,137,141294,1273,304,441,2021-10-22
317502,JAKARTA TIMUR,PULO GADUNG,21742,1,21333,398,10,11,2021-10-22
317504,JAKARTA TIMUR,KRAMAT JATI,21584,5,21165,402,12,17,2021-10-22
317307,JAKARTA BARAT,PALMERAH,15813,3,15475,328,7,10,2021-10-22
310101,KAB.ADM.KEP.SERIBU,KEP. SERIBU UTARA,638,0,632,6,0,0,2021-10-22
317506,JAKARTA TIMUR,CAKUNG,22605,6,22161,412,26,32,2021-10-22
317203,JAKARTA UTARA,KOJA,17171,11,16792,337,31,42,2021-10-22
317301,JAKARTA BARAT,CENGKARENG,28556,15,27952,557,32,47,2021-10-22
317406,JAKARTA SELATAN,CILANDAK,17649,2,17374,261,12,14,2021-10-22
317204,JAKARTA UTARA,CILINCING,17351,5,16970,340,36,41,2021-10-22
317510,JAKARTA TIMUR,CIPAYUNG,25143,1,24860,267,15,16,2021-10-22
317509,JAKARTA TIMUR,CIRACAS,22396,1,21987,379,29,30,2021-10-22
317507,JAKARTA TIMUR,DUREN SAWIT,29396,7,28768,611,10,17,2021-10-22
317101,JAKARTA PUSAT,GAMBIR,8540,5,8395,134,6,11,2021-10-22
317302,JAKARTA BARAT,GROGOL PETAMBURAN,19054,2,18748,298,6,8,2021-10-22
317409,JAKARTA SELATAN,JAGAKARSA,26558,4,26144,405,5,9,2021-10-22
317105,JAKARTA PUSAT,CEMPAKA PUTIH,10471,3,10289,167,12,15,2021-10-22
317503,JAKARTA TIMUR,JATINEGARA,19494,6,19080,383,25,31,2021-10-22
317308,JAKARTA BARAT,KEMBANGAN,20207,3,19886,302,16,19,2021-10-22
317103,JAKARTA PUSAT,KEMAYORAN,19914,9,19525,372,8,17,2021-10-22
317206,JAKARTA UTARA,KELAPA GADING,12582,0,12363,192,27,27,2021-10-22
317305,JAKARTA BARAT,KEBON JERUK,22040,3,21653,374,10,13,2021-10-22
310102,KAB.ADM.KEP.SERIBU,KEP. SERIBU SELATAN,703,0,693,10,0,0,2021-10-22
317407,JAKARTA SELATAN,KEBAYORAN BARU,13840,4,13641,184,11,15,2021-10-22
317306,JAKARTA BARAT,KALI DERES,17974,3,17642,316,13,16,2021-10-22
317108,JAKARTA PUSAT,JOHAR BARU,8666,5,8494,157,10,15,2021-10-22
317405,JAKARTA SELATAN,KEBAYORAN LAMA,20015,8,19637,362,8,16,2021-10-22
317505,JAKARTA TIMUR,PASAR REBO,17609,2,17278,326,3,5,2021-10-23
317403,JAKARTA SELATAN,MAMPANG PRAPATAN,11481,2,11292,179,8,10,2021-10-23
317501,JAKARTA TIMUR,MATRAMAN,14185,3,13899,279,4,7,2021-10-23
317106,JAKARTA PUSAT,MENTENG,6424,1,6303,119,1,2,2021-10-23
317205,JAKARTA UTARA,PADEMANGAN,12765,5,12537,163,60,65,2021-10-23
317307,JAKARTA BARAT,PALMERAH,15813,3,15475,328,7,10,2021-10-23
317408,JAKARTA SELATAN,PANCORAN,14289,3,14054,227,5,8,2021-10-23
317404,JAKARTA SELATAN,PASAR MINGGU,23763,7,23319,425,12,19,2021-10-23
317201,JAKARTA UTARA,PENJARINGAN,18586,5,18346,229,6,11,2021-10-23
317402,JAKARTA SELATAN,SETIA BUDI,11964,6,11753,182,23,29,2021-10-23
317502,JAKARTA TIMUR,PULO GADUNG,21743,2,21333,398,10,12,2021-10-23
317102,JAKARTA PUSAT,SAWAH BESAR,9142,6,8951,172,13,19,2021-10-23
317104,JAKARTA PUSAT,SENEN,9366,1,9192,168,5,6,2021-10-23
111111,Luar DKI & Proses Update,Luar DKI & Proses Update,143008,137,141294,1273,304,441,2021-10-23
317303,JAKARTA BARAT,TAMAN SARI,8742,2,8599,140,1,3,2021-10-23
317304,JAKARTA BARAT,TAMBORA,14090,4,13826,252,8,12,2021-10-23
317107,JAKARTA PUSAT,TANAH ABANG,11014,4,10785,222,3,7,2021-10-23
317202,JAKARTA UTARA,TANJUNG PRIOK,25712,15,25257,424,16,31,2021-10-23
317401,JAKARTA SELATAN,TEBET,16917,6,16613,278,20,26,2021-10-23
317410,JAKARTA SELATAN,PESANGGRAHAN,16338,3,16065,252,18,21,2021-10-23
317508,JAKARTA TIMUR,MAKASAR,17452,2,17148,296,6,8,2021-10-23
310101,KAB.ADM.KEP.SERIBU,KEP. SERIBU UTARA,639,1,632,6,0,1,2021-10-23
317203,JAKARTA UTARA,KOJA,17175,8,16808,337,22,30,2021-10-23
317504,JAKARTA TIMUR,KRAMAT JATI,21584,5,21166,402,11,16,2021-10-23
317105,JAKARTA PUSAT,CEMPAKA PUTIH,10471,0,10293,167,11,11,2021-10-23
317301,JAKARTA BARAT,CENGKARENG,28557,15,27963,557,22,37,2021-10-23
317406,JAKARTA SELATAN,CILANDAK,17650,2,17378,261,9,11,2021-10-23
317204,JAKARTA UTARA,CILINCING,17355,6,16979,340,30,36,2021-10-23
317510,JAKARTA TIMUR,CIPAYUNG,25144,1,24860,267,16,17,2021-10-23
317509,JAKARTA TIMUR,CIRACAS,22396,0,21993,379,24,24,2021-10-23
317507,JAKARTA TIMUR,DUREN SAWIT,29397,8,28770,611,8,16,2021-10-23
317101,JAKARTA PUSAT,GAMBIR,8540,5,8395,134,6,11,2021-10-23
317302,JAKARTA BARAT,GROGOL PETAMBURAN,19054,2,18748,298,6,8,2021-10-23
317506,JAKARTA TIMUR,CAKUNG,22609,6,22166,412,25,31,2021-10-23
317503,JAKARTA TIMUR,JATINEGARA,19498,3,19088,383,24,27,2021-10-23
317108,JAKARTA PUSAT,JOHAR BARU,8666,4,8497,157,8,12,2021-10-23
317306,JAKARTA BARAT,KALI DERES,17974,3,17644,316,11,14,2021-10-23
317407,JAKARTA SELATAN,KEBAYORAN BARU,13841,3,13643,184,11,14,2021-10-23
317405,JAKARTA SELATAN,KEBAYORAN LAMA,20016,7,19641,362,6,13,2021-10-23
317305,JAKARTA BARAT,KEBON JERUK,22041,3,21656,374,8,11,2021-10-23
317206,JAKARTA UTARA,KELAPA GADING,12583,0,12369,192,22,22,2021-10-23
317103,JAKARTA PUSAT,KEMAYORAN,19915,8,19526,372,9,17,2021-10-23
317409,JAKARTA SELATAN,JAGAKARSA,26559,3,26145,405,6,9,2021-10-23
317308,JAKARTA BARAT,KEMBANGAN,20209,3,19887,302,17,20,2021-10-23
310102,KAB.ADM.KEP.SERIBU,KEP. SERIBU SELATAN,703,0,693,10,0,0,2021-10-23
317404,JAKARTA SELATAN,PASAR MINGGU,23766,7,23321,425,13,20,2021-10-24
317408,JAKARTA SELATAN,PANCORAN,14290,0,14059,227,4,4,2021-10-24
317106,JAKARTA PUSAT,MENTENG,6425,1,6303,119,2,3,2021-10-24
317205,JAKARTA UTARA,PADEMANGAN,12767,5,12542,163,57,62,2021-10-24
317505,JAKARTA TIMUR,PASAR REBO,17610,3,17280,326,1,4,2021-10-24
317501,JAKARTA TIMUR,MATRAMAN,14186,3,13900,279,4,7,2021-10-24
317307,JAKARTA BARAT,PALMERAH,15813,3,15475,328,7,10,2021-10-24
317201,JAKARTA UTARA,PENJARINGAN,18588,6,18350,229,3,9,2021-10-24
317402,JAKARTA SELATAN,SETIA BUDI,11964,6,11754,182,22,28,2021-10-24
317502,JAKARTA TIMUR,PULO GADUNG,21744,2,21334,398,10,12,2021-10-24
317102,JAKARTA PUSAT,SAWAH BESAR,9142,5,8953,172,12,17,2021-10-24
317104,JAKARTA PUSAT,SENEN,9367,1,9193,168,5,6,2021-10-24
317303,JAKARTA BARAT,TAMAN SARI,8742,1,8600,140,1,2,2021-10-24
317304,JAKARTA BARAT,TAMBORA,14091,4,13828,252,7,11,2021-10-24
317107,JAKARTA PUSAT,TANAH ABANG,11015,5,10785,222,3,8,2021-10-24
317202,JAKARTA UTARA,TANJUNG PRIOK,25713,14,25263,424,12,26,2021-10-24
317403,JAKARTA SELATAN,MAMPANG PRAPATAN,11493,2,11292,179,20,22,2021-10-24
111111,Luar DKI & Proses Update,Luar DKI & Proses Update,143008,137,141294,1273,304,441,2021-10-24
317410,JAKARTA SELATAN,PESANGGRAHAN,16339,3,16069,252,15,18,2021-10-24
317508,JAKARTA TIMUR,MAKASAR,17451,3,17146,296,6,9,2021-10-24
317405,JAKARTA SELATAN,KEBAYORAN LAMA,20017,8,19642,362,5,13,2021-10-24
317203,JAKARTA UTARA,KOJA,17175,6,16811,337,21,27,2021-10-24
317506,JAKARTA TIMUR,CAKUNG,22613,6,22167,412,28,34,2021-10-24
317105,JAKARTA PUSAT,CEMPAKA PUTIH,10471,0,10295,167,9,9,2021-10-24
317301,JAKARTA BARAT,CENGKARENG,28561,16,27968,557,20,36,2021-10-24
317406,JAKARTA SELATAN,CILANDAK,17650,2,17379,261,8,10,2021-10-24
317204,JAKARTA UTARA,CILINCING,17359,7,16981,340,31,38,2021-10-24
317510,JAKARTA TIMUR,CIPAYUNG,25144,1,24860,267,16,17,2021-10-24
317509,JAKARTA TIMUR,CIRACAS,22398,2,21996,379,21,23,2021-10-24
317507,JAKARTA TIMUR,DUREN SAWIT,29407,8,28770,611,18,26,2021-10-24
317101,JAKARTA PUSAT,GAMBIR,8540,4,8397,134,5,9,2021-10-24
317504,JAKARTA TIMUR,KRAMAT JATI,21583,6,21164,402,11,17,2021-10-24
317409,JAKARTA SELATAN,JAGAKARSA,26562,4,26147,405,6,10,2021-10-24
317302,JAKARTA BARAT,GROGOL PETAMBURAN,19054,2,18748,298,6,8,2021-10-24
317108,JAKARTA PUSAT,JOHAR BARU,8667,4,8498,157,8,12,2021-10-24
317306,JAKARTA BARAT,KALI DERES,17974,3,17646,316,9,12,2021-10-24
317407,JAKARTA SELATAN,KEBAYORAN BARU,13842,4,13646,184,8,12,2021-10-24
317305,JAKARTA BARAT,KEBON JERUK,22044,3,21657,374,10,13,2021-10-24
317206,JAKARTA UTARA,KELAPA GADING,12588,0,12373,192,23,23,2021-10-24
317103,JAKARTA PUSAT,KEMAYORAN,19915,8,19529,372,6,14,2021-10-24
317308,JAKARTA BARAT,KEMBANGAN,20210,2,19888,302,18,20,2021-10-24
310102,KAB.ADM.KEP.SERIBU,KEP. SERIBU SELATAN,703,0,693,10,0,0,2021-10-24
310101,KAB.ADM.KEP.SERIBU,KEP. SERIBU UTARA,639,1,632,6,0,1,2021-10-24
317503,JAKARTA TIMUR,JATINEGARA,19515,3,19088,383,41,44,2021-10-24
317401,JAKARTA SELATAN,TEBET,16922,6,16614,278,24,30,2021-10-24
317506,JAKARTA TIMUR,CAKUNG,22613,7,22170,412,24,31,2021-10-25
317105,JAKARTA PUSAT,CEMPAKA PUTIH,10471,0,10297,167,7,7,2021-10-25
111111,Luar DKI & Proses Update,Luar DKI & Proses Update,143008,137,141294,1273,304,441,2021-10-25
317301,JAKARTA BARAT,CENGKARENG,28562,16,27971,557,18,34,2021-10-25
317507,JAKARTA TIMUR,DUREN SAWIT,29410,8,28771,611,20,28,2021-10-25
317403,JAKARTA SELATAN,MAMPANG PRAPATAN,11493,2,11294,179,18,20,2021-10-25
317501,JAKARTA TIMUR,MATRAMAN,14186,3,13900,279,4,7,2021-10-25
317106,JAKARTA PUSAT,MENTENG,6425,1,6304,119,1,2,2021-10-25
317205,JAKARTA UTARA,PADEMANGAN,12768,5,12555,163,45,50,2021-10-25
317307,JAKARTA BARAT,PALMERAH,15813,3,15476,328,6,9,2021-10-25
317408,JAKARTA SELATAN,PANCORAN,14294,0,14060,227,7,7,2021-10-25
317404,JAKARTA SELATAN,PASAR MINGGU,23771,5,23326,425,15,20,2021-10-25
317201,JAKARTA UTARA,PENJARINGAN,18589,7,18350,229,3,10,2021-10-25
317508,JAKARTA TIMUR,MAKASAR,17454,3,17149,296,6,9,2021-10-25
317410,JAKARTA SELATAN,PESANGGRAHAN,16342,3,16073,252,14,17,2021-10-25
317102,JAKARTA PUSAT,SAWAH BESAR,9142,5,8953,172,12,17,2021-10-25
317104,JAKARTA PUSAT,SENEN,9367,1,9194,168,4,5,2021-10-25
317402,JAKARTA SELATAN,SETIA BUDI,11965,5,11756,182,22,27,2021-10-25
317303,JAKARTA BARAT,TAMAN SARI,8742,1,8601,140,0,1,2021-10-25
317304,JAKARTA BARAT,TAMBORA,14091,4,13830,252,5,9,2021-10-25
317107,JAKARTA PUSAT,TANAH ABANG,11015,3,10787,222,3,6,2021-10-25
317202,JAKARTA UTARA,TANJUNG PRIOK,25713,13,25265,424,11,24,2021-10-25
317401,JAKARTA SELATAN,TEBET,16924,5,16625,278,16,21,2021-10-25
317502,JAKARTA TIMUR,PULO GADUNG,21747,3,21337,398,9,12,2021-10-25
317504,JAKARTA TIMUR,KRAMAT JATI,21586,6,21170,402,8,14,2021-10-25
317505,JAKARTA TIMUR,PASAR REBO,17611,3,17282,326,0,3,2021-10-25
310101,KAB.ADM.KEP.SERIBU,KEP. SERIBU UTARA,639,1,632,6,0,1,2021-10-25
317203,JAKARTA UTARA,KOJA,17176,5,16814,337,20,25,2021-10-25
317406,JAKARTA SELATAN,CILANDAK,17650,2,17379,261,8,10,2021-10-25
317204,JAKARTA UTARA,CILINCING,17361,6,16984,340,31,37,2021-10-25
317510,JAKARTA TIMUR,CIPAYUNG,25147,1,24870,267,9,10,2021-10-25
317509,JAKARTA TIMUR,CIRACAS,22399,2,22004,379,14,16,2021-10-25
317302,JAKARTA BARAT,GROGOL PETAMBURAN,19055,3,18748,298,6,9,2021-10-25
317409,JAKARTA SELATAN,JAGAKARSA,26563,5,26146,406,6,11,2021-10-25
317503,JAKARTA TIMUR,JATINEGARA,19522,4,19096,383,39,43,2021-10-25
317108,JAKARTA PUSAT,JOHAR BARU,8668,1,8503,157,7,8,2021-10-25
317101,JAKARTA PUSAT,GAMBIR,8541,3,8401,134,3,6,2021-10-25
317306,JAKARTA BARAT,KALI DERES,17974,3,17649,316,6,9,2021-10-25
317407,JAKARTA SELATAN,KEBAYORAN BARU,13842,4,13646,184,8,12,2021-10-25
317405,JAKARTA SELATAN,KEBAYORAN LAMA,20017,5,19646,362,4,9,2021-10-25
317305,JAKARTA BARAT,KEBON JERUK,22044,3,21659,374,8,11,2021-10-25
317206,JAKARTA UTARA,KELAPA GADING,12588,0,12374,192,22,22,2021-10-25
317103,JAKARTA PUSAT,KEMAYORAN,19915,7,19531,372,5,12,2021-10-25
317308,JAKARTA BARAT,KEMBANGAN,20210,2,19891,302,15,17,2021-10-25
310102,KAB.ADM.KEP.SERIBU,KEP. SERIBU SELATAN,703,0,693,10,0,0,2021-10-25
317404,JAKARTA SELATAN,PASAR MINGGU,23771,4,23328,425,14,18,2021-10-26
317408,JAKARTA SELATAN,PANCORAN,14296,0,14060,227,9,9,2021-10-26
317307,JAKARTA BARAT,PALMERAH,15813,3,15478,328,4,7,2021-10-26
317205,JAKARTA UTARA,PADEMANGAN,12768,5,12574,163,26,31,2021-10-26
317403,JAKARTA SELATAN,MAMPANG PRAPATAN,11493,2,11294,179,18,20,2021-10-26
317501,JAKARTA TIMUR,MATRAMAN,14186,2,13902,279,3,5,2021-10-26
317508,JAKARTA TIMUR,MAKASAR,17455,4,17150,296,5,9,2021-10-26
317505,JAKARTA TIMUR,PASAR REBO,17613,5,17282,326,0,5,2021-10-26
317106,JAKARTA PUSAT,MENTENG,6425,1,6304,119,1,2,2021-10-26
317201,JAKARTA UTARA,PENJARINGAN,18589,6,18351,229,3,9,2021-10-26
317401,JAKARTA SELATAN,TEBET,16924,5,16626,278,15,20,2021-10-26
317502,JAKARTA TIMUR,PULO GADUNG,21748,3,21337,398,10,13,2021-10-26
317102,JAKARTA PUSAT,SAWAH BESAR,9142,4,8956,172,10,14,2021-10-26
317104,JAKARTA PUSAT,SENEN,9367,1,9194,168,4,5,2021-10-26
317402,JAKARTA SELATAN,SETIA BUDI,11966,4,11763,182,17,21,2021-10-26
317303,JAKARTA BARAT,TAMAN SARI,8742,1,8601,140,0,1,2021-10-26
317304,JAKARTA BARAT,TAMBORA,14091,4,13832,252,3,7,2021-10-26
317107,JAKARTA PUSAT,TANAH ABANG,11017,3,10790,222,2,5,2021-10-26
317202,JAKARTA UTARA,TANJUNG PRIOK,25713,11,25268,425,9,20,2021-10-26
317504,JAKARTA TIMUR,KRAMAT JATI,21588,6,21171,402,9,15,2021-10-26
317410,JAKARTA SELATAN,PESANGGRAHAN,16343,3,16076,252,12,15,2021-10-26
317203,JAKARTA UTARA,KOJA,17176,4,16818,337,17,21,2021-10-26
310101,KAB.ADM.KEP.SERIBU,KEP. SERIBU UTARA,639,1,632,6,0,1,2021-10-26
111111,Luar DKI & Proses Update,Luar DKI & Proses Update,143008,137,141294,1273,304,441,2021-10-26
317506,JAKARTA TIMUR,CAKUNG,22613,6,22172,412,23,29,2021-10-26
317105,JAKARTA PUSAT,CEMPAKA PUTIH,10471,0,10297,167,7,7,2021-10-26
317301,JAKARTA BARAT,CENGKARENG,28564,16,27971,557,20,36,2021-10-26
317406,JAKARTA SELATAN,CILANDAK,17650,2,17381,261,6,8,2021-10-26
317204,JAKARTA UTARA,CILINCING,17362,6,16991,340,25,31,2021-10-26
310102,KAB.ADM.KEP.SERIBU,KEP. SERIBU SELATAN,703,0,693,10,0,0,2021-10-26
317509,JAKARTA TIMUR,CIRACAS,22400,2,22005,379,14,16,2021-10-26
317507,JAKARTA TIMUR,DUREN SAWIT,29410,6,28773,611,20,26,2021-10-26
317101,JAKARTA PUSAT,GAMBIR,8541,1,8404,134,2,3,2021-10-26
317302,JAKARTA BARAT,GROGOL PETAMBURAN,19056,3,18752,298,3,6,2021-10-26
317510,JAKARTA TIMUR,CIPAYUNG,25152,2,24870,267,13,15,2021-10-26
317503,JAKARTA TIMUR,JATINEGARA,19522,3,19098,383,38,41,2021-10-26
317108,JAKARTA PUSAT,JOHAR BARU,8668,1,8504,157,6,7,2021-10-26
317306,JAKARTA BARAT,KALI DERES,17977,4,17649,316,8,12,2021-10-26
317407,JAKARTA SELATAN,KEBAYORAN BARU,13843,2,13649,184,8,10,2021-10-26
317405,JAKARTA SELATAN,KEBAYORAN LAMA,20017,4,19647,362,4,8,2021-10-26
317305,JAKARTA BARAT,KEBON JERUK,22045,4,21659,374,8,12,2021-10-26
317206,JAKARTA UTARA,KELAPA GADING,12588,0,12377,192,19,19,2021-10-26
317103,JAKARTA PUSAT,KEMAYORAN,19915,5,19533,372,5,10,2021-10-26
317308,JAKARTA BARAT,KEMBANGAN,20210,2,19892,302,14,16,2021-10-26
317409,JAKARTA SELATAN,JAGAKARSA,26563,4,26147,406,6,10,2021-10-26
317408,JAKARTA SELATAN,PANCORAN,14298,0,14060,227,11,11,2021-10-27
317307,JAKARTA BARAT,PALMERAH,15814,2,15479,328,5,7,2021-10-27
317205,JAKARTA UTARA,PADEMANGAN,12768,4,12585,163,16,20,2021-10-27
317504,JAKARTA TIMUR,KRAMAT JATI,21591,5,21174,402,10,15,2021-10-27
317501,JAKARTA TIMUR,MATRAMAN,14194,2,13903,279,10,12,2021-10-27
317403,JAKARTA SELATAN,MAMPANG PRAPATAN,11493,2,11296,179,16,18,2021-10-27
317508,JAKARTA TIMUR,MAKASAR,17456,2,17154,296,4,6,2021-10-27
317106,JAKARTA PUSAT,MENTENG,6425,1,6304,119,1,2,2021-10-27
317404,JAKARTA SELATAN,PASAR MINGGU,23773,2,23331,425,15,17,2021-10-27
317107,JAKARTA PUSAT,TANAH ABANG,11017,3,10791,222,1,4,2021-10-27
317201,JAKARTA UTARA,PENJARINGAN,18589,6,18352,229,2,8,2021-10-27
317410,JAKARTA SELATAN,PESANGGRAHAN,16345,5,16080,252,8,13,2021-10-27
317502,JAKARTA TIMUR,PULO GADUNG,21753,3,21337,399,14,17,2021-10-27
317102,JAKARTA PUSAT,SAWAH BESAR,9143,3,8958,172,10,13,2021-10-27
317104,JAKARTA PUSAT,SENEN,9367,1,9195,168,3,4,2021-10-27
317402,JAKARTA SELATAN,SETIA BUDI,11966,4,11763,182,17,21,2021-10-27
317303,JAKARTA BARAT,TAMAN SARI,8743,1,8601,140,1,2,2021-10-27
317304,JAKARTA BARAT,TAMBORA,14093,4,13832,252,5,9,2021-10-27
317203,JAKARTA UTARA,KOJA,17179,3,16824,337,15,18,2021-10-27
317505,JAKARTA TIMUR,PASAR REBO,17614,5,17282,326,1,6,2021-10-27
310101,KAB.ADM.KEP.SERIBU,KEP. SERIBU UTARA,639,1,632,6,0,1,2021-10-27
317302,JAKARTA BARAT,GROGOL PETAMBURAN,19056,3,18752,298,3,6,2021-10-27
317308,JAKARTA BARAT,KEMBANGAN,20211,2,19897,302,10,12,2021-10-27
111111,Luar DKI & Proses Update,Luar DKI & Proses Update,143008,137,141294,1273,304,441,2021-10-27
317506,JAKARTA TIMUR,CAKUNG,22618,7,22181,412,18,25,2021-10-27
317105,JAKARTA PUSAT,CEMPAKA PUTIH,10475,1,10298,167,9,10,2021-10-27
317301,JAKARTA BARAT,CENGKARENG,28565,14,27980,557,14,28,2021-10-27
317406,JAKARTA SELATAN,CILANDAK,17651,3,17381,261,6,9,2021-10-27
317204,JAKARTA UTARA,CILINCING,17366,6,17002,340,18,24,2021-10-27
317510,JAKARTA TIMUR,CIPAYUNG,25155,2,24872,267,14,16,2021-10-27
317509,JAKARTA TIMUR,CIRACAS,22402,3,22007,379,13,16,2021-10-27
317507,JAKARTA TIMUR,DUREN SAWIT,29413,6,28776,611,20,26,2021-10-27
317101,JAKARTA PUSAT,GAMBIR,8541,1,8404,134,2,3,2021-10-27
317409,JAKARTA SELATAN,JAGAKARSA,26565,4,26148,406,7,11,2021-10-27
317503,JAKARTA TIMUR,JATINEGARA,19524,3,19101,383,37,40,2021-10-27
317108,JAKARTA PUSAT,JOHAR BARU,8668,0,8508,157,3,3,2021-10-27
317306,JAKARTA BARAT,KALI DERES,17977,3,17654,316,4,7,2021-10-27
317407,JAKARTA SELATAN,KEBAYORAN BARU,13844,2,13650,184,8,10,2021-10-27
317405,JAKARTA SELATAN,KEBAYORAN LAMA,20017,4,19648,362,3,7,2021-10-27
317305,JAKARTA BARAT,KEBON JERUK,22045,4,21659,374,8,12,2021-10-27
317206,JAKARTA UTARA,KELAPA GADING,12589,0,12384,192,13,13,2021-10-27
317103,JAKARTA PUSAT,KEMAYORAN,19918,1,19538,372,7,8,2021-10-27
310102,KAB.ADM.KEP.SERIBU,KEP. SERIBU SELATAN,703,0,693,10,0,0,2021-10-27
317401,JAKARTA SELATAN,TEBET,16926,5,16626,278,17,22,2021-10-27
317202,JAKARTA UTARA,TANJUNG PRIOK,25715,10,25270,425,10,20,2021-10-27
317105,JAKARTA PUSAT,CEMPAKA PUTIH,10479,4,10298,167,10,14,2021-10-28
317508,JAKARTA TIMUR,MAKASAR,17458,3,17154,296,5,8,2021-10-28
317403,JAKARTA SELATAN,MAMPANG PRAPATAN,11494,1,11297,179,17,18,2021-10-28
317501,JAKARTA TIMUR,MATRAMAN,14194,2,13904,279,9,11,2021-10-28
317106,JAKARTA PUSAT,MENTENG,6425,1,6304,119,1,2,2021-10-28
317205,JAKARTA UTARA,PADEMANGAN,12774,4,12588,163,19,23,2021-10-28
317307,JAKARTA BARAT,PALMERAH,15815,2,15480,328,5,7,2021-10-28
317408,JAKARTA SELATAN,PANCORAN,14300,1,14060,227,12,13,2021-10-28
317404,JAKARTA SELATAN,PASAR MINGGU,23774,2,23331,425,16,18,2021-10-28
317201,JAKARTA UTARA,PENJARINGAN,18592,4,18354,229,5,9,2021-10-28
317410,JAKARTA SELATAN,PESANGGRAHAN,16351,5,16082,252,12,17,2021-10-28
317502,JAKARTA TIMUR,PULO GADUNG,21757,5,21337,399,16,21,2021-10-28
317102,JAKARTA PUSAT,SAWAH BESAR,9144,3,8958,172,11,14,2021-10-28
317104,JAKARTA PUSAT,SENEN,9369,1,9196,168,4,5,2021-10-28
317402,JAKARTA SELATAN,SETIA BUDI,11967,3,11766,182,16,19,2021-10-28
317303,JAKARTA BARAT,TAMAN SARI,8743,1,8601,140,1,2,2021-10-28
317304,JAKARTA BARAT,TAMBORA,14094,5,13834,252,3,8,2021-10-28
317107,JAKARTA PUSAT,TANAH ABANG,11017,3,10790,223,1,4,2021-10-28
317202,JAKARTA UTARA,TANJUNG PRIOK,25716,8,25273,425,10,18,2021-10-28
317401,JAKARTA SELATAN,TEBET,16926,5,16630,278,13,18,2021-10-28
317504,JAKARTA TIMUR,KRAMAT JATI,21594,5,21174,402,13,18,2021-10-28
317203,JAKARTA UTARA,KOJA,17183,2,16826,337,18,20,2021-10-28
317505,JAKARTA TIMUR,PASAR REBO,17616,6,17282,326,2,8,2021-10-28
310102,KAB.ADM.KEP.SERIBU,KEP. SERIBU SELATAN,703,0,693,10,0,0,2021-10-28
310101,KAB.ADM.KEP.SERIBU,KEP. SERIBU UTARA,639,1,632,6,0,1,2021-10-28
111111,Luar DKI & Proses Update,Luar DKI & Proses Update,143008,137,141294,1273,304,441,2021-10-28
317301,JAKARTA BARAT,CENGKARENG,28567,12,27984,557,14,26,2021-10-28
317406,JAKARTA SELATAN,CILANDAK,17654,4,17381,261,8,12,2021-10-28
317204,JAKARTA UTARA,CILINCING,17372,6,17002,340,24,30,2021-10-28
317510,JAKARTA TIMUR,CIPAYUNG,25156,2,24872,267,15,17,2021-10-28
317509,JAKARTA TIMUR,CIRACAS,22404,2,22007,379,16,18,2021-10-28
317507,JAKARTA TIMUR,DUREN SAWIT,29413,6,28776,611,20,26,2021-10-28
317101,JAKARTA PUSAT,GAMBIR,8541,1,8406,134,0,1,2021-10-28
317302,JAKARTA BARAT,GROGOL PETAMBURAN,19057,3,18752,298,4,7,2021-10-28
317506,JAKARTA TIMUR,CAKUNG,22620,7,22182,412,19,26,2021-10-28
317503,JAKARTA TIMUR,JATINEGARA,19530,3,19101,383,43,46,2021-10-28
317409,JAKARTA SELATAN,JAGAKARSA,26566,3,26149,406,8,11,2021-10-28
317103,JAKARTA PUSAT,KEMAYORAN,19919,1,19538,372,8,9,2021-10-28
317206,JAKARTA UTARA,KELAPA GADING,12594,0,12384,192,18,18,2021-10-28
317305,JAKARTA BARAT,KEBON JERUK,22046,4,21661,374,7,11,2021-10-28
317308,JAKARTA BARAT,KEMBANGAN,20211,3,19897,302,9,12,2021-10-28
317407,JAKARTA SELATAN,KEBAYORAN BARU,13848,2,13654,184,8,10,2021-10-28
317306,JAKARTA BARAT,KALI DERES,17980,2,17656,316,6,8,2021-10-28
317108,JAKARTA PUSAT,JOHAR BARU,8669,0,8508,157,4,4,2021-10-28
317405,JAKARTA SELATAN,KEBAYORAN LAMA,20019,5,19649,362,3,8,2021-10-28
317404,JAKARTA SELATAN,PASAR MINGGU,23773,1,23331,425,16,17,2021-10-29
317403,JAKARTA SELATAN,MAMPANG PRAPATAN,11496,1,11297,179,19,20,2021-10-29
317501,JAKARTA TIMUR,MATRAMAN,14196,2,13904,279,11,13,2021-10-29
317106,JAKARTA PUSAT,MENTENG,6425,1,6304,119,1,2,2021-10-29
317205,JAKARTA UTARA,PADEMANGAN,12786,3,12595,163,25,28,2021-10-29
317307,JAKARTA BARAT,PALMERAH,15815,2,15480,328,5,7,2021-10-29
317508,JAKARTA TIMUR,MAKASAR,17458,3,17154,296,5,8,2021-10-29
317408,JAKARTA SELATAN,PANCORAN,14301,1,14060,227,13,14,2021-10-29
317505,JAKARTA TIMUR,PASAR REBO,17621,7,17282,326,6,13,2021-10-29
317104,JAKARTA PUSAT,SENEN,9371,1,9196,168,6,7,2021-10-29
317410,JAKARTA SELATAN,PESANGGRAHAN,16351,4,16083,252,12,16,2021-10-29
317502,JAKARTA TIMUR,PULO GADUNG,21756,5,21337,399,15,20,2021-10-29
317102,JAKARTA PUSAT,SAWAH BESAR,9145,2,8966,172,5,7,2021-10-29
317402,JAKARTA SELATAN,SETIA BUDI,11967,3,11768,182,14,17,2021-10-29
317303,JAKARTA BARAT,TAMAN SARI,8744,1,8601,140,2,3,2021-10-29
317304,JAKARTA BARAT,TAMBORA,14094,5,13834,252,3,8,2021-10-29
317107,JAKARTA PUSAT,TANAH ABANG,11018,5,10789,223,1,6,2021-10-29
317202,JAKARTA UTARA,TANJUNG PRIOK,25716,5,25277,425,9,14,2021-10-29
317504,JAKARTA TIMUR,KRAMAT JATI,21594,4,21175,402,13,17,2021-10-29
317201,JAKARTA UTARA,PENJARINGAN,18596,5,18354,229,8,13,2021-10-29
317401,JAKARTA SELATAN,TEBET,16929,6,16633,278,12,18,2021-10-29
317203,JAKARTA UTARA,KOJA,17188,2,16826,337,23,25,2021-10-29
310102,KAB.ADM.KEP.SERIBU,KEP. SERIBU SELATAN,703,0,693,10,0,0,2021-10-29
310101,KAB.ADM.KEP.SERIBU,KEP. SERIBU UTARA,639,1,632,6,0,1,2021-10-29
317506,JAKARTA TIMUR,CAKUNG,22622,6,22183,412,21,27,2021-10-29
317105,JAKARTA PUSAT,CEMPAKA PUTIH,10483,5,10298,167,13,18,2021-10-29
317301,JAKARTA BARAT,CENGKARENG,28568,12,27985,557,14,26,2021-10-29
317406,JAKARTA SELATAN,CILANDAK,17655,5,17382,261,7,12,2021-10-29
317204,JAKARTA UTARA,CILINCING,17375,6,17002,340,27,33,2021-10-29
317510,JAKARTA TIMUR,CIPAYUNG,25157,2,24871,267,17,19,2021-10-29
317509,JAKARTA TIMUR,CIRACAS,22405,4,22006,379,16,20,2021-10-29
317507,JAKARTA TIMUR,DUREN SAWIT,29418,6,28775,611,26,32,2021-10-29
317101,JAKARTA PUSAT,GAMBIR,8541,1,8406,134,0,1,2021-10-29
111111,Luar DKI & Proses Update,Luar DKI & Proses Update,143008,137,141294,1273,304,441,2021-10-29
317409,JAKARTA SELATAN,JAGAKARSA,26566,3,26149,406,8,11,2021-10-29
317503,JAKARTA TIMUR,JATINEGARA,19529,4,19099,383,43,47,2021-10-29
317108,JAKARTA PUSAT,JOHAR BARU,8670,0,8508,157,5,5,2021-10-29
317306,JAKARTA BARAT,KALI DERES,17982,2,17656,316,8,10,2021-10-29
317407,JAKARTA SELATAN,KEBAYORAN BARU,13848,2,13654,184,8,10,2021-10-29
317405,JAKARTA SELATAN,KEBAYORAN LAMA,20019,5,19649,362,3,8,2021-10-29
317305,JAKARTA BARAT,KEBON JERUK,22047,4,21662,374,7,11,2021-10-29
317206,JAKARTA UTARA,KELAPA GADING,12601,0,12384,192,25,25,2021-10-29
317103,JAKARTA PUSAT,KEMAYORAN,19919,2,19537,372,8,10,2021-10-29
317308,JAKARTA BARAT,KEMBANGAN,20215,4,19897,302,12,16,2021-10-29
317302,JAKARTA BARAT,GROGOL PETAMBURAN,19057,1,18754,298,4,5,2021-10-29
317404,JAKARTA SELATAN,PASAR MINGGU,23777,4,23334,425,14,18,2021-10-30
317408,JAKARTA SELATAN,PANCORAN,14302,1,14062,227,12,13,2021-10-30
317403,JAKARTA SELATAN,MAMPANG PRAPATAN,11498,1,11299,179,19,20,2021-10-30
317205,JAKARTA UTARA,PADEMANGAN,12789,3,12598,163,25,28,2021-10-30
317106,JAKARTA PUSAT,MENTENG,6425,1,6304,119,1,2,2021-10-30
317501,JAKARTA TIMUR,MATRAMAN,14197,2,13905,279,11,13,2021-10-30
317307,JAKARTA BARAT,PALMERAH,15815,3,15479,329,4,7,2021-10-30
317505,JAKARTA TIMUR,PASAR REBO,17622,6,17283,326,7,13,2021-10-30
317304,JAKARTA BARAT,TAMBORA,14094,5,13835,252,2,7,2021-10-30
317202,JAKARTA UTARA,TANJUNG PRIOK,25717,4,25282,425,6,10,2021-10-30
317107,JAKARTA PUSAT,TANAH ABANG,11018,5,10790,223,0,5,2021-10-30
317410,JAKARTA SELATAN,PESANGGRAHAN,16353,5,16085,252,11,16,2021-10-30
317303,JAKARTA BARAT,TAMAN SARI,8745,0,8602,140,3,3,2021-10-30
317402,JAKARTA SELATAN,SETIA BUDI,11972,3,11776,182,11,14,2021-10-30
317104,JAKARTA PUSAT,SENEN,9371,1,9196,168,6,7,2021-10-30
317102,JAKARTA PUSAT,SAWAH BESAR,9146,2,8966,172,6,8,2021-10-30
317502,JAKARTA TIMUR,PULO GADUNG,21761,6,21340,399,16,22,2021-10-30
317508,JAKARTA TIMUR,MAKASAR,17458,3,17156,296,3,6,2021-10-30
317401,JAKARTA SELATAN,TEBET,16932,5,16635,278,14,19,2021-10-30
317504,JAKARTA TIMUR,KRAMAT JATI,21595,5,21176,402,12,17,2021-10-30
317108,JAKARTA PUSAT,JOHAR BARU,8670,0,8509,157,4,4,2021-10-30
310101,KAB.ADM.KEP.SERIBU,KEP. SERIBU UTARA,639,1,632,6,0,1,2021-10-30
317506,JAKARTA TIMUR,CAKUNG,22625,5,22190,412,18,23,2021-10-30
317105,JAKARTA PUSAT,CEMPAKA PUTIH,10486,6,10302,167,11,17,2021-10-30
317301,JAKARTA BARAT,CENGKARENG,28573,13,27990,557,13,26,2021-10-30
317406,JAKARTA SELATAN,CILANDAK,17655,4,17384,261,6,10,2021-10-30
317204,JAKARTA UTARA,CILINCING,17374,6,17007,340,21,27,2021-10-30
317510,JAKARTA TIMUR,CIPAYUNG,25158,1,24873,267,17,18,2021-10-30
317509,JAKARTA TIMUR,CIRACAS,22407,4,22015,379,9,13,2021-10-30
317507,JAKARTA TIMUR,DUREN SAWIT,29420,5,28779,611,25,30,2021-10-30
317101,JAKARTA PUSAT,GAMBIR,8541,1,8406,134,0,1,2021-10-30
317203,JAKARTA UTARA,KOJA,17191,2,16833,337,19,21,2021-10-30
317302,JAKARTA BARAT,GROGOL PETAMBURAN,19057,1,18756,298,2,3,2021-10-30
317503,JAKARTA TIMUR,JATINEGARA,19538,4,19119,383,32,36,2021-10-30
317306,JAKARTA BARAT,KALI DERES,17981,2,17655,316,8,10,2021-10-30
317407,JAKARTA SELATAN,KEBAYORAN BARU,13849,2,13654,184,9,11,2021-10-30
317405,JAKARTA SELATAN,KEBAYORAN LAMA,20019,5,19649,362,3,8,2021-10-30
317305,JAKARTA BARAT,KEBON JERUK,22046,4,21662,374,6,10,2021-10-30
317206,JAKARTA UTARA,KELAPA GADING,12608,0,12385,192,31,31,2021-10-30
317103,JAKARTA PUSAT,KEMAYORAN,19915,1,19534,372,8,9,2021-10-30
317308,JAKARTA BARAT,KEMBANGAN,20216,3,19903,302,8,11,2021-10-30
310102,KAB.ADM.KEP.SERIBU,KEP. SERIBU SELATAN,703,0,693,10,0,0,2021-10-30
317409,JAKARTA SELATAN,JAGAKARSA,26567,4,26150,406,7,11,2021-10-30
111111,Luar DKI & Proses Update,Luar DKI & Proses Update,143008,137,141294,1273,304,441,2021-10-30
317201,JAKARTA UTARA,PENJARINGAN,18597,6,18354,229,8,14,2021-10-30
317502,JAKARTA TIMUR,PULO GADUNG,21764,5,21341,399,19,24,2021-10-31
317306,JAKARTA BARAT,KALI DERES,17983,3,17657,316,7,10,2021-10-31
317407,JAKARTA SELATAN,KEBAYORAN BARU,13851,2,13653,185,11,13,2021-10-31
317405,JAKARTA SELATAN,KEBAYORAN LAMA,20020,4,19650,362,4,8,2021-10-31
317305,JAKARTA BARAT,KEBON JERUK,22047,4,21664,374,5,9,2021-10-31
317206,JAKARTA UTARA,KELAPA GADING,12609,0,12390,192,27,27,2021-10-31
317103,JAKARTA PUSAT,KEMAYORAN,19923,1,19540,372,10,11,2021-10-31
317308,JAKARTA BARAT,KEMBANGAN,20218,2,19905,302,9,11,2021-10-31
310102,KAB.ADM.KEP.SERIBU,KEP. SERIBU SELATAN,703,0,693,10,0,0,2021-10-31
310101,KAB.ADM.KEP.SERIBU,KEP. SERIBU UTARA,639,1,632,6,0,1,2021-10-31
317203,JAKARTA UTARA,KOJA,17194,2,16833,337,22,24,2021-10-31
317504,JAKARTA TIMUR,KRAMAT JATI,21597,4,21181,402,10,14,2021-10-31
317508,JAKARTA TIMUR,MAKASAR,17464,4,17156,296,8,12,2021-10-31
317403,JAKARTA SELATAN,MAMPANG PRAPATAN,11498,1,11300,179,18,19,2021-10-31
317501,JAKARTA TIMUR,MATRAMAN,14198,3,13905,279,11,14,2021-10-31
317106,JAKARTA PUSAT,MENTENG,6425,1,6304,119,1,2,2021-10-31
317205,JAKARTA UTARA,PADEMANGAN,12793,2,12599,163,29,31,2021-10-31
317307,JAKARTA BARAT,PALMERAH,15816,2,15484,329,1,3,2021-10-31
317408,JAKARTA SELATAN,PANCORAN,14302,1,14062,227,12,13,2021-10-31
317404,JAKARTA SELATAN,PASAR MINGGU,23779,6,23337,425,11,17,2021-10-31
317505,JAKARTA TIMUR,PASAR REBO,17623,7,17283,326,7,14,2021-10-31
317201,JAKARTA UTARA,PENJARINGAN,18598,6,18355,229,8,14,2021-10-31
317108,JAKARTA PUSAT,JOHAR BARU,8672,0,8509,157,6,6,2021-10-31
317503,JAKARTA TIMUR,JATINEGARA,19546,2,19124,383,37,39,2021-10-31
317410,JAKARTA SELATAN,PESANGGRAHAN,16354,5,16085,252,12,17,2021-10-31
317302,JAKARTA BARAT,GROGOL PETAMBURAN,19057,1,18756,298,2,3,2021-10-31
317102,JAKARTA PUSAT,SAWAH BESAR,9147,2,8967,172,6,8,2021-10-31
317402,JAKARTA SELATAN,SETIA BUDI,11972,3,11778,182,9,12,2021-10-31
317303,JAKARTA BARAT,TAMAN SARI,8747,1,8602,140,4,5,2021-10-31
317304,JAKARTA BARAT,TAMBORA,14094,5,13836,252,1,6,2021-10-31
317107,JAKARTA PUSAT,TANAH ABANG,11020,5,10791,223,1,6,2021-10-31
317202,JAKARTA UTARA,TANJUNG PRIOK,25719,2,25285,425,7,9,2021-10-31
317401,JAKARTA SELATAN,TEBET,16932,5,16637,278,12,17,2021-10-31
317506,JAKARTA TIMUR,CAKUNG,22634,5,22195,412,22,27,2021-10-31
317105,JAKARTA PUSAT,CEMPAKA PUTIH,10488,7,10303,167,11,18,2021-10-31
317104,JAKARTA PUSAT,SENEN,9373,1,9197,168,7,8,2021-10-31
317409,JAKARTA SELATAN,JAGAKARSA,26563,4,26146,406,7,11,2021-10-31
111111,Luar DKI & Proses Update,Luar DKI & Proses Update,143008,137,141294,1273,304,441,2021-10-31
317301,JAKARTA BARAT,CENGKARENG,28574,12,27998,557,7,19,2021-10-31
317406,JAKARTA SELATAN,CILANDAK,17652,4,17379,261,8,12,2021-10-31
317204,JAKARTA UTARA,CILINCING,17380,6,17011,340,23,29,2021-10-31
317510,JAKARTA TIMUR,CIPAYUNG,25161,1,24874,267,19,20,2021-10-31
317509,JAKARTA TIMUR,CIRACAS,22414,7,22017,379,11,18,2021-10-31
317507,JAKARTA TIMUR,DUREN SAWIT,29424,4,28781,611,28,32,2021-10-31
317101,JAKARTA PUSAT,GAMBIR,8542,1,8406,134,1,2,2021-10-31
317408,JAKARTA SELATAN,PANCORAN,14303,2,14062,227,12,14,2021-11-01
317307,JAKARTA BARAT,PALMERAH,15816,2,15484,329,1,3,2021-11-01
317205,JAKARTA UTARA,PADEMANGAN,12793,2,12599,163,29,31,2021-11-01
317106,JAKARTA PUSAT,MENTENG,6425,0,6305,119,1,1,2021-11-01
317508,JAKARTA TIMUR,MAKASAR,17464,4,17156,296,8,12,2021-11-01
317403,JAKARTA SELATAN,MAMPANG PRAPATAN,11498,1,11300,179,18,19,2021-11-01
317404,JAKARTA SELATAN,PASAR MINGGU,23780,7,23337,425,11,18,2021-11-01
317504,JAKARTA TIMUR,KRAMAT JATI,21600,3,21182,402,13,16,2021-11-01
317501,JAKARTA TIMUR,MATRAMAN,14201,3,13905,279,14,17,2021-11-01
317505,JAKARTA TIMUR,PASAR REBO,17624,7,17283,326,8,15,2021-11-01
317104,JAKARTA PUSAT,SENEN,9373,1,9198,168,6,7,2021-11-01
317502,JAKARTA TIMUR,PULO GADUNG,21765,5,21342,399,19,24,2021-11-01
317102,JAKARTA PUSAT,SAWAH BESAR,9147,2,8968,172,5,7,2021-11-01
317401,JAKARTA SELATAN,TEBET,16932,5,16637,278,12,17,2021-11-01
317402,JAKARTA SELATAN,SETIA BUDI,11972,3,11778,182,9,12,2021-11-01
317303,JAKARTA BARAT,TAMAN SARI,8747,1,8601,140,5,6,2021-11-01
317304,JAKARTA BARAT,TAMBORA,14094,3,13838,252,1,4,2021-11-01
317107,JAKARTA PUSAT,TANAH ABANG,11020,5,10791,223,1,6,2021-11-01
317203,JAKARTA UTARA,KOJA,17192,1,16832,337,22,23,2021-11-01
317202,JAKARTA UTARA,TANJUNG PRIOK,25719,2,25285,425,7,9,2021-11-01
317410,JAKARTA SELATAN,PESANGGRAHAN,16358,5,16086,252,15,20,2021-11-01
310101,KAB.ADM.KEP.SERIBU,KEP. SERIBU UTARA,639,1,632,6,0,1,2021-11-01
317201,JAKARTA UTARA,PENJARINGAN,18601,6,18354,229,12,18,2021-11-01
317308,JAKARTA BARAT,KEMBANGAN,20217,3,19903,302,9,12,2021-11-01
111111,Luar DKI & Proses Update,Luar DKI & Proses Update,143008,137,141294,1273,304,441,2021-11-01
310102,KAB.ADM.KEP.SERIBU,KEP. SERIBU SELATAN,703,0,693,10,0,0,2021-11-01
317506,JAKARTA TIMUR,CAKUNG,22634,4,22196,412,22,26,2021-11-01
317105,JAKARTA PUSAT,CEMPAKA PUTIH,10488,7,10303,167,11,18,2021-11-01
317301,JAKARTA BARAT,CENGKARENG,28582,13,27997,557,15,28,2021-11-01
317406,JAKARTA SELATAN,CILANDAK,17659,4,17385,261,9,13,2021-11-01
317204,JAKARTA UTARA,CILINCING,17380,6,17011,340,23,29,2021-11-01
317509,JAKARTA TIMUR,CIRACAS,22421,7,22018,379,17,24,2021-11-01
317507,JAKARTA TIMUR,DUREN SAWIT,29427,5,28782,611,29,34,2021-11-01
317101,JAKARTA PUSAT,GAMBIR,8545,1,8406,134,4,5,2021-11-01
317510,JAKARTA TIMUR,CIPAYUNG,25161,1,24874,267,19,20,2021-11-01
317302,JAKARTA BARAT,GROGOL PETAMBURAN,19058,1,18756,298,3,4,2021-11-01
317103,JAKARTA PUSAT,KEMAYORAN,19923,1,19540,372,10,11,2021-11-01
317305,JAKARTA BARAT,KEBON JERUK,22048,5,21664,374,5,10,2021-11-01
317405,JAKARTA SELATAN,KEBAYORAN LAMA,20022,5,19650,362,5,10,2021-11-01
317407,JAKARTA SELATAN,KEBAYORAN BARU,13852,3,13653,185,11,14,2021-11-01
317206,JAKARTA UTARA,KELAPA GADING,12611,0,12390,192,29,29,2021-11-01
317108,JAKARTA PUSAT,JOHAR BARU,8672,0,8509,157,6,6,2021-11-01
317503,JAKARTA TIMUR,JATINEGARA,19548,2,19125,383,38,40,2021-11-01
317409,JAKARTA SELATAN,JAGAKARSA,26567,4,26151,406,6,10,2021-11-01
317306,JAKARTA BARAT,KALI DERES,17986,3,17658,316,9,12,2021-11-01
317404,JAKARTA SELATAN,PASAR MINGGU,23784,9,23339,425,11,20,2021-11-02
317508,JAKARTA TIMUR,MAKASAR,17464,4,17156,296,8,12,2021-11-02
317403,JAKARTA SELATAN,MAMPANG PRAPATAN,11498,1,11301,179,17,18,2021-11-02
317501,JAKARTA TIMUR,MATRAMAN,14203,4,13906,279,14,18,2021-11-02
317106,JAKARTA PUSAT,MENTENG,6425,0,6305,119,1,1,2021-11-02
317205,JAKARTA UTARA,PADEMANGAN,12793,0,12603,163,27,27,2021-11-02
317307,JAKARTA BARAT,PALMERAH,15817,3,15484,329,1,4,2021-11-02
317408,JAKARTA SELATAN,PANCORAN,14307,3,14062,227,15,18,2021-11-02
317505,JAKARTA TIMUR,PASAR REBO,17626,8,17283,326,9,17,2021-11-02
317202,JAKARTA UTARA,TANJUNG PRIOK,25721,4,25287,425,5,9,2021-11-02
317410,JAKARTA SELATAN,PESANGGRAHAN,16358,5,16086,252,15,20,2021-11-02
317502,JAKARTA TIMUR,PULO GADUNG,21767,5,21344,399,19,24,2021-11-02
317102,JAKARTA PUSAT,SAWAH BESAR,9147,2,8968,172,5,7,2021-11-02
317104,JAKARTA PUSAT,SENEN,9375,2,9198,168,7,9,2021-11-02
317402,JAKARTA SELATAN,SETIA BUDI,11973,2,11782,182,7,9,2021-11-02
317303,JAKARTA BARAT,TAMAN SARI,8748,1,8602,140,5,6,2021-11-02
317304,JAKARTA BARAT,TAMBORA,14094,3,13838,252,1,4,2021-11-02
317107,JAKARTA PUSAT,TANAH ABANG,11021,3,10793,223,2,5,2021-11-02
317401,JAKARTA SELATAN,TEBET,16932,4,16638,278,12,16,2021-11-02
317201,JAKARTA UTARA,PENJARINGAN,18605,6,18358,229,12,18,2021-11-02
317203,JAKARTA UTARA,KOJA,17195,2,16837,337,19,21,2021-11-02
317504,JAKARTA TIMUR,KRAMAT JATI,21598,3,21182,402,11,14,2021-11-02
310102,KAB.ADM.KEP.SERIBU,KEP. SERIBU SELATAN,703,0,693,10,0,0,2021-11-02
310101,KAB.ADM.KEP.SERIBU,KEP. SERIBU UTARA,639,1,632,6,0,1,2021-11-02
111111,Luar DKI & Proses Update,Luar DKI & Proses Update,143008,137,141294,1273,304,441,2021-11-02
317506,JAKARTA TIMUR,CAKUNG,22635,4,22199,412,20,24,2021-11-02
317301,JAKARTA BARAT,CENGKARENG,28585,13,28000,557,15,28,2021-11-02
317406,JAKARTA SELATAN,CILANDAK,17659,4,17389,261,5,9,2021-11-02
317204,JAKARTA UTARA,CILINCING,17382,3,17018,340,21,24,2021-11-02
317510,JAKARTA TIMUR,CIPAYUNG,25164,1,24877,267,19,20,2021-11-02
317509,JAKARTA TIMUR,CIRACAS,22422,7,22018,379,18,25,2021-11-02
317507,JAKARTA TIMUR,DUREN SAWIT,29428,4,28789,611,24,28,2021-11-02
317101,JAKARTA PUSAT,GAMBIR,8544,1,8406,134,3,4,2021-11-02
317105,JAKARTA PUSAT,CEMPAKA PUTIH,10492,8,10304,167,13,21,2021-11-02
317409,JAKARTA SELATAN,JAGAKARSA,26567,4,26153,406,4,8,2021-11-02
317503,JAKARTA TIMUR,JATINEGARA,19550,2,19129,383,36,38,2021-11-02
317108,JAKARTA PUSAT,JOHAR BARU,8672,0,8509,157,6,6,2021-11-02
317306,JAKARTA BARAT,KALI DERES,17986,3,17658,316,9,12,2021-11-02
317407,JAKARTA SELATAN,KEBAYORAN BARU,13856,4,13655,185,12,16,2021-11-02
317405,JAKARTA SELATAN,KEBAYORAN LAMA,20022,2,19655,362,3,5,2021-11-02
317305,JAKARTA BARAT,KEBON JERUK,22050,4,21668,374,4,8,2021-11-02
317206,JAKARTA UTARA,KELAPA GADING,12612,1,12392,192,27,28,2021-11-02
317103,JAKARTA PUSAT,KEMAYORAN,19925,2,19543,372,8,10,2021-11-02
317308,JAKARTA BARAT,KEMBANGAN,20218,2,19907,302,7,9,2021-11-02
317302,JAKARTA BARAT,GROGOL PETAMBURAN,19060,1,18756,298,5,6,2021-11-02
317407,JAKARTA SELATAN,KEBAYORAN BARU,13857,4,13657,185,11,15,2021-11-03
317405,JAKARTA SELATAN,KEBAYORAN LAMA,20023,3,19655,362,3,6,2021-11-03
317305,JAKARTA BARAT,KEBON JERUK,22053,5,21670,374,4,9,2021-11-03
317206,JAKARTA UTARA,KELAPA GADING,12617,1,12396,192,28,29,2021-11-03
310101,KAB.ADM.KEP.SERIBU,KEP. SERIBU UTARA,639,0,633,6,0,0,2021-11-03
317308,JAKARTA BARAT,KEMBANGAN,20219,2,19908,303,6,8,2021-11-03
310102,KAB.ADM.KEP.SERIBU,KEP. SERIBU SELATAN,703,0,693,10,0,0,2021-11-03
317306,JAKARTA BARAT,KALI DERES,17987,4,17660,316,7,11,2021-11-03
317203,JAKARTA UTARA,KOJA,17200,4,16837,337,22,26,2021-11-03
317103,JAKARTA PUSAT,KEMAYORAN,19927,3,19543,372,9,12,2021-11-03
317108,JAKARTA PUSAT,JOHAR BARU,8674,0,8510,157,7,7,2021-11-03
317507,JAKARTA TIMUR,DUREN SAWIT,29433,4,28798,611,20,24,2021-11-03
317409,JAKARTA SELATAN,JAGAKARSA,26568,2,26157,406,3,5,2021-11-03
317302,JAKARTA BARAT,GROGOL PETAMBURAN,19060,1,18757,298,4,5,2021-11-03
317101,JAKARTA PUSAT,GAMBIR,8545,1,8406,134,4,5,2021-11-03
317509,JAKARTA TIMUR,CIRACAS,22430,5,22021,379,25,30,2021-11-03
317510,JAKARTA TIMUR,CIPAYUNG,25166,3,24884,267,12,15,2021-11-03
317204,JAKARTA UTARA,CILINCING,17386,2,17022,340,22,24,2021-11-03
317406,JAKARTA SELATAN,CILANDAK,17661,5,17389,261,6,11,2021-11-03
317301,JAKARTA BARAT,CENGKARENG,28588,12,28004,557,15,27,2021-11-03
317506,JAKARTA TIMUR,CAKUNG,22639,5,22200,412,22,27,2021-11-03
317504,JAKARTA TIMUR,KRAMAT JATI,21602,3,21184,402,13,16,2021-11-03
317503,JAKARTA TIMUR,JATINEGARA,19552,2,19138,383,29,31,2021-11-03
317105,JAKARTA PUSAT,CEMPAKA PUTIH,10503,12,10304,167,20,32,2021-11-03
317403,JAKARTA SELATAN,MAMPANG PRAPATAN,11498,0,11314,179,5,5,2021-11-03
317303,JAKARTA BARAT,TAMAN SARI,8748,1,8602,140,5,6,2021-11-03
111111,Luar DKI & Proses Update,Luar DKI & Proses Update,143008,137,141294,1273,304,441,2021-11-03
317508,JAKARTA TIMUR,MAKASAR,17466,3,17158,296,9,12,2021-11-03
317401,JAKARTA SELATAN,TEBET,16933,2,16645,278,8,10,2021-11-03
317202,JAKARTA UTARA,TANJUNG PRIOK,25728,3,25288,425,12,15,2021-11-03
317107,JAKARTA PUSAT,TANAH ABANG,11023,3,10793,223,4,7,2021-11-03
317304,JAKARTA BARAT,TAMBORA,14100,1,13840,252,7,8,2021-11-03
317402,JAKARTA SELATAN,SETIA BUDI,11974,3,11782,182,7,10,2021-11-03
317104,JAKARTA PUSAT,SENEN,9375,2,9199,168,6,8,2021-11-03
317502,JAKARTA TIMUR,PULO GADUNG,21768,5,21348,399,16,21,2021-11-03
317102,JAKARTA PUSAT,SAWAH BESAR,9148,2,8970,172,4,6,2021-11-03
317201,JAKARTA UTARA,PENJARINGAN,18608,5,18359,229,15,20,2021-11-03
317505,JAKARTA TIMUR,PASAR REBO,17626,7,17284,326,9,16,2021-11-03
317404,JAKARTA SELATAN,PASAR MINGGU,23786,9,23344,425,8,17,2021-11-03
317408,JAKARTA SELATAN,PANCORAN,14307,3,14068,227,9,12,2021-11-03
317307,JAKARTA BARAT,PALMERAH,15817,3,15484,329,1,4,2021-11-03
317205,JAKARTA UTARA,PADEMANGAN,12812,0,12604,163,45,45,2021-11-03
317106,JAKARTA PUSAT,MENTENG,6427,0,6306,119,2,2,2021-11-03
317501,JAKARTA TIMUR,MATRAMAN,14206,3,13907,279,17,20,2021-11-03
317410,JAKARTA SELATAN,PESANGGRAHAN,16359,6,16089,252,12,18,2021-11-03
317408,JAKARTA SELATAN,PANCORAN,14313,5,14068,227,13,18,2021-11-04
317505,JAKARTA TIMUR,PASAR REBO,17628,8,17285,326,9,17,2021-11-04
317404,JAKARTA SELATAN,PASAR MINGGU,23788,11,23344,425,8,19,2021-11-04
317307,JAKARTA BARAT,PALMERAH,15817,3,15484,329,1,4,2021-11-04
317508,JAKARTA TIMUR,MAKASAR,17466,2,17159,296,9,11,2021-11-04
317106,JAKARTA PUSAT,MENTENG,6427,0,6306,119,2,2,2021-11-04
317501,JAKARTA TIMUR,MATRAMAN,14207,3,13907,279,18,21,2021-11-04
317201,JAKARTA UTARA,PENJARINGAN,18610,4,18360,229,17,21,2021-11-04
317205,JAKARTA UTARA,PADEMANGAN,12823,1,12605,163,54,55,2021-11-04
317410,JAKARTA SELATAN,PESANGGRAHAN,16360,6,16090,252,12,18,2021-11-04
111111,Luar DKI & Proses Update,Luar DKI & Proses Update,143008,137,141294,1273,304,441,2021-11-04
317102,JAKARTA PUSAT,SAWAH BESAR,9148,2,8970,172,4,6,2021-11-04
317104,JAKARTA PUSAT,SENEN,9376,3,9199,168,6,9,2021-11-04
317402,JAKARTA SELATAN,SETIA BUDI,11974,2,11783,182,7,9,2021-11-04
317303,JAKARTA BARAT,TAMAN SARI,8749,1,8602,140,6,7,2021-11-04
317304,JAKARTA BARAT,TAMBORA,14100,1,13840,252,7,8,2021-11-04
317107,JAKARTA PUSAT,TANAH ABANG,11025,2,10794,223,6,8,2021-11-04
317202,JAKARTA UTARA,TANJUNG PRIOK,25732,5,25288,425,14,19,2021-11-04
317401,JAKARTA SELATAN,TEBET,16934,2,16645,278,9,11,2021-11-04
317403,JAKARTA SELATAN,MAMPANG PRAPATAN,11499,0,11314,179,6,6,2021-11-04
317502,JAKARTA TIMUR,PULO GADUNG,21773,5,21350,399,19,24,2021-11-04
317504,JAKARTA TIMUR,KRAMAT JATI,21601,2,21185,402,12,14,2021-11-04
317206,JAKARTA UTARA,KELAPA GADING,12618,1,12396,192,29,30,2021-11-04
317507,JAKARTA TIMUR,DUREN SAWIT,29440,6,28799,611,24,30,2021-11-04
317105,JAKARTA PUSAT,CEMPAKA PUTIH,10507,13,10304,167,23,36,2021-11-04
317301,JAKARTA BARAT,CENGKARENG,28591,14,28005,557,15,29,2021-11-04
317406,JAKARTA SELATAN,CILANDAK,17664,7,17389,261,7,14,2021-11-04
317204,JAKARTA UTARA,CILINCING,17388,2,17022,340,24,26,2021-11-04
317510,JAKARTA TIMUR,CIPAYUNG,25167,4,24884,267,12,16,2021-11-04
317509,JAKARTA TIMUR,CIRACAS,22433,5,22021,379,28,33,2021-11-04
317203,JAKARTA UTARA,KOJA,17203,5,16838,337,23,28,2021-11-04
317101,JAKARTA PUSAT,GAMBIR,8545,0,8407,134,4,4,2021-11-04
317302,JAKARTA BARAT,GROGOL PETAMBURAN,19060,0,18758,298,4,4,2021-11-04
317503,JAKARTA TIMUR,JATINEGARA,19553,1,19139,383,30,31,2021-11-04
317409,JAKARTA SELATAN,JAGAKARSA,26569,3,26157,406,3,6,2021-11-04
317306,JAKARTA BARAT,KALI DERES,17990,7,17660,316,7,14,2021-11-04
317407,JAKARTA SELATAN,KEBAYORAN BARU,13858,5,13657,185,11,16,2021-11-04
317405,JAKARTA SELATAN,KEBAYORAN LAMA,20023,3,19655,362,3,6,2021-11-04
317305,JAKARTA BARAT,KEBON JERUK,22056,5,21671,374,6,11,2021-11-04
317506,JAKARTA TIMUR,CAKUNG,22640,4,22201,412,23,27,2021-11-04
317103,JAKARTA PUSAT,KEMAYORAN,19927,3,19543,372,9,12,2021-11-04
317308,JAKARTA BARAT,KEMBANGAN,20219,2,19908,303,6,8,2021-11-04
310102,KAB.ADM.KEP.SERIBU,KEP. SERIBU SELATAN,703,0,693,10,0,0,2021-11-04
310101,KAB.ADM.KEP.SERIBU,KEP. SERIBU UTARA,639,0,633,6,0,0,2021-11-04
317108,JAKARTA PUSAT,JOHAR BARU,8675,1,8511,157,6,7,2021-11-04
317404,JAKARTA SELATAN,PASAR MINGGU,23791,11,23346,425,9,20,2021-11-05
317505,JAKARTA TIMUR,PASAR REBO,17628,7,17286,326,9,16,2021-11-05
317408,JAKARTA SELATAN,PANCORAN,14315,5,14069,227,14,19,2021-11-05
317501,JAKARTA TIMUR,MATRAMAN,14207,3,13907,279,18,21,2021-11-05
317205,JAKARTA UTARA,PADEMANGAN,12829,1,12605,163,60,61,2021-11-05
317106,JAKARTA PUSAT,MENTENG,6427,0,6306,119,2,2,2021-11-05
317201,JAKARTA UTARA,PENJARINGAN,18610,4,18360,229,17,21,2021-11-05
317307,JAKARTA BARAT,PALMERAH,15818,3,15484,329,2,5,2021-11-05
317410,JAKARTA SELATAN,PESANGGRAHAN,16362,5,16091,252,14,19,2021-11-05
317407,JAKARTA SELATAN,KEBAYORAN BARU,13859,5,13658,185,11,16,2021-11-05
317102,JAKARTA PUSAT,SAWAH BESAR,9149,2,8970,172,5,7,2021-11-05
317104,JAKARTA PUSAT,SENEN,9376,3,9199,168,6,9,2021-11-05
317402,JAKARTA SELATAN,SETIA BUDI,11977,4,11784,182,7,11,2021-11-05
317303,JAKARTA BARAT,TAMAN SARI,8749,1,8602,140,6,7,2021-11-05
317304,JAKARTA BARAT,TAMBORA,14101,1,13840,252,8,9,2021-11-05
317107,JAKARTA PUSAT,TANAH ABANG,11025,2,10794,223,6,8,2021-11-05
317202,JAKARTA UTARA,TANJUNG PRIOK,25738,5,25288,425,20,25,2021-11-05
317401,JAKARTA SELATAN,TEBET,16936,1,16646,278,11,12,2021-11-05
111111,Luar DKI & Proses Update,Luar DKI & Proses Update,143008,137,141294,1273,304,441,2021-11-05
317403,JAKARTA SELATAN,MAMPANG PRAPATAN,11500,0,11314,179,7,7,2021-11-05
317502,JAKARTA TIMUR,PULO GADUNG,21775,5,21350,399,21,26,2021-11-05
317508,JAKARTA TIMUR,MAKASAR,17467,2,17159,296,10,12,2021-11-05
317105,JAKARTA PUSAT,CEMPAKA PUTIH,10508,14,10304,167,23,37,2021-11-05
317203,JAKARTA UTARA,KOJA,17210,5,16838,337,30,35,2021-11-05
317506,JAKARTA TIMUR,CAKUNG,22643,4,22201,412,26,30,2021-11-05
317301,JAKARTA BARAT,CENGKARENG,28595,17,28005,558,15,32,2021-11-05
317504,JAKARTA TIMUR,KRAMAT JATI,21602,2,21185,402,13,15,2021-11-05
317406,JAKARTA SELATAN,CILANDAK,17664,7,17389,261,7,14,2021-11-05
317204,JAKARTA UTARA,CILINCING,17394,1,17023,340,30,31,2021-11-05
317510,JAKARTA TIMUR,CIPAYUNG,25170,5,24884,267,14,19,2021-11-05
317507,JAKARTA TIMUR,DUREN SAWIT,29443,5,28800,611,27,32,2021-11-05
317101,JAKARTA PUSAT,GAMBIR,8546,0,8407,134,5,5,2021-11-05
317302,JAKARTA BARAT,GROGOL PETAMBURAN,19068,1,18758,298,11,12,2021-11-05
317409,JAKARTA SELATAN,JAGAKARSA,26571,4,26157,406,4,8,2021-11-05
317509,JAKARTA TIMUR,CIRACAS,22448,5,22021,379,43,48,2021-11-05
317108,JAKARTA PUSAT,JOHAR BARU,8675,1,8511,157,6,7,2021-11-05
317306,JAKARTA BARAT,KALI DERES,17990,7,17660,316,7,14,2021-11-05
317405,JAKARTA SELATAN,KEBAYORAN LAMA,20029,3,19655,362,9,12,2021-11-05
310101,KAB.ADM.KEP.SERIBU,KEP. SERIBU UTARA,640,0,633,6,1,1,2021-11-05
317305,JAKARTA BARAT,KEBON JERUK,22059,6,21671,374,8,14,2021-11-05
317206,JAKARTA UTARA,KELAPA GADING,12621,1,12396,192,32,33,2021-11-05
317103,JAKARTA PUSAT,KEMAYORAN,19928,3,19543,372,10,13,2021-11-05
317308,JAKARTA BARAT,KEMBANGAN,20220,2,19908,303,7,9,2021-11-05
317503,JAKARTA TIMUR,JATINEGARA,19553,1,19139,383,30,31,2021-11-05
310102,KAB.ADM.KEP.SERIBU,KEP. SERIBU SELATAN,704,0,693,10,1,1,2021-11-05
317404,JAKARTA SELATAN,PASAR MINGGU,23793,11,23349,425,8,19,2021-11-06
317408,JAKARTA SELATAN,PANCORAN,14317,7,14073,227,10,17,2021-11-06
317501,JAKARTA TIMUR,MATRAMAN,14207,2,13915,279,11,13,2021-11-06
317205,JAKARTA UTARA,PADEMANGAN,12829,1,12619,163,46,47,2021-11-06
317106,JAKARTA PUSAT,MENTENG,6429,1,6306,119,3,4,2021-11-06
317403,JAKARTA SELATAN,MAMPANG PRAPATAN,11500,0,11316,179,5,5,2021-11-06
317505,JAKARTA TIMUR,PASAR REBO,17632,5,17290,326,11,16,2021-11-06
317307,JAKARTA BARAT,PALMERAH,15818,3,15485,329,1,4,2021-11-06
317201,JAKARTA UTARA,PENJARINGAN,18615,5,18366,229,15,20,2021-11-06
317303,JAKARTA BARAT,TAMAN SARI,8749,1,8603,140,5,6,2021-11-06
317502,JAKARTA TIMUR,PULO GADUNG,21777,5,21359,399,14,19,2021-11-06
317508,JAKARTA TIMUR,MAKASAR,17467,2,17161,296,8,10,2021-11-06
111111,Luar DKI & Proses Update,Luar DKI & Proses Update,143008,137,141294,1273,304,441,2021-11-06
317401,JAKARTA SELATAN,TEBET,16937,1,16649,278,9,10,2021-11-06
317202,JAKARTA UTARA,TANJUNG PRIOK,25739,5,25291,425,18,23,2021-11-06
317107,JAKARTA PUSAT,TANAH ABANG,11025,2,10794,223,6,8,2021-11-06
317304,JAKARTA BARAT,TAMBORA,14101,0,13841,253,7,7,2021-11-06
317402,JAKARTA SELATAN,SETIA BUDI,11978,4,11785,182,7,11,2021-11-06
317410,JAKARTA SELATAN,PESANGGRAHAN,16365,3,16099,252,11,14,2021-11-06
317504,JAKARTA TIMUR,KRAMAT JATI,21603,1,21192,402,8,9,2021-11-06
317102,JAKARTA PUSAT,SAWAH BESAR,9149,1,8974,172,2,3,2021-11-06
310101,KAB.ADM.KEP.SERIBU,KEP. SERIBU UTARA,640,0,633,6,1,1,2021-11-06
317506,JAKARTA TIMUR,CAKUNG,22644,3,22209,412,20,23,2021-11-06
317105,JAKARTA PUSAT,CEMPAKA PUTIH,10508,13,10309,167,19,32,2021-11-06
317301,JAKARTA BARAT,CENGKARENG,28598,17,28008,558,15,32,2021-11-06
317406,JAKARTA SELATAN,CILANDAK,17658,4,17388,261,5,9,2021-11-06
317204,JAKARTA UTARA,CILINCING,17392,0,17030,340,22,22,2021-11-06
317510,JAKARTA TIMUR,CIPAYUNG,25172,5,24891,267,9,14,2021-11-06
317509,JAKARTA TIMUR,CIRACAS,22448,4,22026,379,39,43,2021-11-06
317507,JAKARTA TIMUR,DUREN SAWIT,29446,5,28807,611,23,28,2021-11-06
317101,JAKARTA PUSAT,GAMBIR,8546,0,8407,134,5,5,2021-11-06
317203,JAKARTA UTARA,KOJA,17213,5,16847,337,24,29,2021-11-06
317302,JAKARTA BARAT,GROGOL PETAMBURAN,19071,2,18758,298,13,15,2021-11-06
317503,JAKARTA TIMUR,JATINEGARA,19556,1,19148,383,24,25,2021-11-06
317108,JAKARTA PUSAT,JOHAR BARU,8675,1,8512,157,5,6,2021-11-06
317306,JAKARTA BARAT,KALI DERES,17991,5,17665,316,5,10,2021-11-06
317407,JAKARTA SELATAN,KEBAYORAN BARU,13859,4,13662,185,8,12,2021-11-06
317405,JAKARTA SELATAN,KEBAYORAN LAMA,20029,2,19657,362,8,10,2021-11-06
317305,JAKARTA BARAT,KEBON JERUK,22059,6,21672,374,7,13,2021-11-06
317206,JAKARTA UTARA,KELAPA GADING,12621,1,12407,192,21,22,2021-11-06
317103,JAKARTA PUSAT,KEMAYORAN,19930,4,19547,372,7,11,2021-11-06
317308,JAKARTA BARAT,KEMBANGAN,20221,2,19910,303,6,8,2021-11-06
310102,KAB.ADM.KEP.SERIBU,KEP. SERIBU SELATAN,704,0,693,10,1,1,2021-11-06
317409,JAKARTA SELATAN,JAGAKARSA,26569,4,26156,406,3,7,2021-11-06
317104,JAKARTA PUSAT,SENEN,9376,3,9200,168,5,8,2021-11-06
111111,Luar DKI & Proses Update,Luar DKI & Proses Update,143008,137,141294,1273,304,441,2021-11-07
317204,JAKARTA UTARA,CILINCING,17395,0,17036,340,19,19,2021-11-07
317408,JAKARTA SELATAN,PANCORAN,14317,6,14074,227,10,16,2021-11-07
317203,JAKARTA UTARA,KOJA,17212,5,16851,337,19,24,2021-11-07
317508,JAKARTA TIMUR,MAKASAR,17467,1,17162,296,8,9,2021-11-07
317403,JAKARTA SELATAN,MAMPANG PRAPATAN,11501,0,11319,179,3,3,2021-11-07
317501,JAKARTA TIMUR,MATRAMAN,14209,2,13917,279,11,13,2021-11-07
317106,JAKARTA PUSAT,MENTENG,6429,1,6306,119,3,4,2021-11-07
317205,JAKARTA UTARA,PADEMANGAN,12829,1,12627,163,38,39,2021-11-07
317307,JAKARTA BARAT,PALMERAH,15818,2,15486,329,1,3,2021-11-07
317404,JAKARTA SELATAN,PASAR MINGGU,23793,9,23351,425,8,17,2021-11-07
317505,JAKARTA TIMUR,PASAR REBO,17632,4,17291,326,11,15,2021-11-07
310101,KAB.ADM.KEP.SERIBU,KEP. SERIBU UTARA,640,0,633,6,1,1,2021-11-07
317201,JAKARTA UTARA,PENJARINGAN,18620,5,18366,229,20,25,2021-11-07
317502,JAKARTA TIMUR,PULO GADUNG,21779,5,21362,399,13,18,2021-11-07
317102,JAKARTA PUSAT,SAWAH BESAR,9149,1,8974,172,2,3,2021-11-07
317104,JAKARTA PUSAT,SENEN,9377,2,9203,168,4,6,2021-11-07
317402,JAKARTA SELATAN,SETIA BUDI,11980,4,11785,182,9,13,2021-11-07
317303,JAKARTA BARAT,TAMAN SARI,8752,2,8604,140,6,8,2021-11-07
317304,JAKARTA BARAT,TAMBORA,14106,0,13841,253,12,12,2021-11-07
317107,JAKARTA PUSAT,TANAH ABANG,11028,2,10795,223,8,10,2021-11-07
317202,JAKARTA UTARA,TANJUNG PRIOK,25740,5,25291,425,19,24,2021-11-07
317401,JAKARTA SELATAN,TEBET,16937,1,16651,278,7,8,2021-11-07
317410,JAKARTA SELATAN,PESANGGRAHAN,16366,3,16100,252,11,14,2021-11-07
310102,KAB.ADM.KEP.SERIBU,KEP. SERIBU SELATAN,704,0,693,10,1,1,2021-11-07
317504,JAKARTA TIMUR,KRAMAT JATI,21606,1,21192,402,11,12,2021-11-07
317103,JAKARTA PUSAT,KEMAYORAN,19930,3,19548,372,7,10,2021-11-07
317506,JAKARTA TIMUR,CAKUNG,22645,2,22217,412,14,16,2021-11-07
317105,JAKARTA PUSAT,CEMPAKA PUTIH,10510,11,10316,167,16,27,2021-11-07
317301,JAKARTA BARAT,CENGKARENG,28602,18,28010,558,16,34,2021-11-07
317406,JAKARTA SELATAN,CILANDAK,17666,4,17394,261,7,11,2021-11-07
317510,JAKARTA TIMUR,CIPAYUNG,25173,5,24891,267,10,15,2021-11-07
317308,JAKARTA BARAT,KEMBANGAN,20227,3,19912,303,9,12,2021-11-07
317507,JAKARTA TIMUR,DUREN SAWIT,29450,5,28810,611,24,29,2021-11-07
317101,JAKARTA PUSAT,GAMBIR,8546,0,8407,134,5,5,2021-11-07
317302,JAKARTA BARAT,GROGOL PETAMBURAN,19072,2,18759,298,13,15,2021-11-07
317509,JAKARTA TIMUR,CIRACAS,22477,4,22028,379,66,70,2021-11-07
317503,JAKARTA TIMUR,JATINEGARA,19560,1,19164,383,12,13,2021-11-07
317108,JAKARTA PUSAT,JOHAR BARU,8675,1,8514,157,3,4,2021-11-07
317306,JAKARTA BARAT,KALI DERES,17995,5,17666,316,8,13,2021-11-07
317407,JAKARTA SELATAN,KEBAYORAN BARU,13860,5,13664,185,6,11,2021-11-07
317405,JAKARTA SELATAN,KEBAYORAN LAMA,20032,2,19657,362,11,13,2021-11-07
317305,JAKARTA BARAT,KEBON JERUK,22061,6,21672,374,9,15,2021-11-07
317206,JAKARTA UTARA,KELAPA GADING,12621,1,12412,192,16,17,2021-11-07
317409,JAKARTA SELATAN,JAGAKARSA,26574,4,26161,406,3,7,2021-11-07
317501,JAKARTA TIMUR,MATRAMAN,14209,2,13918,279,10,12,2021-11-08
317404,JAKARTA SELATAN,PASAR MINGGU,23793,8,23352,425,8,16,2021-11-08
317408,JAKARTA SELATAN,PANCORAN,14317,6,14075,227,9,15,2021-11-08
317307,JAKARTA BARAT,PALMERAH,15818,2,15486,329,1,3,2021-11-08
317205,JAKARTA UTARA,PADEMANGAN,12830,1,12628,163,38,39,2021-11-08
317403,JAKARTA SELATAN,MAMPANG PRAPATAN,11501,0,11319,179,3,3,2021-11-08
317504,JAKARTA TIMUR,KRAMAT JATI,21606,0,21193,402,11,11,2021-11-08
317508,JAKARTA TIMUR,MAKASAR,17467,1,17163,296,7,8,2021-11-08
317505,JAKARTA TIMUR,PASAR REBO,17632,4,17295,326,7,11,2021-11-08
317106,JAKARTA PUSAT,MENTENG,6429,1,6306,119,3,4,2021-11-08
317201,JAKARTA UTARA,PENJARINGAN,18621,5,18367,229,20,25,2021-11-08
317308,JAKARTA BARAT,KEMBANGAN,20228,3,19913,303,9,12,2021-11-08
317502,JAKARTA TIMUR,PULO GADUNG,21779,5,21363,399,12,17,2021-11-08
317102,JAKARTA PUSAT,SAWAH BESAR,9149,1,8974,172,2,3,2021-11-08
317104,JAKARTA PUSAT,SENEN,9377,2,9204,168,3,5,2021-11-08
317402,JAKARTA SELATAN,SETIA BUDI,11980,4,11790,182,4,8,2021-11-08
317303,JAKARTA BARAT,TAMAN SARI,8752,2,8605,140,5,7,2021-11-08
317304,JAKARTA BARAT,TAMBORA,14106,0,13841,253,12,12,2021-11-08
317203,JAKARTA UTARA,KOJA,17212,5,16852,337,18,23,2021-11-08
317107,JAKARTA PUSAT,TANAH ABANG,11028,1,10796,223,8,9,2021-11-08
317202,JAKARTA UTARA,TANJUNG PRIOK,25740,4,25292,425,19,23,2021-11-08
317401,JAKARTA SELATAN,TEBET,16937,0,16654,278,5,5,2021-11-08
317410,JAKARTA SELATAN,PESANGGRAHAN,16366,3,16100,252,11,14,2021-11-08
310101,KAB.ADM.KEP.SERIBU,KEP. SERIBU UTARA,640,0,633,6,1,1,2021-11-08
317507,JAKARTA TIMUR,DUREN SAWIT,29451,5,28814,611,21,26,2021-11-08
111111,Luar DKI & Proses Update,Luar DKI & Proses Update,143008,137,141294,1273,304,441,2021-11-08
310102,KAB.ADM.KEP.SERIBU,KEP. SERIBU SELATAN,704,0,693,10,1,1,2021-11-08
317506,JAKARTA TIMUR,CAKUNG,22645,2,22220,412,11,13,2021-11-08
317105,JAKARTA PUSAT,CEMPAKA PUTIH,10510,11,10316,167,16,27,2021-11-08
317301,JAKARTA BARAT,CENGKARENG,28602,14,28015,558,15,29,2021-11-08
317406,JAKARTA SELATAN,CILANDAK,17671,4,17396,261,10,14,2021-11-08
317204,JAKARTA UTARA,CILINCING,17396,0,17037,340,19,19,2021-11-08
317509,JAKARTA TIMUR,CIRACAS,22478,3,22029,379,67,70,2021-11-08
317101,JAKARTA PUSAT,GAMBIR,8546,0,8407,134,5,5,2021-11-08
317302,JAKARTA BARAT,GROGOL PETAMBURAN,19072,2,18759,298,13,15,2021-11-08
317510,JAKARTA TIMUR,CIPAYUNG,25173,5,24892,267,9,14,2021-11-08
317503,JAKARTA TIMUR,JATINEGARA,19560,1,19164,383,12,13,2021-11-08
317409,JAKARTA SELATAN,JAGAKARSA,26575,4,26161,406,4,8,2021-11-08
317206,JAKARTA UTARA,KELAPA GADING,12621,1,12416,192,12,13,2021-11-08
317305,JAKARTA BARAT,KEBON JERUK,22062,6,21673,374,9,15,2021-11-08
317405,JAKARTA SELATAN,KEBAYORAN LAMA,20033,2,19657,362,12,14,2021-11-08
317103,JAKARTA PUSAT,KEMAYORAN,19930,3,19548,372,7,10,2021-11-08
317306,JAKARTA BARAT,KALI DERES,17995,5,17666,316,8,13,2021-11-08
317108,JAKARTA PUSAT,JOHAR BARU,8675,1,8514,157,3,4,2021-11-08
317407,JAKARTA SELATAN,KEBAYORAN BARU,13864,5,13664,185,10,15,2021-11-08
317307,JAKARTA BARAT,PALMERAH,15819,2,15487,329,1,3,2021-11-09
310101,KAB.ADM.KEP.SERIBU,KEP. SERIBU UTARA,640,0,633,6,1,1,2021-11-09
317203,JAKARTA UTARA,KOJA,17212,5,16856,337,14,19,2021-11-09
317504,JAKARTA TIMUR,KRAMAT JATI,21607,0,21196,402,9,9,2021-11-09
317508,JAKARTA TIMUR,MAKASAR,17467,0,17165,296,6,6,2021-11-09
317403,JAKARTA SELATAN,MAMPANG PRAPATAN,11501,0,11319,179,3,3,2021-11-09
317501,JAKARTA TIMUR,MATRAMAN,14209,2,13919,279,9,11,2021-11-09
317106,JAKARTA PUSAT,MENTENG,6429,1,6306,119,3,4,2021-11-09
317205,JAKARTA UTARA,PADEMANGAN,12832,3,12632,163,34,37,2021-11-09
317408,JAKARTA SELATAN,PANCORAN,14319,6,14076,227,10,16,2021-11-09
317402,JAKARTA SELATAN,SETIA BUDI,11982,5,11791,182,4,9,2021-11-09
317505,JAKARTA TIMUR,PASAR REBO,17632,4,17296,326,6,10,2021-11-09
317201,JAKARTA UTARA,PENJARINGAN,18621,2,18374,229,16,18,2021-11-09
317410,JAKARTA SELATAN,PESANGGRAHAN,16366,2,16105,252,7,9,2021-11-09
317502,JAKARTA TIMUR,PULO GADUNG,21782,4,21369,399,10,14,2021-11-09
317102,JAKARTA PUSAT,SAWAH BESAR,9150,2,8975,172,1,3,2021-11-09
317104,JAKARTA PUSAT,SENEN,9377,2,9205,168,2,4,2021-11-09
317202,JAKARTA UTARA,TANJUNG PRIOK,25742,6,25294,425,17,23,2021-11-09
317401,JAKARTA SELATAN,TEBET,16938,0,16654,278,6,6,2021-11-09
310102,KAB.ADM.KEP.SERIBU,KEP. SERIBU SELATAN,704,0,693,10,1,1,2021-11-09
317404,JAKARTA SELATAN,PASAR MINGGU,23794,5,23356,425,8,13,2021-11-09
317308,JAKARTA BARAT,KEMBANGAN,20232,6,19915,303,8,14,2021-11-09
317303,JAKARTA BARAT,TAMAN SARI,8752,2,8607,140,3,5,2021-11-09
317206,JAKARTA UTARA,KELAPA GADING,12622,2,12419,192,9,11,2021-11-09
111111,Luar DKI & Proses Update,Luar DKI & Proses Update,143008,137,141294,1273,304,441,2021-11-09
317107,JAKARTA PUSAT,TANAH ABANG,11028,1,10797,223,7,8,2021-11-09
317506,JAKARTA TIMUR,CAKUNG,22645,1,22222,412,10,11,2021-11-09
317105,JAKARTA PUSAT,CEMPAKA PUTIH,10511,10,10319,167,15,25,2021-11-09
317301,JAKARTA BARAT,CENGKARENG,28612,23,28024,558,7,30,2021-11-09
317406,JAKARTA SELATAN,CILANDAK,17673,3,17400,261,9,12,2021-11-09
317204,JAKARTA UTARA,CILINCING,17397,0,17042,340,15,15,2021-11-09
317510,JAKARTA TIMUR,CIPAYUNG,25175,6,24895,267,7,13,2021-11-09
317103,JAKARTA PUSAT,KEMAYORAN,19936,3,19551,372,10,13,2021-11-09
317509,JAKARTA TIMUR,CIRACAS,22478,3,22039,379,57,60,2021-11-09
317101,JAKARTA PUSAT,GAMBIR,8547,1,8407,134,5,6,2021-11-09
317302,JAKARTA BARAT,GROGOL PETAMBURAN,19072,2,18759,298,13,15,2021-11-09
317409,JAKARTA SELATAN,JAGAKARSA,26575,4,26161,406,4,8,2021-11-09
317503,JAKARTA TIMUR,JATINEGARA,19560,1,19166,383,10,11,2021-11-09
317108,JAKARTA PUSAT,JOHAR BARU,8675,1,8515,157,2,3,2021-11-09
317306,JAKARTA BARAT,KALI DERES,17996,5,17670,316,5,10,2021-11-09
317407,JAKARTA SELATAN,KEBAYORAN BARU,13864,4,13667,185,8,12,2021-11-09
317405,JAKARTA SELATAN,KEBAYORAN LAMA,20035,3,19660,362,10,13,2021-11-09
317305,JAKARTA BARAT,KEBON JERUK,22062,5,21674,374,9,14,2021-11-09
317507,JAKARTA TIMUR,DUREN SAWIT,29452,5,28815,611,21,26,2021-11-09
317304,JAKARTA BARAT,TAMBORA,14107,0,13841,253,13,13,2021-11-09
111111,Luar DKI & Proses Update,Luar DKI & Proses Update,143008,137,141294,1273,304,441,2021-11-10
310102,KAB.ADM.KEP.SERIBU,KEP. SERIBU SELATAN,704,0,693,10,1,1,2021-11-10
317506,JAKARTA TIMUR,CAKUNG,22645,1,22222,412,10,11,2021-11-10
317403,JAKARTA SELATAN,MAMPANG PRAPATAN,11502,1,11319,179,3,4,2021-11-10
317501,JAKARTA TIMUR,MATRAMAN,14211,2,13921,279,9,11,2021-11-10
317106,JAKARTA PUSAT,MENTENG,6429,1,6306,119,3,4,2021-11-10
317205,JAKARTA UTARA,PADEMANGAN,12837,4,12632,163,38,42,2021-11-10
317307,JAKARTA BARAT,PALMERAH,15821,4,15487,329,1,5,2021-11-10
317408,JAKARTA SELATAN,PANCORAN,14320,6,14076,227,11,17,2021-11-10
317404,JAKARTA SELATAN,PASAR MINGGU,23794,3,23358,425,8,11,2021-11-10
317505,JAKARTA TIMUR,PASAR REBO,17632,3,17298,326,5,8,2021-11-10
317508,JAKARTA TIMUR,MAKASAR,17468,0,17168,296,4,4,2021-11-10
317410,JAKARTA SELATAN,PESANGGRAHAN,16369,3,16105,252,9,12,2021-11-10
317102,JAKARTA PUSAT,SAWAH BESAR,9150,2,8975,172,1,3,2021-11-10
317104,JAKARTA PUSAT,SENEN,9377,2,9205,168,2,4,2021-11-10
317402,JAKARTA SELATAN,SETIA BUDI,11984,7,11791,182,4,11,2021-11-10
317303,JAKARTA BARAT,TAMAN SARI,8752,1,8608,140,3,4,2021-11-10
317304,JAKARTA BARAT,TAMBORA,14108,0,13841,253,14,14,2021-11-10
317107,JAKARTA PUSAT,TANAH ABANG,11030,3,10797,223,7,10,2021-11-10
317202,JAKARTA UTARA,TANJUNG PRIOK,25745,8,25294,425,18,26,2021-11-10
317401,JAKARTA SELATAN,TEBET,16939,1,16654,278,6,7,2021-11-10
317502,JAKARTA TIMUR,PULO GADUNG,21782,4,21369,399,10,14,2021-11-10
317504,JAKARTA TIMUR,KRAMAT JATI,21608,1,21196,402,9,10,2021-11-10
317201,JAKARTA UTARA,PENJARINGAN,18623,2,18374,229,18,20,2021-11-10
310101,KAB.ADM.KEP.SERIBU,KEP. SERIBU UTARA,640,0,633,6,1,1,2021-11-10
317203,JAKARTA UTARA,KOJA,17213,6,16857,337,13,19,2021-11-10
317105,JAKARTA PUSAT,CEMPAKA PUTIH,10511,9,10321,167,14,23,2021-11-10
317301,JAKARTA BARAT,CENGKARENG,28613,22,28026,558,7,29,2021-11-10
317406,JAKARTA SELATAN,CILANDAK,17674,3,17400,261,10,13,2021-11-10
317204,JAKARTA UTARA,CILINCING,17398,0,17042,340,16,16,2021-11-10
317510,JAKARTA TIMUR,CIPAYUNG,25177,7,24895,267,8,15,2021-11-10
317507,JAKARTA TIMUR,DUREN SAWIT,29456,7,28816,611,22,29,2021-11-10
317101,JAKARTA PUSAT,GAMBIR,8548,1,8411,134,2,3,2021-11-10
317302,JAKARTA BARAT,GROGOL PETAMBURAN,19072,2,18764,298,8,10,2021-11-10
317409,JAKARTA SELATAN,JAGAKARSA,26577,5,26161,406,5,10,2021-11-10
317509,JAKARTA TIMUR,CIRACAS,22482,0,22042,379,61,61,2021-11-10
317503,JAKARTA TIMUR,JATINEGARA,19560,1,19166,383,10,11,2021-11-10
317103,JAKARTA PUSAT,KEMAYORAN,19936,3,19551,372,10,13,2021-11-10
317206,JAKARTA UTARA,KELAPA GADING,12623,2,12419,192,10,12,2021-11-10
317305,JAKARTA BARAT,KEBON JERUK,22062,4,21676,374,8,12,2021-11-10
317405,JAKARTA SELATAN,KEBAYORAN LAMA,20035,2,19661,362,10,12,2021-11-10
317308,JAKARTA BARAT,KEMBANGAN,20234,6,19916,303,9,15,2021-11-10
317306,JAKARTA BARAT,KALI DERES,17996,5,17670,316,5,10,2021-11-10
317108,JAKARTA PUSAT,JOHAR BARU,8675,1,8515,157,2,3,2021-11-10
317407,JAKARTA SELATAN,KEBAYORAN BARU,13864,4,13667,185,8,12,2021-11-10
317201,JAKARTA UTARA,PENJARINGAN,18623,2,18375,229,17,19,2021-11-11
317403,JAKARTA SELATAN,MAMPANG PRAPATAN,11502,1,11319,179,3,4,2021-11-11
317501,JAKARTA TIMUR,MATRAMAN,14211,2,13922,279,8,10,2021-11-11
317106,JAKARTA PUSAT,MENTENG,6430,1,6306,119,4,5,2021-11-11
317205,JAKARTA UTARA,PADEMANGAN,12842,4,12632,163,43,47,2021-11-11
317307,JAKARTA BARAT,PALMERAH,15821,3,15488,329,1,4,2021-11-11
317408,JAKARTA SELATAN,PANCORAN,14320,6,14079,227,8,14,2021-11-11
317404,JAKARTA SELATAN,PASAR MINGGU,23796,4,23358,425,9,13,2021-11-11
317505,JAKARTA TIMUR,PASAR REBO,17633,4,17299,326,4,8,2021-11-11
317410,JAKARTA SELATAN,PESANGGRAHAN,16370,4,16106,252,8,12,2021-11-11
111111,Luar DKI & Proses Update,Luar DKI & Proses Update,143008,137,141294,1273,304,441,2021-11-11
317102,JAKARTA PUSAT,SAWAH BESAR,9152,2,8975,172,3,5,2021-11-11
317104,JAKARTA PUSAT,SENEN,9377,1,9207,168,1,2,2021-11-11
317402,JAKARTA SELATAN,SETIA BUDI,11987,8,11792,182,5,13,2021-11-11
317303,JAKARTA BARAT,TAMAN SARI,8752,1,8608,140,3,4,2021-11-11
317304,JAKARTA BARAT,TAMBORA,14111,0,13841,253,17,17,2021-11-11
317107,JAKARTA PUSAT,TANAH ABANG,11030,3,10797,223,7,10,2021-11-11
317202,JAKARTA UTARA,TANJUNG PRIOK,25748,7,25295,425,21,28,2021-11-11
317401,JAKARTA SELATAN,TEBET,16940,1,16654,278,7,8,2021-11-11
317508,JAKARTA TIMUR,MAKASAR,17469,0,17168,296,5,5,2021-11-11
317502,JAKARTA TIMUR,PULO GADUNG,21784,4,21370,399,11,15,2021-11-11
317203,JAKARTA UTARA,KOJA,17213,6,16857,337,13,19,2021-11-11
317504,JAKARTA TIMUR,KRAMAT JATI,21609,1,21200,402,6,7,2021-11-11
317509,JAKARTA TIMUR,CIRACAS,22485,0,22042,379,64,64,2021-11-11
317506,JAKARTA TIMUR,CAKUNG,22645,1,22221,413,10,11,2021-11-11
317105,JAKARTA PUSAT,CEMPAKA PUTIH,10512,9,10321,167,15,24,2021-11-11
317301,JAKARTA BARAT,CENGKARENG,28615,22,28028,558,7,29,2021-11-11
317406,JAKARTA SELATAN,CILANDAK,17674,2,17401,261,10,12,2021-11-11
317204,JAKARTA UTARA,CILINCING,17398,0,17044,340,14,14,2021-11-11
317510,JAKARTA TIMUR,CIPAYUNG,25177,6,24896,267,8,14,2021-11-11
310101,KAB.ADM.KEP.SERIBU,KEP. SERIBU UTARA,640,0,634,6,0,0,2021-11-11
317507,JAKARTA TIMUR,DUREN SAWIT,29458,7,28818,611,22,29,2021-11-11
317101,JAKARTA PUSAT,GAMBIR,8551,2,8411,134,4,6,2021-11-11
317409,JAKARTA SELATAN,JAGAKARSA,26579,6,26161,406,6,12,2021-11-11
317302,JAKARTA BARAT,GROGOL PETAMBURAN,19074,2,18765,298,9,11,2021-11-11
317108,JAKARTA PUSAT,JOHAR BARU,8675,1,8515,157,2,3,2021-11-11
317306,JAKARTA BARAT,KALI DERES,17999,6,17670,316,7,13,2021-11-11
317407,JAKARTA SELATAN,KEBAYORAN BARU,13864,4,13670,185,5,9,2021-11-11
317405,JAKARTA SELATAN,KEBAYORAN LAMA,20035,1,19662,362,10,11,2021-11-11
317305,JAKARTA BARAT,KEBON JERUK,22064,5,21676,374,9,14,2021-11-11
317206,JAKARTA UTARA,KELAPA GADING,12626,1,12420,192,13,14,2021-11-11
317103,JAKARTA PUSAT,KEMAYORAN,19938,3,19552,372,11,14,2021-11-11
317308,JAKARTA BARAT,KEMBANGAN,20235,6,19916,303,10,16,2021-11-11
310102,KAB.ADM.KEP.SERIBU,KEP. SERIBU SELATAN,704,0,694,10,0,0,2021-11-11
317503,JAKARTA TIMUR,JATINEGARA,19561,1,19167,383,10,11,2021-11-11
317408,JAKARTA SELATAN,PANCORAN,14322,5,14085,227,5,10,2021-11-12
317404,JAKARTA SELATAN,PASAR MINGGU,23799,3,23365,425,6,9,2021-11-12
317307,JAKARTA BARAT,PALMERAH,15821,2,15489,329,1,3,2021-11-12
317401,JAKARTA SELATAN,TEBET,16943,1,16655,278,9,10,2021-11-12
317106,JAKARTA PUSAT,MENTENG,6431,1,6308,119,3,4,2021-11-12
317501,JAKARTA TIMUR,MATRAMAN,14211,1,13927,279,4,5,2021-11-12
317403,JAKARTA SELATAN,MAMPANG PRAPATAN,11503,1,11319,179,4,5,2021-11-12
317205,JAKARTA UTARA,PADEMANGAN,12845,5,12661,163,16,21,2021-11-12
317505,JAKARTA TIMUR,PASAR REBO,17635,3,17300,326,6,9,2021-11-12
111111,Luar DKI & Proses Update,Luar DKI & Proses Update,143008,137,141294,1273,304,441,2021-11-12
317410,JAKARTA SELATAN,PESANGGRAHAN,16370,4,16106,252,8,12,2021-11-12
317502,JAKARTA TIMUR,PULO GADUNG,21785,5,21373,399,8,13,2021-11-12
317102,JAKARTA PUSAT,SAWAH BESAR,9153,2,8976,172,3,5,2021-11-12
317104,JAKARTA PUSAT,SENEN,9378,1,9208,168,1,2,2021-11-12
317402,JAKARTA SELATAN,SETIA BUDI,11987,6,11794,182,5,11,2021-11-12
317303,JAKARTA BARAT,TAMAN SARI,8752,1,8608,140,3,4,2021-11-12
317304,JAKARTA BARAT,TAMBORA,14111,0,13843,253,15,15,2021-11-12
317107,JAKARTA PUSAT,TANAH ABANG,11030,3,10799,223,5,8,2021-11-12
317508,JAKARTA TIMUR,MAKASAR,17469,0,17168,296,5,5,2021-11-12
317201,JAKARTA UTARA,PENJARINGAN,18624,1,18378,229,16,17,2021-11-12
317504,JAKARTA TIMUR,KRAMAT JATI,21610,1,21200,402,7,8,2021-11-12
317108,JAKARTA PUSAT,JOHAR BARU,8675,1,8517,157,0,1,2021-11-12
310101,KAB.ADM.KEP.SERIBU,KEP. SERIBU UTARA,640,0,634,6,0,0,2021-11-12
317506,JAKARTA TIMUR,CAKUNG,22646,2,22225,413,6,8,2021-11-12
317105,JAKARTA PUSAT,CEMPAKA PUTIH,10512,8,10332,167,5,13,2021-11-12
317301,JAKARTA BARAT,CENGKARENG,28617,22,28030,558,7,29,2021-11-12
317406,JAKARTA SELATAN,CILANDAK,17669,1,17397,261,10,11,2021-11-12
317204,JAKARTA UTARA,CILINCING,17400,0,17048,340,12,12,2021-11-12
317510,JAKARTA TIMUR,CIPAYUNG,25177,4,24903,267,3,7,2021-11-12
317509,JAKARTA TIMUR,CIRACAS,22486,0,22065,379,42,42,2021-11-12
317507,JAKARTA TIMUR,DUREN SAWIT,29459,8,28823,611,17,25,2021-11-12
317101,JAKARTA PUSAT,GAMBIR,8552,2,8411,134,5,7,2021-11-12
317203,JAKARTA UTARA,KOJA,17214,5,16861,337,11,16,2021-11-12
317302,JAKARTA BARAT,GROGOL PETAMBURAN,19076,2,18767,298,9,11,2021-11-12
317503,JAKARTA TIMUR,JATINEGARA,19560,1,19169,383,7,8,2021-11-12
317306,JAKARTA BARAT,KALI DERES,17999,5,17671,316,7,12,2021-11-12
317407,JAKARTA SELATAN,KEBAYORAN BARU,13864,2,13672,185,5,7,2021-11-12
317405,JAKARTA SELATAN,KEBAYORAN LAMA,20037,1,19662,362,12,13,2021-11-12
317305,JAKARTA BARAT,KEBON JERUK,22066,6,21677,374,9,15,2021-11-12
317206,JAKARTA UTARA,KELAPA GADING,12629,1,12424,192,12,13,2021-11-12
317103,JAKARTA PUSAT,KEMAYORAN,19938,2,19554,372,10,12,2021-11-12
317308,JAKARTA BARAT,KEMBANGAN,20235,6,19916,303,10,16,2021-11-12
310102,KAB.ADM.KEP.SERIBU,KEP. SERIBU SELATAN,704,0,694,10,0,0,2021-11-12
317409,JAKARTA SELATAN,JAGAKARSA,26577,5,26158,406,8,13,2021-11-12
317202,JAKARTA UTARA,TANJUNG PRIOK,25748,6,25304,425,13,19,2021-11-12
111111,Luar DKI & Proses Update,Luar DKI & Proses Update,143008,137,141294,1273,304,441,2021-11-13
317203,JAKARTA UTARA,KOJA,17214,1,16866,337,10,11,2021-11-13
317505,JAKARTA TIMUR,PASAR REBO,17636,4,17300,326,6,10,2021-11-13
317508,JAKARTA TIMUR,MAKASAR,17469,0,17170,296,3,3,2021-11-13
317403,JAKARTA SELATAN,MAMPANG PRAPATAN,11503,1,11320,179,3,4,2021-11-13
317106,JAKARTA PUSAT,MENTENG,6431,1,6308,119,3,4,2021-11-13
317205,JAKARTA UTARA,PADEMANGAN,12845,4,12665,163,13,17,2021-11-13
317307,JAKARTA BARAT,PALMERAH,15821,2,15489,329,1,3,2021-11-13
317408,JAKARTA SELATAN,PANCORAN,14322,4,14086,227,5,9,2021-11-13
317404,JAKARTA SELATAN,PASAR MINGGU,23799,1,23367,425,6,7,2021-11-13
317201,JAKARTA UTARA,PENJARINGAN,18624,1,18381,229,13,14,2021-11-13
317504,JAKARTA TIMUR,KRAMAT JATI,21612,2,21200,402,8,10,2021-11-13
317410,JAKARTA SELATAN,PESANGGRAHAN,16370,3,16107,252,8,11,2021-11-13
317102,JAKARTA PUSAT,SAWAH BESAR,9154,3,8976,172,3,6,2021-11-13
317104,JAKARTA PUSAT,SENEN,9378,1,9208,168,1,2,2021-11-13
317402,JAKARTA SELATAN,SETIA BUDI,11987,6,11794,182,5,11,2021-11-13
317303,JAKARTA BARAT,TAMAN SARI,8753,1,8609,140,3,4,2021-11-13
317304,JAKARTA BARAT,TAMBORA,14113,0,13847,253,13,13,2021-11-13
317107,JAKARTA PUSAT,TANAH ABANG,11030,3,10800,223,4,7,2021-11-13
317202,JAKARTA UTARA,TANJUNG PRIOK,25749,4,25307,425,13,17,2021-11-13
317401,JAKARTA SELATAN,TEBET,16945,2,16655,278,10,12,2021-11-13
317502,JAKARTA TIMUR,PULO GADUNG,21785,4,21374,399,8,12,2021-11-13
310101,KAB.ADM.KEP.SERIBU,KEP. SERIBU UTARA,640,0,634,6,0,0,2021-11-13
317501,JAKARTA TIMUR,MATRAMAN,14211,1,13928,279,3,4,2021-11-13
317308,JAKARTA BARAT,KEMBANGAN,20236,7,19916,303,10,17,2021-11-13
317506,JAKARTA TIMUR,CAKUNG,22649,1,22227,413,8,9,2021-11-13
317105,JAKARTA PUSAT,CEMPAKA PUTIH,10512,3,10337,167,5,8,2021-11-13
317301,JAKARTA BARAT,CENGKARENG,28617,19,28034,558,6,25,2021-11-13
317406,JAKARTA SELATAN,CILANDAK,17676,1,17405,261,9,10,2021-11-13
317204,JAKARTA UTARA,CILINCING,17402,0,17050,340,12,12,2021-11-13
317510,JAKARTA TIMUR,CIPAYUNG,25178,5,24903,267,3,8,2021-11-13
310102,KAB.ADM.KEP.SERIBU,KEP. SERIBU SELATAN,704,0,694,10,0,0,2021-11-13
317507,JAKARTA TIMUR,DUREN SAWIT,29460,6,28829,611,14,20,2021-11-13
317101,JAKARTA PUSAT,GAMBIR,8552,2,8411,134,5,7,2021-11-13
317302,JAKARTA BARAT,GROGOL PETAMBURAN,19077,3,18767,298,9,12,2021-11-13
317509,JAKARTA TIMUR,CIRACAS,22488,2,22065,379,42,44,2021-11-13
317103,JAKARTA PUSAT,KEMAYORAN,19938,2,19555,372,9,11,2021-11-13
317503,JAKARTA TIMUR,JATINEGARA,19561,1,19170,383,7,8,2021-11-13
317108,JAKARTA PUSAT,JOHAR BARU,8675,0,8518,157,0,0,2021-11-13
317306,JAKARTA BARAT,KALI DERES,18000,3,17674,316,7,10,2021-11-13
317407,JAKARTA SELATAN,KEBAYORAN BARU,13867,5,13672,185,5,10,2021-11-13
317405,JAKARTA SELATAN,KEBAYORAN LAMA,20039,0,19663,362,14,14,2021-11-13
317305,JAKARTA BARAT,KEBON JERUK,22067,4,21683,374,6,10,2021-11-13
317206,JAKARTA UTARA,KELAPA GADING,12629,1,12426,192,10,11,2021-11-13
317409,JAKARTA SELATAN,JAGAKARSA,26581,4,26163,406,8,12,2021-11-13
317201,JAKARTA UTARA,PENJARINGAN,18625,1,18381,229,14,15,2021-11-14
317404,JAKARTA SELATAN,PASAR MINGGU,23801,1,23366,426,8,9,2021-11-14
317408,JAKARTA SELATAN,PANCORAN,14322,3,14088,227,4,7,2021-11-14
317307,JAKARTA BARAT,PALMERAH,15822,2,15489,329,2,4,2021-11-14
317508,JAKARTA TIMUR,MAKASAR,17470,0,17171,296,3,3,2021-11-14
317106,JAKARTA PUSAT,MENTENG,6432,2,6308,119,3,5,2021-11-14
317403,JAKARTA SELATAN,MAMPANG PRAPATAN,11503,1,11321,179,2,3,2021-11-14
317410,JAKARTA SELATAN,PESANGGRAHAN,16370,2,16110,252,6,8,2021-11-14
317205,JAKARTA UTARA,PADEMANGAN,12846,4,12667,163,12,16,2021-11-14
317502,JAKARTA TIMUR,PULO GADUNG,21785,4,21378,399,4,8,2021-11-14
317505,JAKARTA TIMUR,PASAR REBO,17637,2,17303,326,6,8,2021-11-14
317104,JAKARTA PUSAT,SENEN,9379,1,9208,168,2,3,2021-11-14
317402,JAKARTA SELATAN,SETIA BUDI,11989,4,11797,182,6,10,2021-11-14
317303,JAKARTA BARAT,TAMAN SARI,8753,1,8609,140,3,4,2021-11-14
317304,JAKARTA BARAT,TAMBORA,14113,0,13848,253,12,12,2021-11-14
317107,JAKARTA PUSAT,TANAH ABANG,11031,4,10802,223,2,6,2021-11-14
317202,JAKARTA UTARA,TANJUNG PRIOK,25751,5,25314,425,7,12,2021-11-14
317401,JAKARTA SELATAN,TEBET,16946,2,16658,278,8,10,2021-11-14
111111,Luar DKI & Proses Update,Luar DKI & Proses Update,143008,137,141294,1273,304,441,2021-11-14
317504,JAKARTA TIMUR,KRAMAT JATI,21612,2,21201,402,7,9,2021-11-14
317102,JAKARTA PUSAT,SAWAH BESAR,9154,3,8977,172,2,5,2021-11-14
317203,JAKARTA UTARA,KOJA,17214,1,16875,337,1,2,2021-11-14
317501,JAKARTA TIMUR,MATRAMAN,14216,2,13928,279,7,9,2021-11-14
310102,KAB.ADM.KEP.SERIBU,KEP. SERIBU SELATAN,704,0,694,10,0,0,2021-11-14
310101,KAB.ADM.KEP.SERIBU,KEP. SERIBU UTARA,640,0,634,6,0,0,2021-11-14
317301,JAKARTA BARAT,CENGKARENG,28623,17,28037,558,11,28,2021-11-14
317406,JAKARTA SELATAN,CILANDAK,17676,1,17405,261,9,10,2021-11-14
317204,JAKARTA UTARA,CILINCING,17406,2,17056,340,8,10,2021-11-14
317510,JAKARTA TIMUR,CIPAYUNG,25178,4,24904,267,3,7,2021-11-14
317509,JAKARTA TIMUR,CIRACAS,22488,2,22069,379,38,40,2021-11-14
317507,JAKARTA TIMUR,DUREN SAWIT,29462,6,28834,611,11,17,2021-11-14
317101,JAKARTA PUSAT,GAMBIR,8555,3,8411,134,7,10,2021-11-14
317302,JAKARTA BARAT,GROGOL PETAMBURAN,19079,2,18768,298,11,13,2021-11-14
317409,JAKARTA SELATAN,JAGAKARSA,26582,3,26165,406,8,11,2021-11-14
317105,JAKARTA PUSAT,CEMPAKA PUTIH,10512,2,10341,167,2,4,2021-11-14
317108,JAKARTA PUSAT,JOHAR BARU,8677,0,8518,157,2,2,2021-11-14
317306,JAKARTA BARAT,KALI DERES,18007,6,17674,316,11,17,2021-11-14
317407,JAKARTA SELATAN,KEBAYORAN BARU,13869,5,13674,185,5,10,2021-11-14
317405,JAKARTA SELATAN,KEBAYORAN LAMA,20040,0,19669,362,9,9,2021-11-14
317305,JAKARTA BARAT,KEBON JERUK,22069,4,21685,374,6,10,2021-11-14
317506,JAKARTA TIMUR,CAKUNG,22652,2,22231,413,6,8,2021-11-14
317206,JAKARTA UTARA,KELAPA GADING,12630,1,12428,192,9,10,2021-11-14
317103,JAKARTA PUSAT,KEMAYORAN,19940,3,19557,372,8,11,2021-11-14
317503,JAKARTA TIMUR,JATINEGARA,19562,1,19173,383,5,6,2021-11-14
317308,JAKARTA BARAT,KEMBANGAN,20238,7,19917,303,11,18,2021-11-14
111111,Luar DKI & Proses Update,Luar DKI & Proses Update,143008,137,141294,1273,304,441,2021-11-15
317404,JAKARTA SELATAN,PASAR MINGGU,23801,1,23368,426,6,7,2021-11-15
317408,JAKARTA SELATAN,PANCORAN,14322,1,14090,227,4,5,2021-11-15
317307,JAKARTA BARAT,PALMERAH,15825,3,15490,329,3,6,2021-11-15
317403,JAKARTA SELATAN,MAMPANG PRAPATAN,11503,1,11322,179,1,2,2021-11-15
317106,JAKARTA PUSAT,MENTENG,6432,1,6310,119,2,3,2021-11-15
317501,JAKARTA TIMUR,MATRAMAN,14216,2,13928,279,7,9,2021-11-15
317505,JAKARTA TIMUR,PASAR REBO,17637,2,17304,326,5,7,2021-11-15
317205,JAKARTA UTARA,PADEMANGAN,12848,4,12667,163,14,18,2021-11-15
317201,JAKARTA UTARA,PENJARINGAN,18626,0,18391,229,6,6,2021-11-15
317402,JAKARTA SELATAN,SETIA BUDI,11989,4,11798,182,5,9,2021-11-15
317502,JAKARTA TIMUR,PULO GADUNG,21786,3,21379,400,4,7,2021-11-15
317102,JAKARTA PUSAT,SAWAH BESAR,9154,3,8977,172,2,5,2021-11-15
317104,JAKARTA PUSAT,SENEN,9380,2,9208,168,2,4,2021-11-15
317303,JAKARTA BARAT,TAMAN SARI,8753,1,8611,140,1,2,2021-11-15
317304,JAKARTA BARAT,TAMBORA,14114,0,13848,253,13,13,2021-11-15
317107,JAKARTA PUSAT,TANAH ABANG,11032,4,10802,223,3,7,2021-11-15
317202,JAKARTA UTARA,TANJUNG PRIOK,25751,5,25315,425,6,11,2021-11-15
317401,JAKARTA SELATAN,TEBET,16946,2,16659,278,7,9,2021-11-15
317508,JAKARTA TIMUR,MAKASAR,17470,0,17171,296,3,3,2021-11-15
317410,JAKARTA SELATAN,PESANGGRAHAN,16370,2,16113,252,3,5,2021-11-15
317504,JAKARTA TIMUR,KRAMAT JATI,21612,2,21202,402,6,8,2021-11-15
317405,JAKARTA SELATAN,KEBAYORAN LAMA,20042,1,19669,362,10,11,2021-11-15
310101,KAB.ADM.KEP.SERIBU,KEP. SERIBU UTARA,640,0,634,6,0,0,2021-11-15
317506,JAKARTA TIMUR,CAKUNG,22652,2,22231,413,6,8,2021-11-15
317105,JAKARTA PUSAT,CEMPAKA PUTIH,10512,2,10341,167,2,4,2021-11-15
317301,JAKARTA BARAT,CENGKARENG,28624,16,28040,558,10,26,2021-11-15
317406,JAKARTA SELATAN,CILANDAK,17677,1,17405,261,10,11,2021-11-15
317204,JAKARTA UTARA,CILINCING,17406,2,17056,340,8,10,2021-11-15
317203,JAKARTA UTARA,KOJA,17214,1,16875,337,1,2,2021-11-15
317509,JAKARTA TIMUR,CIRACAS,22489,2,22069,379,39,41,2021-11-15
317507,JAKARTA TIMUR,DUREN SAWIT,29462,6,28836,611,9,15,2021-11-15
317101,JAKARTA PUSAT,GAMBIR,8558,3,8412,134,9,12,2021-11-15
317302,JAKARTA BARAT,GROGOL PETAMBURAN,19079,2,18772,298,7,9,2021-11-15
317510,JAKARTA TIMUR,CIPAYUNG,25179,4,24906,267,2,6,2021-11-15
317503,JAKARTA TIMUR,JATINEGARA,19562,1,19174,383,4,5,2021-11-15
317108,JAKARTA PUSAT,JOHAR BARU,8678,0,8518,157,3,3,2021-11-15
317306,JAKARTA BARAT,KALI DERES,18010,7,17675,316,12,19,2021-11-15
317407,JAKARTA SELATAN,KEBAYORAN BARU,13869,5,13674,185,5,10,2021-11-15
317305,JAKARTA BARAT,KEBON JERUK,22072,5,21685,374,8,13,2021-11-15
317206,JAKARTA UTARA,KELAPA GADING,12630,1,12429,192,8,9,2021-11-15
317103,JAKARTA PUSAT,KEMAYORAN,19941,3,19558,372,8,11,2021-11-15
317308,JAKARTA BARAT,KEMBANGAN,20238,7,19918,303,10,17,2021-11-15
310102,KAB.ADM.KEP.SERIBU,KEP. SERIBU SELATAN,704,0,694,10,0,0,2021-11-15
317409,JAKARTA SELATAN,JAGAKARSA,26582,3,26167,406,6,9,2021-11-15
317505,JAKARTA TIMUR,PASAR REBO,17637,2,17306,326,3,5,2021-11-16
317404,JAKARTA SELATAN,PASAR MINGGU,23801,1,23368,426,6,7,2021-11-16
317408,JAKARTA SELATAN,PANCORAN,14322,1,14090,227,4,5,2021-11-16
317501,JAKARTA TIMUR,MATRAMAN,14216,2,13930,279,5,7,2021-11-16
317106,JAKARTA PUSAT,MENTENG,6433,1,6310,119,3,4,2021-11-16
317201,JAKARTA UTARA,PENJARINGAN,18627,0,18391,229,7,7,2021-11-16
317403,JAKARTA SELATAN,MAMPANG PRAPATAN,11504,1,11322,179,2,3,2021-11-16
317307,JAKARTA BARAT,PALMERAH,15826,2,15491,329,4,6,2021-11-16
317410,JAKARTA SELATAN,PESANGGRAHAN,16371,3,16114,252,2,5,2021-11-16
317502,JAKARTA TIMUR,PULO GADUNG,21786,3,21380,400,3,6,2021-11-16
317104,JAKARTA PUSAT,SENEN,9381,3,9208,168,2,5,2021-11-16
317402,JAKARTA SELATAN,SETIA BUDI,11996,4,11798,182,12,16,2021-11-16
317303,JAKARTA BARAT,TAMAN SARI,8753,1,8611,140,1,2,2021-11-16
317304,JAKARTA BARAT,TAMBORA,14114,0,13853,253,8,8,2021-11-16
317107,JAKARTA PUSAT,TANAH ABANG,11032,4,10803,223,2,6,2021-11-16
317202,JAKARTA UTARA,TANJUNG PRIOK,25751,5,25315,425,6,11,2021-11-16
317401,JAKARTA SELATAN,TEBET,16946,2,16659,278,7,9,2021-11-16
111111,Luar DKI & Proses Update,Luar DKI & Proses Update,143008,137,141294,1273,304,441,2021-11-16
317508,JAKARTA TIMUR,MAKASAR,17470,0,17171,296,3,3,2021-11-16
317102,JAKARTA PUSAT,SAWAH BESAR,9154,3,8977,172,2,5,2021-11-16
317504,JAKARTA TIMUR,KRAMAT JATI,21612,2,21205,402,3,5,2021-11-16
317205,JAKARTA UTARA,PADEMANGAN,12851,4,12668,163,16,20,2021-11-16
310101,KAB.ADM.KEP.SERIBU,KEP. SERIBU UTARA,640,0,634,6,0,0,2021-11-16
317506,JAKARTA TIMUR,CAKUNG,22652,2,22232,413,5,7,2021-11-16
317301,JAKARTA BARAT,CENGKARENG,28628,8,28051,558,11,19,2021-11-16
317406,JAKARTA SELATAN,CILANDAK,17679,1,17407,261,10,11,2021-11-16
317204,JAKARTA UTARA,CILINCING,17406,2,17057,340,7,9,2021-11-16
317510,JAKARTA TIMUR,CIPAYUNG,25180,4,24908,267,1,5,2021-11-16
317509,JAKARTA TIMUR,CIRACAS,22489,2,22097,379,11,13,2021-11-16
317507,JAKARTA TIMUR,DUREN SAWIT,29462,6,28840,611,5,11,2021-11-16
317101,JAKARTA PUSAT,GAMBIR,8558,3,8412,134,9,12,2021-11-16
317302,JAKARTA BARAT,GROGOL PETAMBURAN,19079,1,18774,298,6,7,2021-11-16
317409,JAKARTA SELATAN,JAGAKARSA,26582,3,26167,406,6,9,2021-11-16
317105,JAKARTA PUSAT,CEMPAKA PUTIH,10512,2,10341,167,2,4,2021-11-16
317108,JAKARTA PUSAT,JOHAR BARU,8678,0,8518,157,3,3,2021-11-16
317306,JAKARTA BARAT,KALI DERES,18011,7,17679,316,9,16,2021-11-16
317407,JAKARTA SELATAN,KEBAYORAN BARU,13869,5,13674,185,5,10,2021-11-16
317405,JAKARTA SELATAN,KEBAYORAN LAMA,20042,1,19672,362,7,8,2021-11-16
317305,JAKARTA BARAT,KEBON JERUK,22073,6,21687,374,6,12,2021-11-16
317203,JAKARTA UTARA,KOJA,17214,1,16875,337,1,2,2021-11-16
317206,JAKARTA UTARA,KELAPA GADING,12631,1,12429,192,9,10,2021-11-16
317103,JAKARTA PUSAT,KEMAYORAN,19944,6,19558,372,8,14,2021-11-16
317308,JAKARTA BARAT,KEMBANGAN,20239,6,19924,303,6,12,2021-11-16
310102,KAB.ADM.KEP.SERIBU,KEP. SERIBU SELATAN,704,0,694,10,0,0,2021-11-16
317503,JAKARTA TIMUR,JATINEGARA,19562,0,19176,383,3,3,2021-11-16
317505,JAKARTA TIMUR,PASAR REBO,17638,3,17306,326,3,6,2021-11-17
317404,JAKARTA SELATAN,PASAR MINGGU,23805,1,23369,426,9,10,2021-11-17
317408,JAKARTA SELATAN,PANCORAN,14322,1,14091,227,3,4,2021-11-17
317501,JAKARTA TIMUR,MATRAMAN,14218,2,13931,279,6,8,2021-11-17
317205,JAKARTA UTARA,PADEMANGAN,12854,4,12671,163,16,20,2021-11-17
317106,JAKARTA PUSAT,MENTENG,6433,1,6310,119,3,4,2021-11-17
317201,JAKARTA UTARA,PENJARINGAN,18628,1,18392,229,6,7,2021-11-17
317307,JAKARTA BARAT,PALMERAH,15827,3,15491,329,4,7,2021-11-17
317410,JAKARTA SELATAN,PESANGGRAHAN,16371,3,16114,252,2,5,2021-11-17
317304,JAKARTA BARAT,TAMBORA,14115,1,13853,253,8,9,2021-11-17
317102,JAKARTA PUSAT,SAWAH BESAR,9155,4,8977,172,2,6,2021-11-17
317104,JAKARTA PUSAT,SENEN,9383,3,9210,168,2,5,2021-11-17
317402,JAKARTA SELATAN,SETIA BUDI,12001,4,11808,182,7,11,2021-11-17
317303,JAKARTA BARAT,TAMAN SARI,8754,0,8613,140,1,1,2021-11-17
317107,JAKARTA PUSAT,TANAH ABANG,11034,3,10805,223,3,6,2021-11-17
317202,JAKARTA UTARA,TANJUNG PRIOK,25752,5,25316,425,6,11,2021-11-17
317401,JAKARTA SELATAN,TEBET,16948,4,16660,278,6,10,2021-11-17
111111,Luar DKI & Proses Update,Luar DKI & Proses Update,143008,137,141294,1273,304,441,2021-11-17
317403,JAKARTA SELATAN,MAMPANG PRAPATAN,11507,1,11323,179,4,5,2021-11-17
317502,JAKARTA TIMUR,PULO GADUNG,21789,3,21383,400,3,6,2021-11-17
317508,JAKARTA TIMUR,MAKASAR,17470,0,17171,296,3,3,2021-11-17
317504,JAKARTA TIMUR,KRAMAT JATI,21613,3,21205,402,3,6,2021-11-17
317203,JAKARTA UTARA,KOJA,17221,4,16879,337,1,5,2021-11-17
317506,JAKARTA TIMUR,CAKUNG,22653,3,22232,413,5,8,2021-11-17
317301,JAKARTA BARAT,CENGKARENG,28631,8,28053,558,12,20,2021-11-17
317406,JAKARTA SELATAN,CILANDAK,17685,2,17416,261,6,8,2021-11-17
317204,JAKARTA UTARA,CILINCING,17406,2,17057,340,7,9,2021-11-17
317510,JAKARTA TIMUR,CIPAYUNG,25181,5,24908,267,1,6,2021-11-17
317509,JAKARTA TIMUR,CIRACAS,22490,3,22100,379,8,11,2021-11-17
317507,JAKARTA TIMUR,DUREN SAWIT,29463,7,28841,611,4,11,2021-11-17
317101,JAKARTA PUSAT,GAMBIR,8558,3,8412,134,9,12,2021-11-17
317302,JAKARTA BARAT,GROGOL PETAMBURAN,19079,1,18774,298,6,7,2021-11-17
317409,JAKARTA SELATAN,JAGAKARSA,26584,2,26170,406,6,8,2021-11-17
317105,JAKARTA PUSAT,CEMPAKA PUTIH,10515,2,10342,168,3,5,2021-11-17
317108,JAKARTA PUSAT,JOHAR BARU,8678,0,8518,157,3,3,2021-11-17
317306,JAKARTA BARAT,KALI DERES,18012,7,17681,316,8,15,2021-11-17
317407,JAKARTA SELATAN,KEBAYORAN BARU,13869,4,13679,185,1,5,2021-11-17
317405,JAKARTA SELATAN,KEBAYORAN LAMA,20044,1,19675,362,6,7,2021-11-17
317305,JAKARTA BARAT,KEBON JERUK,22075,7,21688,374,6,13,2021-11-17
317206,JAKARTA UTARA,KELAPA GADING,12632,0,12430,192,10,10,2021-11-17
317103,JAKARTA PUSAT,KEMAYORAN,19945,7,19558,372,8,15,2021-11-17
317308,JAKARTA BARAT,KEMBANGAN,20241,4,19927,303,7,11,2021-11-17
310102,KAB.ADM.KEP.SERIBU,KEP. SERIBU SELATAN,704,0,694,10,0,0,2021-11-17
310101,KAB.ADM.KEP.SERIBU,KEP. SERIBU UTARA,640,0,634,6,0,0,2021-11-17
317503,JAKARTA TIMUR,JATINEGARA,19563,0,19178,383,2,2,2021-11-17
317505,JAKARTA TIMUR,PASAR REBO,17640,5,17306,326,3,8,2021-11-18
317404,JAKARTA SELATAN,PASAR MINGGU,23807,1,23370,426,10,11,2021-11-18
317408,JAKARTA SELATAN,PANCORAN,14322,0,14093,227,2,2,2021-11-18
317106,JAKARTA PUSAT,MENTENG,6433,1,6311,119,2,3,2021-11-18
111111,Luar DKI & Proses Update,Luar DKI & Proses Update,143008,137,141294,1273,304,441,2021-11-18
317205,JAKARTA UTARA,PADEMANGAN,12854,3,12681,163,7,10,2021-11-18
317201,JAKARTA UTARA,PENJARINGAN,18628,1,18392,229,6,7,2021-11-18
317307,JAKARTA BARAT,PALMERAH,15827,2,15492,329,4,6,2021-11-18
317410,JAKARTA SELATAN,PESANGGRAHAN,16371,3,16114,252,2,5,2021-11-18
317303,JAKARTA BARAT,TAMAN SARI,8754,0,8614,140,0,0,2021-11-18
317102,JAKARTA PUSAT,SAWAH BESAR,9155,3,8979,172,1,4,2021-11-18
317104,JAKARTA PUSAT,SENEN,9383,3,9210,168,2,5,2021-11-18
317402,JAKARTA SELATAN,SETIA BUDI,12001,4,11809,182,6,10,2021-11-18
317304,JAKARTA BARAT,TAMBORA,14116,1,13855,253,7,8,2021-11-18
317107,JAKARTA PUSAT,TANAH ABANG,11039,5,10806,223,5,10,2021-11-18
317202,JAKARTA UTARA,TANJUNG PRIOK,25753,3,25323,425,2,5,2021-11-18
317401,JAKARTA SELATAN,TEBET,16949,3,16661,278,7,10,2021-11-18
317501,JAKARTA TIMUR,MATRAMAN,14219,1,13932,279,7,8,2021-11-18
317502,JAKARTA TIMUR,PULO GADUNG,21789,3,21383,400,3,6,2021-11-18
317403,JAKARTA SELATAN,MAMPANG PRAPATAN,11507,1,11323,179,4,5,2021-11-18
317308,JAKARTA BARAT,KEMBANGAN,20242,2,19931,303,6,8,2021-11-18
317504,JAKARTA TIMUR,KRAMAT JATI,21613,3,21206,402,2,5,2021-11-18
317508,JAKARTA TIMUR,MAKASAR,17472,2,17172,296,2,4,2021-11-18
317406,JAKARTA SELATAN,CILANDAK,17686,3,17418,261,4,7,2021-11-18
317301,JAKARTA BARAT,CENGKARENG,28634,8,28055,558,13,21,2021-11-18
317506,JAKARTA TIMUR,CAKUNG,22653,3,22232,413,5,8,2021-11-18
317204,JAKARTA UTARA,CILINCING,17409,2,17058,340,9,11,2021-11-18
317510,JAKARTA TIMUR,CIPAYUNG,25182,4,24910,267,1,5,2021-11-18
317509,JAKARTA TIMUR,CIRACAS,22496,3,22106,379,8,11,2021-11-18
317507,JAKARTA TIMUR,DUREN SAWIT,29463,6,28842,611,4,10,2021-11-18
317101,JAKARTA PUSAT,GAMBIR,8558,2,8414,134,8,10,2021-11-18
317302,JAKARTA BARAT,GROGOL PETAMBURAN,19080,2,18775,298,5,7,2021-11-18
317409,JAKARTA SELATAN,JAGAKARSA,26585,2,26173,406,4,6,2021-11-18
317105,JAKARTA PUSAT,CEMPAKA PUTIH,10516,1,10345,168,2,3,2021-11-18
317108,JAKARTA PUSAT,JOHAR BARU,8678,0,8518,157,3,3,2021-11-18
317503,JAKARTA TIMUR,JATINEGARA,19565,1,19179,383,2,3,2021-11-18
317203,JAKARTA UTARA,KOJA,17221,3,16880,337,1,4,2021-11-18
310101,KAB.ADM.KEP.SERIBU,KEP. SERIBU UTARA,640,0,634,6,0,0,2021-11-18
317103,JAKARTA PUSAT,KEMAYORAN,19946,8,19564,373,1,9,2021-11-18
310102,KAB.ADM.KEP.SERIBU,KEP. SERIBU SELATAN,704,0,694,10,0,0,2021-11-18
317305,JAKARTA BARAT,KEBON JERUK,22076,6,21689,374,7,13,2021-11-18
317405,JAKARTA SELATAN,KEBAYORAN LAMA,20044,1,19675,362,6,7,2021-11-18
317407,JAKARTA SELATAN,KEBAYORAN BARU,13869,4,13679,185,1,5,2021-11-18
317306,JAKARTA BARAT,KALI DERES,18012,7,17683,316,6,13,2021-11-18
317206,JAKARTA UTARA,KELAPA GADING,12632,0,12431,192,9,9,2021-11-18
317106,JAKARTA PUSAT,MENTENG,6433,1,6311,119,2,3,2021-11-19
317205,JAKARTA UTARA,PADEMANGAN,12858,3,12681,163,11,14,2021-11-19
317201,JAKARTA UTARA,PENJARINGAN,18629,1,18394,229,5,6,2021-11-19
317307,JAKARTA BARAT,PALMERAH,15831,3,15492,329,7,10,2021-11-19
317408,JAKARTA SELATAN,PANCORAN,14323,1,14094,227,1,2,2021-11-19
317404,JAKARTA SELATAN,PASAR MINGGU,23807,0,23371,426,10,10,2021-11-19
317505,JAKARTA TIMUR,PASAR REBO,17640,5,17306,326,3,8,2021-11-19
317410,JAKARTA SELATAN,PESANGGRAHAN,16371,2,16117,252,0,2,2021-11-19
317303,JAKARTA BARAT,TAMAN SARI,8754,0,8614,140,0,0,2021-11-19
317102,JAKARTA PUSAT,SAWAH BESAR,9155,3,8979,172,1,4,2021-11-19
317104,JAKARTA PUSAT,SENEN,9383,3,9210,168,2,5,2021-11-19
317402,JAKARTA SELATAN,SETIA BUDI,12001,1,11812,183,5,6,2021-11-19
317304,JAKARTA BARAT,TAMBORA,14116,1,13857,253,5,6,2021-11-19
317107,JAKARTA PUSAT,TANAH ABANG,11040,4,10807,223,6,10,2021-11-19
317202,JAKARTA UTARA,TANJUNG PRIOK,25753,3,25323,425,2,5,2021-11-19
317401,JAKARTA SELATAN,TEBET,16949,3,16661,278,7,10,2021-11-19
317501,JAKARTA TIMUR,MATRAMAN,14219,1,13933,279,6,7,2021-11-19
111111,Luar DKI & Proses Update,Luar DKI & Proses Update,143008,137,141294,1273,304,441,2021-11-19
317502,JAKARTA TIMUR,PULO GADUNG,21789,3,21384,400,2,5,2021-11-19
317403,JAKARTA SELATAN,MAMPANG PRAPATAN,11507,0,11324,179,4,4,2021-11-19
317308,JAKARTA BARAT,KEMBANGAN,20243,3,19932,303,5,8,2021-11-19
317504,JAKARTA TIMUR,KRAMAT JATI,21625,3,21219,402,1,4,2021-11-19
317506,JAKARTA TIMUR,CAKUNG,22654,2,22233,413,6,8,2021-11-19
317105,JAKARTA PUSAT,CEMPAKA PUTIH,10517,2,10345,168,2,4,2021-11-19
317301,JAKARTA BARAT,CENGKARENG,28638,8,28055,559,16,24,2021-11-19
317406,JAKARTA SELATAN,CILANDAK,17686,3,17419,261,3,6,2021-11-19
317204,JAKARTA UTARA,CILINCING,17411,2,17058,340,11,13,2021-11-19
317510,JAKARTA TIMUR,CIPAYUNG,25185,5,24910,267,3,8,2021-11-19
317508,JAKARTA TIMUR,MAKASAR,17473,2,17173,296,2,4,2021-11-19
317507,JAKARTA TIMUR,DUREN SAWIT,29464,4,28847,611,2,6,2021-11-19
317101,JAKARTA PUSAT,GAMBIR,8558,2,8416,134,6,8,2021-11-19
317302,JAKARTA BARAT,GROGOL PETAMBURAN,19081,2,18775,298,6,8,2021-11-19
317409,JAKARTA SELATAN,JAGAKARSA,26588,2,26173,406,7,9,2021-11-19
317509,JAKARTA TIMUR,CIRACAS,22502,3,22108,379,12,15,2021-11-19
317108,JAKARTA PUSAT,JOHAR BARU,8679,1,8518,157,3,4,2021-11-19
317306,JAKARTA BARAT,KALI DERES,18016,7,17683,316,10,17,2021-11-19
317407,JAKARTA SELATAN,KEBAYORAN BARU,13872,5,13679,185,3,8,2021-11-19
317405,JAKARTA SELATAN,KEBAYORAN LAMA,20045,1,19675,362,7,8,2021-11-19
317305,JAKARTA BARAT,KEBON JERUK,22078,5,21691,374,8,13,2021-11-19
317203,JAKARTA UTARA,KOJA,17221,2,16881,337,1,3,2021-11-19
310101,KAB.ADM.KEP.SERIBU,KEP. SERIBU UTARA,640,0,634,6,0,0,2021-11-19
310102,KAB.ADM.KEP.SERIBU,KEP. SERIBU SELATAN,704,0,694,10,0,0,2021-11-19
317503,JAKARTA TIMUR,JATINEGARA,19567,2,19179,383,3,5,2021-11-19
317206,JAKARTA UTARA,KELAPA GADING,12633,1,12431,192,9,10,2021-11-19
317103,JAKARTA PUSAT,KEMAYORAN,19947,7,19565,373,2,9,2021-11-19
111111,Luar DKI & Proses Update,Luar DKI & Proses Update,143008,137,141294,1273,304,441,2021-11-20
317509,JAKARTA TIMUR,CIRACAS,22503,3,22108,379,13,16,2021-11-20
317204,JAKARTA UTARA,CILINCING,17412,2,17059,340,11,13,2021-11-20
317406,JAKARTA SELATAN,CILANDAK,17687,4,17420,261,2,6,2021-11-20
317301,JAKARTA BARAT,CENGKARENG,28644,7,28062,559,16,23,2021-11-20
317105,JAKARTA PUSAT,CEMPAKA PUTIH,10517,2,10345,168,2,4,2021-11-20
317506,JAKARTA TIMUR,CAKUNG,22654,2,22238,413,1,3,2021-11-20
317510,JAKARTA TIMUR,CIPAYUNG,25189,5,24910,267,7,12,2021-11-20
317507,JAKARTA TIMUR,DUREN SAWIT,29464,4,28847,611,2,6,2021-11-20
317101,JAKARTA PUSAT,GAMBIR,8558,1,8422,134,1,2,2021-11-20
317102,JAKARTA PUSAT,SAWAH BESAR,9155,2,8981,172,0,2,2021-11-20
317205,JAKARTA UTARA,PADEMANGAN,12870,3,12684,163,20,23,2021-11-20
317307,JAKARTA BARAT,PALMERAH,15833,3,15494,329,7,10,2021-11-20
317404,JAKARTA SELATAN,PASAR MINGGU,23808,1,23374,426,7,8,2021-11-20
317505,JAKARTA TIMUR,PASAR REBO,17641,5,17308,326,2,7,2021-11-20
317201,JAKARTA UTARA,PENJARINGAN,18630,1,18396,229,4,5,2021-11-20
317410,JAKARTA SELATAN,PESANGGRAHAN,16371,1,16118,252,0,1,2021-11-20
317106,JAKARTA PUSAT,MENTENG,6433,1,6312,119,1,2,2021-11-20
317502,JAKARTA TIMUR,PULO GADUNG,21790,2,21387,400,1,3,2021-11-20
317402,JAKARTA SELATAN,SETIA BUDI,12001,1,11813,183,4,5,2021-11-20
317303,JAKARTA BARAT,TAMAN SARI,8754,0,8614,140,0,0,2021-11-20
317304,JAKARTA BARAT,TAMBORA,14118,2,13859,253,4,6,2021-11-20
317107,JAKARTA PUSAT,TANAH ABANG,11040,4,10807,223,6,10,2021-11-20
317202,JAKARTA UTARA,TANJUNG PRIOK,25756,3,25325,425,3,6,2021-11-20
317401,JAKARTA SELATAN,TEBET,16950,3,16665,278,4,7,2021-11-20
317104,JAKARTA PUSAT,SENEN,9384,3,9211,168,2,5,2021-11-20
317501,JAKARTA TIMUR,MATRAMAN,14219,1,13937,279,2,3,2021-11-20
317408,JAKARTA SELATAN,PANCORAN,14324,2,14094,227,1,3,2021-11-20
317508,JAKARTA TIMUR,MAKASAR,17472,2,17174,296,0,2,2021-11-20
317302,JAKARTA BARAT,GROGOL PETAMBURAN,19081,2,18776,298,5,7,2021-11-20
317409,JAKARTA SELATAN,JAGAKARSA,26589,1,26176,406,6,7,2021-11-20
317503,JAKARTA TIMUR,JATINEGARA,19568,2,19179,383,4,6,2021-11-20
317108,JAKARTA PUSAT,JOHAR BARU,8679,1,8521,157,0,1,2021-11-20
317403,JAKARTA SELATAN,MAMPANG PRAPATAN,11508,0,11325,179,4,4,2021-11-20
317407,JAKARTA SELATAN,KEBAYORAN BARU,13872,5,13679,185,3,8,2021-11-20
317405,JAKARTA SELATAN,KEBAYORAN LAMA,20046,1,19679,362,4,5,2021-11-20
317305,JAKARTA BARAT,KEBON JERUK,22080,7,21693,374,6,13,2021-11-20
317306,JAKARTA BARAT,KALI DERES,18019,7,17690,316,6,13,2021-11-20
317103,JAKARTA PUSAT,KEMAYORAN,19949,7,19565,373,4,11,2021-11-20
317308,JAKARTA BARAT,KEMBANGAN,20245,2,19934,303,6,8,2021-11-20
310102,KAB.ADM.KEP.SERIBU,KEP. SERIBU SELATAN,704,0,694,10,0,0,2021-11-20
310101,KAB.ADM.KEP.SERIBU,KEP. SERIBU UTARA,640,0,634,6,0,0,2021-11-20
317203,JAKARTA UTARA,KOJA,17224,2,16882,337,3,5,2021-11-20
317504,JAKARTA TIMUR,KRAMAT JATI,21614,3,21208,402,1,4,2021-11-20
317206,JAKARTA UTARA,KELAPA GADING,12635,1,12435,192,7,8,2021-11-20
317508,JAKARTA TIMUR,MAKASAR,17473,2,17174,296,1,3,2021-11-21
317404,JAKARTA SELATAN,PASAR MINGGU,23809,1,23374,426,8,9,2021-11-21
317408,JAKARTA SELATAN,PANCORAN,14326,3,14095,227,1,4,2021-11-21
317307,JAKARTA BARAT,PALMERAH,15833,3,15494,329,7,10,2021-11-21
317403,JAKARTA SELATAN,MAMPANG PRAPATAN,11508,0,11325,179,4,4,2021-11-21
317106,JAKARTA PUSAT,MENTENG,6433,1,6312,119,1,2,2021-11-21
317501,JAKARTA TIMUR,MATRAMAN,14221,1,13937,279,4,5,2021-11-21
317505,JAKARTA TIMUR,PASAR REBO,17641,5,17309,326,1,6,2021-11-21
317205,JAKARTA UTARA,PADEMANGAN,12871,3,12684,163,21,24,2021-11-21
317201,JAKARTA UTARA,PENJARINGAN,18630,1,18397,229,3,4,2021-11-21
317102,JAKARTA PUSAT,SAWAH BESAR,9155,2,8981,172,0,2,2021-11-21
317502,JAKARTA TIMUR,PULO GADUNG,21790,2,21387,400,1,3,2021-11-21
317104,JAKARTA PUSAT,SENEN,9385,2,9212,168,3,5,2021-11-21
317402,JAKARTA SELATAN,SETIA BUDI,12002,1,11814,183,4,5,2021-11-21
317303,JAKARTA BARAT,TAMAN SARI,8754,0,8614,140,0,0,2021-11-21
317304,JAKARTA BARAT,TAMBORA,14118,2,13859,253,4,6,2021-11-21
317107,JAKARTA PUSAT,TANAH ABANG,11042,4,10808,223,7,11,2021-11-21
317202,JAKARTA UTARA,TANJUNG PRIOK,25757,4,25325,425,3,7,2021-11-21
317401,JAKARTA SELATAN,TEBET,16950,3,16666,278,3,6,2021-11-21
111111,Luar DKI & Proses Update,Luar DKI & Proses Update,143008,137,141294,1273,304,441,2021-11-21
317504,JAKARTA TIMUR,KRAMAT JATI,21614,2,21210,402,0,2,2021-11-21
317410,JAKARTA SELATAN,PESANGGRAHAN,16371,1,16118,252,0,1,2021-11-21
317203,JAKARTA UTARA,KOJA,17225,2,16882,337,4,6,2021-11-21
317407,JAKARTA SELATAN,KEBAYORAN BARU,13872,4,13680,185,3,7,2021-11-21
310102,KAB.ADM.KEP.SERIBU,KEP. SERIBU SELATAN,704,0,694,10,0,0,2021-11-21
317506,JAKARTA TIMUR,CAKUNG,22654,2,22238,413,1,3,2021-11-21
310101,KAB.ADM.KEP.SERIBU,KEP. SERIBU UTARA,640,0,634,6,0,0,2021-11-21
317105,JAKARTA PUSAT,CEMPAKA PUTIH,10517,2,10345,168,2,4,2021-11-21
317301,JAKARTA BARAT,CENGKARENG,28646,6,28063,559,18,24,2021-11-21
317406,JAKARTA SELATAN,CILANDAK,17681,4,17414,261,2,6,2021-11-21
317204,JAKARTA UTARA,CILINCING,17412,2,17060,340,10,12,2021-11-21
317510,JAKARTA TIMUR,CIPAYUNG,25190,6,24910,267,7,13,2021-11-21
317507,JAKARTA TIMUR,DUREN SAWIT,29465,3,28849,611,2,5,2021-11-21
317101,JAKARTA PUSAT,GAMBIR,8559,1,8423,134,1,2,2021-11-21
317302,JAKARTA BARAT,GROGOL PETAMBURAN,19082,1,18779,298,4,5,2021-11-21
317509,JAKARTA TIMUR,CIRACAS,22504,2,22109,379,14,16,2021-11-21
317503,JAKARTA TIMUR,JATINEGARA,19567,2,19178,383,4,6,2021-11-21
317308,JAKARTA BARAT,KEMBANGAN,20245,2,19934,303,6,8,2021-11-21
317409,JAKARTA SELATAN,JAGAKARSA,26586,1,26172,406,7,8,2021-11-21
317206,JAKARTA UTARA,KELAPA GADING,12636,2,12437,192,5,7,2021-11-21
317305,JAKARTA BARAT,KEBON JERUK,22081,6,21695,374,6,12,2021-11-21
317405,JAKARTA SELATAN,KEBAYORAN LAMA,20046,1,19680,362,3,4,2021-11-21
317103,JAKARTA PUSAT,KEMAYORAN,19951,7,19566,373,5,12,2021-11-21
317306,JAKARTA BARAT,KALI DERES,18019,7,17690,316,6,13,2021-11-21
317108,JAKARTA PUSAT,JOHAR BARU,8681,2,8521,157,1,3,2021-11-21
317505,JAKARTA TIMUR,PASAR REBO,17641,4,17311,326,0,4,2021-11-22
317403,JAKARTA SELATAN,MAMPANG PRAPATAN,11508,0,11325,179,4,4,2021-11-22
317501,JAKARTA TIMUR,MATRAMAN,14221,1,13937,279,4,5,2021-11-22
317106,JAKARTA PUSAT,MENTENG,6433,0,6313,119,1,1,2021-11-22
317205,JAKARTA UTARA,PADEMANGAN,12871,3,12687,163,18,21,2021-11-22
317307,JAKARTA BARAT,PALMERAH,15833,3,15494,329,7,10,2021-11-22
317408,JAKARTA SELATAN,PANCORAN,14326,3,14095,227,1,4,2021-11-22
317404,JAKARTA SELATAN,PASAR MINGGU,23810,1,23376,426,7,8,2021-11-22
317508,JAKARTA TIMUR,MAKASAR,17473,2,17174,296,1,3,2021-11-22
317201,JAKARTA UTARA,PENJARINGAN,18630,1,18397,229,3,4,2021-11-22
317401,JAKARTA SELATAN,TEBET,16950,2,16668,278,2,4,2021-11-22
317502,JAKARTA TIMUR,PULO GADUNG,21790,2,21387,400,1,3,2021-11-22
317102,JAKARTA PUSAT,SAWAH BESAR,9155,1,8982,172,0,1,2021-11-22
317104,JAKARTA PUSAT,SENEN,9385,2,9212,168,3,5,2021-11-22
317402,JAKARTA SELATAN,SETIA BUDI,12002,1,11815,183,3,4,2021-11-22
317303,JAKARTA BARAT,TAMAN SARI,8754,0,8614,140,0,0,2021-11-22
317304,JAKARTA BARAT,TAMBORA,14119,2,13860,253,4,6,2021-11-22
317107,JAKARTA PUSAT,TANAH ABANG,11042,4,10808,223,7,11,2021-11-22
111111,Luar DKI & Proses Update,Luar DKI & Proses Update,143008,137,141294,1273,304,441,2021-11-22
317504,JAKARTA TIMUR,KRAMAT JATI,21614,1,21211,402,0,1,2021-11-22
317410,JAKARTA SELATAN,PESANGGRAHAN,16371,1,16118,252,0,1,2021-11-22
317203,JAKARTA UTARA,KOJA,17225,2,16882,337,4,6,2021-11-22
317202,JAKARTA UTARA,TANJUNG PRIOK,25757,4,25325,425,3,7,2021-11-22
310102,KAB.ADM.KEP.SERIBU,KEP. SERIBU SELATAN,704,0,694,10,0,0,2021-11-22
310101,KAB.ADM.KEP.SERIBU,KEP. SERIBU UTARA,640,0,634,6,0,0,2021-11-22
317506,JAKARTA TIMUR,CAKUNG,22654,2,22238,413,1,3,2021-11-22
317105,JAKARTA PUSAT,CEMPAKA PUTIH,10517,2,10345,168,2,4,2021-11-22
317301,JAKARTA BARAT,CENGKARENG,28646,6,28064,559,17,23,2021-11-22
317406,JAKARTA SELATAN,CILANDAK,17687,3,17421,261,2,5,2021-11-22
317204,JAKARTA UTARA,CILINCING,17412,1,17062,340,9,10,2021-11-22
317509,JAKARTA TIMUR,CIRACAS,22504,1,22110,379,14,15,2021-11-22
317507,JAKARTA TIMUR,DUREN SAWIT,29465,3,28851,611,0,3,2021-11-22
317101,JAKARTA PUSAT,GAMBIR,8560,2,8423,134,1,3,2021-11-22
317302,JAKARTA BARAT,GROGOL PETAMBURAN,19082,1,18781,298,2,3,2021-11-22
317510,JAKARTA TIMUR,CIPAYUNG,25190,5,24911,267,7,12,2021-11-22
317503,JAKARTA TIMUR,JATINEGARA,19568,2,19179,383,4,6,2021-11-22
317409,JAKARTA SELATAN,JAGAKARSA,26590,1,26176,406,7,8,2021-11-22
317103,JAKARTA PUSAT,KEMAYORAN,19952,8,19566,373,5,13,2021-11-22
317206,JAKARTA UTARA,KELAPA GADING,12636,2,12438,192,4,6,2021-11-22
317305,JAKARTA BARAT,KEBON JERUK,22082,7,21696,374,5,12,2021-11-22
317308,JAKARTA BARAT,KEMBANGAN,20245,2,19934,303,6,8,2021-11-22
317407,JAKARTA SELATAN,KEBAYORAN BARU,13874,1,13684,185,4,5,2021-11-22
317306,JAKARTA BARAT,KALI DERES,18020,5,17693,316,6,11,2021-11-22
317108,JAKARTA PUSAT,JOHAR BARU,8681,2,8521,157,1,3,2021-11-22
317405,JAKARTA SELATAN,KEBAYORAN LAMA,20046,1,19681,362,2,3,2021-11-22
317201,JAKARTA UTARA,PENJARINGAN,18632,2,18397,229,4,6,2021-11-23
317403,JAKARTA SELATAN,MAMPANG PRAPATAN,11508,0,11325,179,4,4,2021-11-23
317501,JAKARTA TIMUR,MATRAMAN,14221,0,13938,279,4,4,2021-11-23
317106,JAKARTA PUSAT,MENTENG,6433,0,6313,119,1,1,2021-11-23
317307,JAKARTA BARAT,PALMERAH,15833,3,15494,329,7,10,2021-11-23
317408,JAKARTA SELATAN,PANCORAN,14326,3,14095,227,1,4,2021-11-23
317404,JAKARTA SELATAN,PASAR MINGGU,23812,1,23376,426,9,10,2021-11-23
317505,JAKARTA TIMUR,PASAR REBO,17641,4,17311,326,0,4,2021-11-23
317410,JAKARTA SELATAN,PESANGGRAHAN,16372,2,16118,252,0,2,2021-11-23
317508,JAKARTA TIMUR,MAKASAR,17474,2,17175,296,1,3,2021-11-23
317102,JAKARTA PUSAT,SAWAH BESAR,9155,1,8982,172,0,1,2021-11-23
317104,JAKARTA PUSAT,SENEN,9385,1,9213,168,3,4,2021-11-23
317402,JAKARTA SELATAN,SETIA BUDI,12002,1,11815,183,3,4,2021-11-23
317303,JAKARTA BARAT,TAMAN SARI,8754,0,8614,140,0,0,2021-11-23
317304,JAKARTA BARAT,TAMBORA,14119,2,13860,253,4,6,2021-11-23
317107,JAKARTA PUSAT,TANAH ABANG,11042,3,10809,223,7,10,2021-11-23
317202,JAKARTA UTARA,TANJUNG PRIOK,25760,3,25328,425,4,7,2021-11-23
317401,JAKARTA SELATAN,TEBET,16951,2,16669,278,2,4,2021-11-23
111111,Luar DKI & Proses Update,Luar DKI & Proses Update,143008,137,141294,1273,304,441,2021-11-23
317502,JAKARTA TIMUR,PULO GADUNG,21791,3,21387,400,1,4,2021-11-23
317504,JAKARTA TIMUR,KRAMAT JATI,21627,2,21223,402,0,2,2021-11-23
317205,JAKARTA UTARA,PADEMANGAN,12874,3,12689,163,19,22,2021-11-23
310101,KAB.ADM.KEP.SERIBU,KEP. SERIBU UTARA,640,0,634,6,0,0,2021-11-23
317506,JAKARTA TIMUR,CAKUNG,22654,1,22239,413,1,2,2021-11-23
317203,JAKARTA UTARA,KOJA,17226,3,16882,337,4,7,2021-11-23
317301,JAKARTA BARAT,CENGKARENG,28646,5,28065,559,17,22,2021-11-23
317406,JAKARTA SELATAN,CILANDAK,17690,3,17422,261,4,7,2021-11-23
317204,JAKARTA UTARA,CILINCING,17415,0,17067,340,8,8,2021-11-23
317510,JAKARTA TIMUR,CIPAYUNG,25191,5,24912,267,7,12,2021-11-23
317509,JAKARTA TIMUR,CIRACAS,22506,1,22111,379,15,16,2021-11-23
317105,JAKARTA PUSAT,CEMPAKA PUTIH,10518,3,10345,168,2,5,2021-11-23
317101,JAKARTA PUSAT,GAMBIR,8561,2,8424,134,1,3,2021-11-23
317302,JAKARTA BARAT,GROGOL PETAMBURAN,19082,1,18781,298,2,3,2021-11-23
317409,JAKARTA SELATAN,JAGAKARSA,26591,1,26178,406,6,7,2021-11-23
317507,JAKARTA TIMUR,DUREN SAWIT,29465,3,28851,611,0,3,2021-11-23
317108,JAKARTA PUSAT,JOHAR BARU,8681,2,8521,157,1,3,2021-11-23
310102,KAB.ADM.KEP.SERIBU,KEP. SERIBU SELATAN,704,0,694,10,0,0,2021-11-23
317503,JAKARTA TIMUR,JATINEGARA,19569,2,19180,383,4,6,2021-11-23
317103,JAKARTA PUSAT,KEMAYORAN,19952,6,19569,373,4,10,2021-11-23
317206,JAKARTA UTARA,KELAPA GADING,12636,2,12438,192,4,6,2021-11-23
317308,JAKARTA BARAT,KEMBANGAN,20246,3,19935,303,5,8,2021-11-23
317305,JAKARTA BARAT,KEBON JERUK,22082,6,21697,374,5,11,2021-11-23
317405,JAKARTA SELATAN,KEBAYORAN LAMA,20046,1,19681,362,2,3,2021-11-23
317407,JAKARTA SELATAN,KEBAYORAN BARU,13876,2,13684,185,5,7,2021-11-23
317306,JAKARTA BARAT,KALI DERES,18020,3,17695,316,6,9,2021-11-23
317501,JAKARTA TIMUR,MATRAMAN,14224,2,13938,279,5,7,2021-11-24
317205,JAKARTA UTARA,PADEMANGAN,12878,2,12690,163,23,25,2021-11-24
317307,JAKARTA BARAT,PALMERAH,15833,2,15497,329,5,7,2021-11-24
317408,JAKARTA SELATAN,PANCORAN,14326,3,14095,227,1,4,2021-11-24
317404,JAKARTA SELATAN,PASAR MINGGU,23813,2,23376,426,9,11,2021-11-24
317505,JAKARTA TIMUR,PASAR REBO,17641,4,17311,326,0,4,2021-11-24
317201,JAKARTA UTARA,PENJARINGAN,18632,2,18399,229,2,4,2021-11-24
317403,JAKARTA SELATAN,MAMPANG PRAPATAN,11509,0,11325,179,5,5,2021-11-24
317410,JAKARTA SELATAN,PESANGGRAHAN,16376,6,16118,252,0,6,2021-11-24
317202,JAKARTA UTARA,TANJUNG PRIOK,25764,4,25328,425,7,11,2021-11-24
317502,JAKARTA TIMUR,PULO GADUNG,21795,5,21387,400,3,8,2021-11-24
317102,JAKARTA PUSAT,SAWAH BESAR,9156,1,8983,172,0,1,2021-11-24
317104,JAKARTA PUSAT,SENEN,9386,1,9214,168,3,4,2021-11-24
317402,JAKARTA SELATAN,SETIA BUDI,12002,0,11816,183,3,3,2021-11-24
317303,JAKARTA BARAT,TAMAN SARI,8754,0,8614,140,0,0,2021-11-24
317304,JAKARTA BARAT,TAMBORA,14121,3,13861,253,4,7,2021-11-24
317107,JAKARTA PUSAT,TANAH ABANG,11042,3,10810,223,6,9,2021-11-24
317508,JAKARTA TIMUR,MAKASAR,17474,2,17175,296,1,3,2021-11-24
317401,JAKARTA SELATAN,TEBET,16951,1,16669,279,2,3,2021-11-24
111111,Luar DKI & Proses Update,Luar DKI & Proses Update,143008,137,141294,1273,304,441,2021-11-24
317504,JAKARTA TIMUR,KRAMAT JATI,21627,1,21224,402,0,1,2021-11-24
317106,JAKARTA PUSAT,MENTENG,6433,0,6313,119,1,1,2021-11-24
310101,KAB.ADM.KEP.SERIBU,KEP. SERIBU UTARA,640,0,634,6,0,0,2021-11-24
317203,JAKARTA UTARA,KOJA,17228,4,16882,337,5,9,2021-11-24
317506,JAKARTA TIMUR,CAKUNG,22656,3,22239,413,1,4,2021-11-24
317105,JAKARTA PUSAT,CEMPAKA PUTIH,10520,3,10346,168,3,6,2021-11-24
317301,JAKARTA BARAT,CENGKARENG,28661,6,28065,559,31,37,2021-11-24
317406,JAKARTA SELATAN,CILANDAK,17691,4,17422,261,4,8,2021-11-24
317204,JAKARTA UTARA,CILINCING,17423,0,17067,340,16,16,2021-11-24
317510,JAKARTA TIMUR,CIPAYUNG,25192,6,24912,267,7,13,2021-11-24
317507,JAKARTA TIMUR,DUREN SAWIT,29466,3,28851,611,1,4,2021-11-24
317101,JAKARTA PUSAT,GAMBIR,8563,3,8424,134,2,5,2021-11-24
317302,JAKARTA BARAT,GROGOL PETAMBURAN,19082,1,18781,298,2,3,2021-11-24
317409,JAKARTA SELATAN,JAGAKARSA,26592,1,26178,406,7,8,2021-11-24
317509,JAKARTA TIMUR,CIRACAS,22506,1,22111,379,15,16,2021-11-24
317308,JAKARTA BARAT,KEMBANGAN,20246,3,19935,303,5,8,2021-11-24
317503,JAKARTA TIMUR,JATINEGARA,19569,2,19180,383,4,6,2021-11-24
317108,JAKARTA PUSAT,JOHAR BARU,8681,2,8521,157,1,3,2021-11-24
317306,JAKARTA BARAT,KALI DERES,18021,2,17696,316,7,9,2021-11-24
317407,JAKARTA SELATAN,KEBAYORAN BARU,13877,2,13684,185,6,8,2021-11-24
317405,JAKARTA SELATAN,KEBAYORAN LAMA,20046,0,19682,362,2,2,2021-11-24
317305,JAKARTA BARAT,KEBON JERUK,22083,5,21700,374,4,9,2021-11-24
317206,JAKARTA UTARA,KELAPA GADING,12640,5,12439,192,4,9,2021-11-24
317103,JAKARTA PUSAT,KEMAYORAN,19955,4,19572,373,6,10,2021-11-24
310102,KAB.ADM.KEP.SERIBU,KEP. SERIBU SELATAN,704,0,694,10,0,0,2021-11-24
317404,JAKARTA SELATAN,PASAR MINGGU,23815,2,23377,426,10,12,2021-11-25
317505,JAKARTA TIMUR,PASAR REBO,17641,3,17312,326,0,3,2021-11-25
317201,JAKARTA UTARA,PENJARINGAN,18632,2,18399,229,2,4,2021-11-25
317410,JAKARTA SELATAN,PESANGGRAHAN,16376,5,16119,252,0,5,2021-11-25
317502,JAKARTA TIMUR,PULO GADUNG,21796,5,21387,400,4,9,2021-11-25
317102,JAKARTA PUSAT,SAWAH BESAR,9156,1,8983,172,0,1,2021-11-25
317202,JAKARTA UTARA,TANJUNG PRIOK,25765,4,25330,425,6,10,2021-11-25
317402,JAKARTA SELATAN,SETIA BUDI,12002,0,11818,183,1,1,2021-11-25
317303,JAKARTA BARAT,TAMAN SARI,8755,1,8614,140,0,1,2021-11-25
317107,JAKARTA PUSAT,TANAH ABANG,11043,4,10811,223,5,9,2021-11-25
317408,JAKARTA SELATAN,PANCORAN,14326,3,14095,227,1,4,2021-11-25
317304,JAKARTA BARAT,TAMBORA,14121,3,13861,253,4,7,2021-11-25
317104,JAKARTA PUSAT,SENEN,9386,1,9215,168,2,3,2021-11-25
317307,JAKARTA BARAT,PALMERAH,15834,1,15498,329,6,7,2021-11-25
317103,JAKARTA PUSAT,KEMAYORAN,19955,4,19572,373,6,10,2021-11-25
317106,JAKARTA PUSAT,MENTENG,6433,0,6314,119,0,0,2021-11-25
317501,JAKARTA TIMUR,MATRAMAN,14224,2,13939,279,4,6,2021-11-25
317403,JAKARTA SELATAN,MAMPANG PRAPATAN,11509,0,11326,179,4,4,2021-11-25
317508,JAKARTA TIMUR,MAKASAR,17474,2,17175,296,1,3,2021-11-25
317504,JAKARTA TIMUR,KRAMAT JATI,21627,1,21224,402,0,1,2021-11-25
317203,JAKARTA UTARA,KOJA,17229,2,16884,338,5,7,2021-11-25
310101,KAB.ADM.KEP.SERIBU,KEP. SERIBU UTARA,640,0,634,6,0,0,2021-11-25
310102,KAB.ADM.KEP.SERIBU,KEP. SERIBU SELATAN,704,0,694,10,0,0,2021-11-25
317308,JAKARTA BARAT,KEMBANGAN,20246,3,19937,303,3,6,2021-11-25
317405,JAKARTA SELATAN,KEBAYORAN LAMA,20046,0,19682,362,2,2,2021-11-25
317401,JAKARTA SELATAN,TEBET,16952,1,16670,279,2,3,2021-11-25
317206,JAKARTA UTARA,KELAPA GADING,12641,6,12440,192,3,9,2021-11-25
317305,JAKARTA BARAT,KEBON JERUK,22085,7,21700,374,4,11,2021-11-25
317205,JAKARTA UTARA,PADEMANGAN,12880,1,12691,163,25,26,2021-11-25
317108,JAKARTA PUSAT,JOHAR BARU,8681,2,8521,157,1,3,2021-11-25
317306,JAKARTA BARAT,KALI DERES,18022,2,17696,316,8,10,2021-11-25
317409,JAKARTA SELATAN,JAGAKARSA,26595,1,26178,406,10,11,2021-11-25
317503,JAKARTA TIMUR,JATINEGARA,19570,2,19180,383,5,7,2021-11-25
317302,JAKARTA BARAT,GROGOL PETAMBURAN,19082,1,18781,298,2,3,2021-11-25
317101,JAKARTA PUSAT,GAMBIR,8564,3,8424,134,3,6,2021-11-25
317507,JAKARTA TIMUR,DUREN SAWIT,29468,3,28851,611,3,6,2021-11-25
317509,JAKARTA TIMUR,CIRACAS,22508,2,22113,379,14,16,2021-11-25
317204,JAKARTA UTARA,CILINCING,17424,0,17067,340,17,17,2021-11-25
317510,JAKARTA TIMUR,CIPAYUNG,25193,5,24913,267,8,13,2021-11-25
317301,JAKARTA BARAT,CENGKARENG,28665,4,28072,559,30,34,2021-11-25
317105,JAKARTA PUSAT,CEMPAKA PUTIH,10521,4,10346,168,3,7,2021-11-25
317506,JAKARTA TIMUR,CAKUNG,22656,2,22240,413,1,3,2021-11-25
111111,Luar DKI & Proses Update,Luar DKI & Proses Update,143008,137,141294,1273,304,441,2021-11-25
317407,JAKARTA SELATAN,KEBAYORAN BARU,13877,2,13684,185,6,8,2021-11-25
317406,JAKARTA SELATAN,CILANDAK,17693,4,17423,261,5,9,2021-11-25
317104,JAKARTA PUSAT,SENEN,9386,1,9215,168,2,3,2021-11-26
317201,JAKARTA UTARA,PENJARINGAN,18632,1,18400,229,2,3,2021-11-26
317410,JAKARTA SELATAN,PESANGGRAHAN,16376,5,16119,252,0,5,2021-11-26
317502,JAKARTA TIMUR,PULO GADUNG,21798,6,21389,400,3,9,2021-11-26
317102,JAKARTA PUSAT,SAWAH BESAR,9156,1,8983,172,0,1,2021-11-26
317402,JAKARTA SELATAN,SETIA BUDI,12002,0,11818,183,1,1,2021-11-26
317106,JAKARTA PUSAT,MENTENG,6433,0,6314,119,0,0,2021-11-26
317304,JAKARTA BARAT,TAMBORA,14122,2,13862,253,5,7,2021-11-26
317107,JAKARTA PUSAT,TANAH ABANG,11043,1,10817,223,2,3,2021-11-26
317202,JAKARTA UTARA,TANJUNG PRIOK,25767,5,25330,425,7,12,2021-11-26
317401,JAKARTA SELATAN,TEBET,16953,0,16671,279,3,3,2021-11-26
317505,JAKARTA TIMUR,PASAR REBO,17642,4,17312,326,0,4,2021-11-26
111111,Luar DKI & Proses Update,Luar DKI & Proses Update,143008,137,141294,1273,304,441,2021-11-26
317303,JAKARTA BARAT,TAMAN SARI,8755,1,8614,140,0,1,2021-11-26
317205,JAKARTA UTARA,PADEMANGAN,12884,1,12691,163,29,30,2021-11-26
317404,JAKARTA SELATAN,PASAR MINGGU,23819,2,23380,426,11,13,2021-11-26
317506,JAKARTA TIMUR,CAKUNG,22656,2,22240,413,1,3,2021-11-26
317501,JAKARTA TIMUR,MATRAMAN,14224,2,13940,279,3,5,2021-11-26
317403,JAKARTA SELATAN,MAMPANG PRAPATAN,11511,0,11328,179,4,4,2021-11-26
317508,JAKARTA TIMUR,MAKASAR,17474,2,17175,296,1,3,2021-11-26
317504,JAKARTA TIMUR,KRAMAT JATI,21628,1,21224,402,1,2,2021-11-26
317203,JAKARTA UTARA,KOJA,17230,2,16884,338,6,8,2021-11-26
310101,KAB.ADM.KEP.SERIBU,KEP. SERIBU UTARA,640,0,634,6,0,0,2021-11-26
310102,KAB.ADM.KEP.SERIBU,KEP. SERIBU SELATAN,704,0,694,10,0,0,2021-11-26
317308,JAKARTA BARAT,KEMBANGAN,20246,2,19939,303,2,4,2021-11-26
317103,JAKARTA PUSAT,KEMAYORAN,19955,3,19573,373,6,9,2021-11-26
317206,JAKARTA UTARA,KELAPA GADING,12642,6,12441,192,3,9,2021-11-26
317305,JAKARTA BARAT,KEBON JERUK,22086,7,21702,374,3,10,2021-11-26
317405,JAKARTA SELATAN,KEBAYORAN LAMA,20047,1,19682,362,2,3,2021-11-26
317408,JAKARTA SELATAN,PANCORAN,14328,3,14095,227,3,6,2021-11-26
317407,JAKARTA SELATAN,KEBAYORAN BARU,13878,2,13684,185,7,9,2021-11-26
317108,JAKARTA PUSAT,JOHAR BARU,8681,2,8521,157,1,3,2021-11-26
317503,JAKARTA TIMUR,JATINEGARA,19571,1,19182,383,5,6,2021-11-26
317409,JAKARTA SELATAN,JAGAKARSA,26596,0,26180,406,10,10,2021-11-26
317302,JAKARTA BARAT,GROGOL PETAMBURAN,19082,0,18782,298,2,2,2021-11-26
317307,JAKARTA BARAT,PALMERAH,15834,1,15498,329,6,7,2021-11-26
317507,JAKARTA TIMUR,DUREN SAWIT,29469,2,28852,611,4,6,2021-11-26
317509,JAKARTA TIMUR,CIRACAS,22509,1,22124,379,5,6,2021-11-26
317510,JAKARTA TIMUR,CIPAYUNG,25193,4,24916,267,6,10,2021-11-26
317204,JAKARTA UTARA,CILINCING,17425,0,17070,340,15,15,2021-11-26
317406,JAKARTA SELATAN,CILANDAK,17693,2,17425,261,5,7,2021-11-26
317301,JAKARTA BARAT,CENGKARENG,28671,3,28075,559,34,37,2021-11-26
317105,JAKARTA PUSAT,CEMPAKA PUTIH,10521,4,10347,168,2,6,2021-11-26
317306,JAKARTA BARAT,KALI DERES,18022,2,17696,316,8,10,2021-11-26
317101,JAKARTA PUSAT,GAMBIR,8564,3,8424,134,3,6,2021-11-26
317504,JAKARTA TIMUR,KRAMAT JATI,21629,2,21224,402,1,3,2021-11-27
317506,JAKARTA TIMUR,CAKUNG,22657,3,22241,413,0,3,2021-11-27
317403,JAKARTA SELATAN,MAMPANG PRAPATAN,11511,0,11328,179,4,4,2021-11-27
317501,JAKARTA TIMUR,MATRAMAN,14224,2,13940,279,3,5,2021-11-27
317106,JAKARTA PUSAT,MENTENG,6433,0,6314,119,0,0,2021-11-27
317205,JAKARTA UTARA,PADEMANGAN,12884,1,12705,163,15,16,2021-11-27
317307,JAKARTA BARAT,PALMERAH,15834,1,15502,329,2,3,2021-11-27
317408,JAKARTA SELATAN,PANCORAN,14328,3,14095,227,3,6,2021-11-27
317404,JAKARTA SELATAN,PASAR MINGGU,23821,3,23382,426,10,13,2021-11-27
317505,JAKARTA TIMUR,PASAR REBO,17642,2,17314,326,0,2,2021-11-27
317410,JAKARTA SELATAN,PESANGGRAHAN,16376,5,16119,252,0,5,2021-11-27
317502,JAKARTA TIMUR,PULO GADUNG,21799,7,21389,400,3,10,2021-11-27
317102,JAKARTA PUSAT,SAWAH BESAR,9156,1,8983,172,0,1,2021-11-27
317104,JAKARTA PUSAT,SENEN,9387,2,9216,168,1,3,2021-11-27
317402,JAKARTA SELATAN,SETIA BUDI,12002,0,11818,183,1,1,2021-11-27
317303,JAKARTA BARAT,TAMAN SARI,8755,1,8614,140,0,1,2021-11-27
317304,JAKARTA BARAT,TAMBORA,14123,2,13863,253,5,7,2021-11-27
317107,JAKARTA PUSAT,TANAH ABANG,11043,1,10818,223,1,2,2021-11-27
317202,JAKARTA UTARA,TANJUNG PRIOK,25768,4,25334,425,5,9,2021-11-27
317401,JAKARTA SELATAN,TEBET,16953,0,16671,279,3,3,2021-11-27
317203,JAKARTA UTARA,KOJA,17230,2,16886,338,4,6,2021-11-27
317508,JAKARTA TIMUR,MAKASAR,17475,1,17177,296,1,2,2021-11-27
310101,KAB.ADM.KEP.SERIBU,KEP. SERIBU UTARA,640,0,634,6,0,0,2021-11-27
317201,JAKARTA UTARA,PENJARINGAN,18632,1,18400,229,2,3,2021-11-27
310102,KAB.ADM.KEP.SERIBU,KEP. SERIBU SELATAN,704,0,694,10,0,0,2021-11-27
111111,Luar DKI & Proses Update,Luar DKI & Proses Update,143008,137,141294,1273,304,441,2021-11-27
317301,JAKARTA BARAT,CENGKARENG,28672,4,28078,559,31,35,2021-11-27
317406,JAKARTA SELATAN,CILANDAK,17694,1,17426,261,6,7,2021-11-27
317204,JAKARTA UTARA,CILINCING,17425,0,17074,340,11,11,2021-11-27
317510,JAKARTA TIMUR,CIPAYUNG,25193,4,24917,267,5,9,2021-11-27
317509,JAKARTA TIMUR,CIRACAS,22510,1,22124,379,6,7,2021-11-27
317507,JAKARTA TIMUR,DUREN SAWIT,29470,1,28853,611,5,6,2021-11-27
317101,JAKARTA PUSAT,GAMBIR,8564,3,8424,134,3,6,2021-11-27
317302,JAKARTA BARAT,GROGOL PETAMBURAN,19082,0,18783,298,1,1,2021-11-27
317409,JAKARTA SELATAN,JAGAKARSA,26597,0,26182,406,9,9,2021-11-27
317105,JAKARTA PUSAT,CEMPAKA PUTIH,10521,4,10348,168,1,5,2021-11-27
317108,JAKARTA PUSAT,JOHAR BARU,8682,1,8522,157,2,3,2021-11-27
317306,JAKARTA BARAT,KALI DERES,18023,2,17700,316,5,7,2021-11-27
317407,JAKARTA SELATAN,KEBAYORAN BARU,13883,2,13687,185,9,11,2021-11-27
317405,JAKARTA SELATAN,KEBAYORAN LAMA,20047,1,19683,362,1,2,2021-11-27
317305,JAKARTA BARAT,KEBON JERUK,22089,8,21704,374,3,11,2021-11-27
317206,JAKARTA UTARA,KELAPA GADING,12644,8,12441,192,3,11,2021-11-27
317103,JAKARTA PUSAT,KEMAYORAN,19957,2,19576,373,6,8,2021-11-27
317308,JAKARTA BARAT,KEMBANGAN,20246,1,19940,303,2,3,2021-11-27
317503,JAKARTA TIMUR,JATINEGARA,19573,2,19183,383,5,7,2021-11-27
317508,JAKARTA TIMUR,MAKASAR,17475,1,17177,296,1,2,2021-11-28
317404,JAKARTA SELATAN,PASAR MINGGU,23824,3,23382,426,13,16,2021-11-28
317408,JAKARTA SELATAN,PANCORAN,14328,2,14096,227,3,5,2021-11-28
317307,JAKARTA BARAT,PALMERAH,15834,0,15503,329,2,2,2021-11-28
317403,JAKARTA SELATAN,MAMPANG PRAPATAN,11511,0,11328,179,4,4,2021-11-28
317106,JAKARTA PUSAT,MENTENG,6433,0,6314,119,0,0,2021-11-28
317501,JAKARTA TIMUR,MATRAMAN,14225,2,13940,279,4,6,2021-11-28
317505,JAKARTA TIMUR,PASAR REBO,17642,2,17314,326,0,2,2021-11-28
317205,JAKARTA UTARA,PADEMANGAN,12885,1,12707,163,14,15,2021-11-28
317201,JAKARTA UTARA,PENJARINGAN,18632,1,18401,229,1,2,2021-11-28
317402,JAKARTA SELATAN,SETIA BUDI,12002,0,11818,183,1,1,2021-11-28
317502,JAKARTA TIMUR,PULO GADUNG,21799,6,21390,400,3,9,2021-11-28
317102,JAKARTA PUSAT,SAWAH BESAR,9156,1,8983,172,0,1,2021-11-28
317104,JAKARTA PUSAT,SENEN,9387,2,9216,168,1,3,2021-11-28
317303,JAKARTA BARAT,TAMAN SARI,8755,1,8614,140,0,1,2021-11-28
317304,JAKARTA BARAT,TAMBORA,14124,2,13865,253,4,6,2021-11-28
317107,JAKARTA PUSAT,TANAH ABANG,11044,1,10818,223,2,3,2021-11-28
317202,JAKARTA UTARA,TANJUNG PRIOK,25771,3,25335,425,8,11,2021-11-28
317401,JAKARTA SELATAN,TEBET,16953,0,16672,279,2,2,2021-11-28
317410,JAKARTA SELATAN,PESANGGRAHAN,16376,5,16119,252,0,5,2021-11-28
317504,JAKARTA TIMUR,KRAMAT JATI,21629,2,21224,402,1,3,2021-11-28
317103,JAKARTA PUSAT,KEMAYORAN,19957,2,19576,373,6,8,2021-11-28
310101,KAB.ADM.KEP.SERIBU,KEP. SERIBU UTARA,640,0,634,6,0,0,2021-11-28
317506,JAKARTA TIMUR,CAKUNG,22657,3,22241,413,0,3,2021-11-28
317203,JAKARTA UTARA,KOJA,17230,2,16886,338,4,6,2021-11-28
111111,Luar DKI & Proses Update,Luar DKI & Proses Update,143008,137,141294,1273,304,441,2021-11-28
317105,JAKARTA PUSAT,CEMPAKA PUTIH,10521,3,10349,168,1,4,2021-11-28
317301,JAKARTA BARAT,CENGKARENG,28680,4,28086,559,31,35,2021-11-28
317204,JAKARTA UTARA,CILINCING,17429,1,17075,340,13,14,2021-11-28
317510,JAKARTA TIMUR,CIPAYUNG,25193,3,24922,267,1,4,2021-11-28
317509,JAKARTA TIMUR,CIRACAS,22511,1,22126,379,5,6,2021-11-28
317507,JAKARTA TIMUR,DUREN SAWIT,29470,1,28853,611,5,6,2021-11-28
317101,JAKARTA PUSAT,GAMBIR,8564,2,8425,134,3,5,2021-11-28
317302,JAKARTA BARAT,GROGOL PETAMBURAN,19082,0,18783,298,1,1,2021-11-28
317406,JAKARTA SELATAN,CILANDAK,17696,2,17426,261,7,9,2021-11-28
317503,JAKARTA TIMUR,JATINEGARA,19574,1,19185,383,5,6,2021-11-28
317108,JAKARTA PUSAT,JOHAR BARU,8682,1,8522,157,2,3,2021-11-28
317306,JAKARTA BARAT,KALI DERES,18024,2,17702,316,4,6,2021-11-28
317407,JAKARTA SELATAN,KEBAYORAN BARU,13883,2,13687,185,9,11,2021-11-28
317405,JAKARTA SELATAN,KEBAYORAN LAMA,20050,2,19683,362,3,5,2021-11-28
317305,JAKARTA BARAT,KEBON JERUK,22090,6,21706,374,4,10,2021-11-28
317206,JAKARTA UTARA,KELAPA GADING,12645,8,12443,192,2,10,2021-11-28
317409,JAKARTA SELATAN,JAGAKARSA,26598,0,26184,406,8,8,2021-11-28
310102,KAB.ADM.KEP.SERIBU,KEP. SERIBU SELATAN,704,0,694,10,0,0,2021-11-28
317308,JAKARTA BARAT,KEMBANGAN,20246,1,19940,303,2,3,2021-11-28
310102,KAB.ADM.KEP.SERIBU,KEP. SERIBU SELATAN,704,0,694,10,0,0,2021-11-29
310101,KAB.ADM.KEP.SERIBU,KEP. SERIBU UTARA,640,0,634,6,0,0,2021-11-29
317203,JAKARTA UTARA,KOJA,17230,2,16888,338,2,4,2021-11-29
317504,JAKARTA TIMUR,KRAMAT JATI,21629,1,21225,402,1,2,2021-11-29
317508,JAKARTA TIMUR,MAKASAR,17475,1,17178,296,0,1,2021-11-29
317403,JAKARTA SELATAN,MAMPANG PRAPATAN,11511,0,11329,179,3,3,2021-11-29
317205,JAKARTA UTARA,PADEMANGAN,12885,0,12710,163,12,12,2021-11-29
317106,JAKARTA PUSAT,MENTENG,6433,0,6314,119,0,0,2021-11-29
317307,JAKARTA BARAT,PALMERAH,15834,0,15504,329,1,1,2021-11-29
317408,JAKARTA SELATAN,PANCORAN,14332,1,14099,227,5,6,2021-11-29
317404,JAKARTA SELATAN,PASAR MINGGU,23825,3,23383,426,13,16,2021-11-29
317505,JAKARTA TIMUR,PASAR REBO,17642,1,17315,326,0,1,2021-11-29
317308,JAKARTA BARAT,KEMBANGAN,20247,1,19942,303,1,2,2021-11-29
317501,JAKARTA TIMUR,MATRAMAN,14225,2,13942,279,2,4,2021-11-29
317103,JAKARTA PUSAT,KEMAYORAN,19957,2,19578,373,4,6,2021-11-29
317507,JAKARTA TIMUR,DUREN SAWIT,29470,0,28854,611,5,5,2021-11-29
317305,JAKARTA BARAT,KEBON JERUK,22090,5,21708,374,3,8,2021-11-29
317201,JAKARTA UTARA,PENJARINGAN,18632,1,18401,229,1,2,2021-11-29
317506,JAKARTA TIMUR,CAKUNG,22657,2,22242,413,0,2,2021-11-29
317105,JAKARTA PUSAT,CEMPAKA PUTIH,10521,1,10351,168,1,2,2021-11-29
317301,JAKARTA BARAT,CENGKARENG,28682,6,28087,559,30,36,2021-11-29
317406,JAKARTA SELATAN,CILANDAK,17696,2,17428,261,5,7,2021-11-29
317204,JAKARTA UTARA,CILINCING,17428,1,17075,340,12,13,2021-11-29
317510,JAKARTA TIMUR,CIPAYUNG,25193,2,24923,267,1,3,2021-11-29
317206,JAKARTA UTARA,KELAPA GADING,12649,8,12444,192,5,13,2021-11-29
317509,JAKARTA TIMUR,CIRACAS,22511,1,22126,379,5,6,2021-11-29
317302,JAKARTA BARAT,GROGOL PETAMBURAN,19082,0,18783,298,1,1,2021-11-29
317409,JAKARTA SELATAN,JAGAKARSA,26598,0,26185,406,7,7,2021-11-29
317503,JAKARTA TIMUR,JATINEGARA,19576,3,19185,383,5,8,2021-11-29
317108,JAKARTA PUSAT,JOHAR BARU,8682,0,8524,157,1,1,2021-11-29
317306,JAKARTA BARAT,KALI DERES,18026,1,17703,316,6,7,2021-11-29
317407,JAKARTA SELATAN,KEBAYORAN BARU,13884,3,13687,185,9,12,2021-11-29
317405,JAKARTA SELATAN,KEBAYORAN LAMA,20050,2,19684,362,2,4,2021-11-29
317101,JAKARTA PUSAT,GAMBIR,8564,2,8425,134,3,5,2021-11-29
317410,JAKARTA SELATAN,PESANGGRAHAN,16376,4,16120,252,0,4,2021-11-29
317402,JAKARTA SELATAN,SETIA BUDI,12002,0,11818,183,1,1,2021-11-29
317102,JAKARTA PUSAT,SAWAH BESAR,9156,1,8983,172,0,1,2021-11-29
317104,JAKARTA PUSAT,SENEN,9392,5,9218,168,1,6,2021-11-29
317303,JAKARTA BARAT,TAMAN SARI,8755,1,8614,140,0,1,2021-11-29
317304,JAKARTA BARAT,TAMBORA,14124,2,13865,253,4,6,2021-11-29
317107,JAKARTA PUSAT,TANAH ABANG,11046,3,10819,223,1,4,2021-11-29
317202,JAKARTA UTARA,TANJUNG PRIOK,25772,4,25335,425,8,12,2021-11-29
317401,JAKARTA SELATAN,TEBET,16953,0,16672,279,2,2,2021-11-29
111111,Luar DKI & Proses Update,Luar DKI & Proses Update,143008,137,141294,1273,304,441,2021-11-29
317502,JAKARTA TIMUR,PULO GADUNG,21799,6,21390,400,3,9,2021-11-29
317505,JAKARTA TIMUR,PASAR REBO,17644,3,17315,326,0,3,2021-11-30
317404,JAKARTA SELATAN,PASAR MINGGU,23828,5,23384,426,13,18,2021-11-30
317408,JAKARTA SELATAN,PANCORAN,14333,1,14099,227,6,7,2021-11-30
317501,JAKARTA TIMUR,MATRAMAN,14225,2,13942,279,2,4,2021-11-30
317205,JAKARTA UTARA,PADEMANGAN,12884,0,12709,163,12,12,2021-11-30
317106,JAKARTA PUSAT,MENTENG,6433,0,6314,119,0,0,2021-11-30
317201,JAKARTA UTARA,PENJARINGAN,18633,1,18402,229,1,2,2021-11-30
317307,JAKARTA BARAT,PALMERAH,15835,0,15505,329,1,1,2021-11-30
317410,JAKARTA SELATAN,PESANGGRAHAN,16377,4,16120,252,1,5,2021-11-30
317402,JAKARTA SELATAN,SETIA BUDI,12001,0,11818,183,0,0,2021-11-30
317102,JAKARTA PUSAT,SAWAH BESAR,9157,2,8983,172,0,2,2021-11-30
317104,JAKARTA PUSAT,SENEN,9394,5,9219,168,2,7,2021-11-30
317403,JAKARTA SELATAN,MAMPANG PRAPATAN,11511,0,11329,179,3,3,2021-11-30
317303,JAKARTA BARAT,TAMAN SARI,8755,1,8614,140,0,1,2021-11-30
317304,JAKARTA BARAT,TAMBORA,14124,2,13865,253,4,6,2021-11-30
317107,JAKARTA PUSAT,TANAH ABANG,11047,3,10819,223,2,5,2021-11-30
317202,JAKARTA UTARA,TANJUNG PRIOK,25773,5,25335,425,8,13,2021-11-30
111111,Luar DKI & Proses Update,Luar DKI & Proses Update,143008,137,141294,1273,304,441,2021-11-30
317502,JAKARTA TIMUR,PULO GADUNG,21799,5,21391,400,3,8,2021-11-30
317508,JAKARTA TIMUR,MAKASAR,17475,1,17178,296,0,1,2021-11-30
317401,JAKARTA SELATAN,TEBET,16954,0,16673,279,2,2,2021-11-30
317203,JAKARTA UTARA,KOJA,17230,2,16888,338,2,4,2021-11-30
317506,JAKARTA TIMUR,CAKUNG,22657,2,22242,413,0,2,2021-11-30
317105,JAKARTA PUSAT,CEMPAKA PUTIH,10521,1,10351,168,1,2,2021-11-30
317504,JAKARTA TIMUR,KRAMAT JATI,21630,2,21225,402,1,3,2021-11-30
317406,JAKARTA SELATAN,CILANDAK,17697,2,17429,261,5,7,2021-11-30
317204,JAKARTA UTARA,CILINCING,17428,1,17075,340,12,13,2021-11-30
317510,JAKARTA TIMUR,CIPAYUNG,25193,2,24923,267,1,3,2021-11-30
317509,JAKARTA TIMUR,CIRACAS,22513,3,22127,379,4,7,2021-11-30
317507,JAKARTA TIMUR,DUREN SAWIT,29470,0,28854,611,5,5,2021-11-30
317101,JAKARTA PUSAT,GAMBIR,8565,1,8427,134,3,4,2021-11-30
317302,JAKARTA BARAT,GROGOL PETAMBURAN,19082,0,18784,298,0,0,2021-11-30
317409,JAKARTA SELATAN,JAGAKARSA,26599,1,26185,406,7,8,2021-11-30
317301,JAKARTA BARAT,CENGKARENG,28682,6,28087,559,30,36,2021-11-30
317108,JAKARTA PUSAT,JOHAR BARU,8683,0,8524,157,2,2,2021-11-30
317308,JAKARTA BARAT,KEMBANGAN,20247,0,19943,303,1,1,2021-11-30
310102,KAB.ADM.KEP.SERIBU,KEP. SERIBU SELATAN,704,0,694,10,0,0,2021-11-30
310101,KAB.ADM.KEP.SERIBU,KEP. SERIBU UTARA,640,0,634,6,0,0,2021-11-30
317103,JAKARTA PUSAT,KEMAYORAN,19958,1,19579,373,5,6,2021-11-30
317503,JAKARTA TIMUR,JATINEGARA,19577,4,19186,383,4,8,2021-11-30
317305,JAKARTA BARAT,KEBON JERUK,22090,4,21709,374,3,7,2021-11-30
317405,JAKARTA SELATAN,KEBAYORAN LAMA,20052,2,19684,362,4,6,2021-11-30
317407,JAKARTA SELATAN,KEBAYORAN BARU,13886,3,13688,185,10,13,2021-11-30
317306,JAKARTA BARAT,KALI DERES,18027,0,17704,316,7,7,2021-11-30
317206,JAKARTA UTARA,KELAPA GADING,12650,8,12444,192,6,14,2021-11-30
317201,JAKARTA UTARA,PENJARINGAN,18634,1,18402,229,2,3,2021-12-01
317106,JAKARTA PUSAT,MENTENG,6433,0,6314,119,0,0,2021-12-01
317205,JAKARTA UTARA,PADEMANGAN,12884,0,12710,163,11,11,2021-12-01
317307,JAKARTA BARAT,PALMERAH,15835,0,15505,329,1,1,2021-12-01
317408,JAKARTA SELATAN,PANCORAN,14334,2,14099,227,6,8,2021-12-01
317404,JAKARTA SELATAN,PASAR MINGGU,23829,5,23386,426,12,17,2021-12-01
317505,JAKARTA TIMUR,PASAR REBO,17644,3,17315,326,0,3,2021-12-01
317410,JAKARTA SELATAN,PESANGGRAHAN,16377,4,16120,252,1,5,2021-12-01
317402,JAKARTA SELATAN,SETIA BUDI,12001,0,11818,183,0,0,2021-12-01
317102,JAKARTA PUSAT,SAWAH BESAR,9158,2,8983,172,1,3,2021-12-01
317104,JAKARTA PUSAT,SENEN,9395,5,9219,168,3,8,2021-12-01
317501,JAKARTA TIMUR,MATRAMAN,14225,2,13942,279,2,4,2021-12-01
317303,JAKARTA BARAT,TAMAN SARI,8755,1,8614,140,0,1,2021-12-01
317304,JAKARTA BARAT,TAMBORA,14124,2,13866,253,3,5,2021-12-01
317107,JAKARTA PUSAT,TANAH ABANG,11048,4,10819,223,2,6,2021-12-01
317202,JAKARTA UTARA,TANJUNG PRIOK,25776,5,25335,425,11,16,2021-12-01
317401,JAKARTA SELATAN,TEBET,16954,0,16673,279,2,2,2021-12-01
111111,Luar DKI & Proses Update,Luar DKI & Proses Update,143008,137,141294,1273,304,441,2021-12-01
317502,JAKARTA TIMUR,PULO GADUNG,21799,5,21391,400,3,8,2021-12-01
317403,JAKARTA SELATAN,MAMPANG PRAPATAN,11511,0,11329,179,3,3,2021-12-01
310101,KAB.ADM.KEP.SERIBU,KEP. SERIBU UTARA,640,0,634,6,0,0,2021-12-01
317504,JAKARTA TIMUR,KRAMAT JATI,21631,2,21225,402,2,4,2021-12-01
317506,JAKARTA TIMUR,CAKUNG,22657,1,22243,413,0,1,2021-12-01
317105,JAKARTA PUSAT,CEMPAKA PUTIH,10524,3,10351,168,2,5,2021-12-01
317301,JAKARTA BARAT,CENGKARENG,28690,6,28087,559,38,44,2021-12-01
317406,JAKARTA SELATAN,CILANDAK,17697,2,17430,261,4,6,2021-12-01
317204,JAKARTA UTARA,CILINCING,17428,1,17075,340,12,13,2021-12-01
317510,JAKARTA TIMUR,CIPAYUNG,25194,3,24923,267,1,4,2021-12-01
317509,JAKARTA TIMUR,CIRACAS,22513,3,22127,379,4,7,2021-12-01
317507,JAKARTA TIMUR,DUREN SAWIT,29471,0,28854,611,6,6,2021-12-01
317101,JAKARTA PUSAT,GAMBIR,8565,0,8428,134,3,3,2021-12-01
317508,JAKARTA TIMUR,MAKASAR,17476,2,17178,296,0,2,2021-12-01
317302,JAKARTA BARAT,GROGOL PETAMBURAN,19082,0,18784,298,0,0,2021-12-01
317503,JAKARTA TIMUR,JATINEGARA,19579,6,19186,383,4,10,2021-12-01
317108,JAKARTA PUSAT,JOHAR BARU,8683,0,8524,157,2,2,2021-12-01
317306,JAKARTA BARAT,KALI DERES,18027,0,17704,316,7,7,2021-12-01
317405,JAKARTA SELATAN,KEBAYORAN LAMA,20053,3,19684,362,4,7,2021-12-01
317305,JAKARTA BARAT,KEBON JERUK,22091,4,21709,374,4,8,2021-12-01
317206,JAKARTA UTARA,KELAPA GADING,12651,9,12444,192,6,15,2021-12-01
317103,JAKARTA PUSAT,KEMAYORAN,19958,1,19579,373,5,6,2021-12-01
317308,JAKARTA BARAT,KEMBANGAN,20247,0,19943,303,1,1,2021-12-01
310102,KAB.ADM.KEP.SERIBU,KEP. SERIBU SELATAN,704,0,694,10,0,0,2021-12-01
317203,JAKARTA UTARA,KOJA,17230,2,16888,338,2,4,2021-12-01
317409,JAKARTA SELATAN,JAGAKARSA,26605,2,26185,406,12,14,2021-12-01
317407,JAKARTA SELATAN,KEBAYORAN BARU,13888,4,13690,185,9,13,2021-12-01
111111,Luar DKI & Proses Update,Luar DKI & Proses Update,143008,137,141294,1273,304,441,2021-12-02
317206,JAKARTA UTARA,KELAPA GADING,12651,6,12448,192,5,11,2021-12-02
317308,JAKARTA BARAT,KEMBANGAN,20247,0,19943,303,1,1,2021-12-02
317305,JAKARTA BARAT,KEBON JERUK,22092,4,21710,374,4,8,2021-12-02
317501,JAKARTA TIMUR,MATRAMAN,14225,0,13945,279,1,1,2021-12-02
317106,JAKARTA PUSAT,MENTENG,6433,0,6314,119,0,0,2021-12-02
317205,JAKARTA UTARA,PADEMANGAN,12885,0,12717,163,5,5,2021-12-02
317307,JAKARTA BARAT,PALMERAH,15835,0,15506,329,0,0,2021-12-02
317408,JAKARTA SELATAN,PANCORAN,14336,3,14099,227,7,10,2021-12-02
317404,JAKARTA SELATAN,PASAR MINGGU,23829,4,23388,426,11,15,2021-12-02
317201,JAKARTA UTARA,PENJARINGAN,18635,1,18403,229,2,3,2021-12-02
317405,JAKARTA SELATAN,KEBAYORAN LAMA,20054,4,19684,362,4,8,2021-12-02
317410,JAKARTA SELATAN,PESANGGRAHAN,16377,0,16124,252,1,1,2021-12-02
317102,JAKARTA PUSAT,SAWAH BESAR,9159,1,8984,172,2,3,2021-12-02
317104,JAKARTA PUSAT,SENEN,9395,5,9219,168,3,8,2021-12-02
317402,JAKARTA SELATAN,SETIA BUDI,12001,0,11818,183,0,0,2021-12-02
317303,JAKARTA BARAT,TAMAN SARI,8755,0,8615,140,0,0,2021-12-02
317304,JAKARTA BARAT,TAMBORA,14125,1,13868,253,3,4,2021-12-02
317107,JAKARTA PUSAT,TANAH ABANG,11050,4,10820,223,3,7,2021-12-02
317202,JAKARTA UTARA,TANJUNG PRIOK,25778,2,25341,425,10,12,2021-12-02
317401,JAKARTA SELATAN,TEBET,16954,0,16673,279,2,2,2021-12-02
317502,JAKARTA TIMUR,PULO GADUNG,21799,3,21396,400,0,3,2021-12-02
317407,JAKARTA SELATAN,KEBAYORAN BARU,13890,4,13692,185,9,13,2021-12-02
317505,JAKARTA TIMUR,PASAR REBO,17644,3,17315,326,0,3,2021-12-02
317108,JAKARTA PUSAT,JOHAR BARU,8683,0,8524,157,2,2,2021-12-02
317306,JAKARTA BARAT,KALI DERES,18029,0,17706,316,7,7,2021-12-02
317203,JAKARTA UTARA,KOJA,17231,1,16890,338,2,3,2021-12-02
317504,JAKARTA TIMUR,KRAMAT JATI,21631,2,21225,402,2,4,2021-12-02
317508,JAKARTA TIMUR,MAKASAR,17476,2,17178,296,0,2,2021-12-02
317403,JAKARTA SELATAN,MAMPANG PRAPATAN,11511,0,11330,179,2,2,2021-12-02
317103,JAKARTA PUSAT,KEMAYORAN,19959,0,19582,373,4,4,2021-12-02
310102,KAB.ADM.KEP.SERIBU,KEP. SERIBU SELATAN,704,0,694,10,0,0,2021-12-02
317506,JAKARTA TIMUR,CAKUNG,22657,0,22244,413,0,0,2021-12-02
317105,JAKARTA PUSAT,CEMPAKA PUTIH,10524,3,10352,168,1,4,2021-12-02
317301,JAKARTA BARAT,CENGKARENG,28694,6,28105,559,24,30,2021-12-02
310101,KAB.ADM.KEP.SERIBU,KEP. SERIBU UTARA,640,0,634,6,0,0,2021-12-02
317204,JAKARTA UTARA,CILINCING,17428,1,17084,340,3,4,2021-12-02
317510,JAKARTA TIMUR,CIPAYUNG,25196,1,24926,267,2,3,2021-12-02
317509,JAKARTA TIMUR,CIRACAS,22514,4,22129,379,2,6,2021-12-02
317507,JAKARTA TIMUR,DUREN SAWIT,29473,0,28857,611,5,5,2021-12-02
317101,JAKARTA PUSAT,GAMBIR,8566,1,8431,134,0,1,2021-12-02
317302,JAKARTA BARAT,GROGOL PETAMBURAN,19083,0,18784,298,1,1,2021-12-02
317409,JAKARTA SELATAN,JAGAKARSA,26607,2,26189,406,10,12,2021-12-02
317503,JAKARTA TIMUR,JATINEGARA,19579,6,19187,383,3,9,2021-12-02
317406,JAKARTA SELATAN,CILANDAK,17698,1,17433,261,3,4,2021-12-02
317504,JAKARTA TIMUR,KRAMAT JATI,21632,3,21225,402,2,5,2021-12-03
317408,JAKARTA SELATAN,PANCORAN,14336,3,14101,227,5,8,2021-12-03
317307,JAKARTA BARAT,PALMERAH,15836,1,15506,329,0,1,2021-12-03
317205,JAKARTA UTARA,PADEMANGAN,12886,0,12721,163,2,2,2021-12-03
317508,JAKARTA TIMUR,MAKASAR,17478,1,17178,297,2,3,2021-12-03
317501,JAKARTA TIMUR,MATRAMAN,14225,0,13945,279,1,1,2021-12-03
317403,JAKARTA SELATAN,MAMPANG PRAPATAN,11511,0,11332,179,0,0,2021-12-03
317404,JAKARTA SELATAN,PASAR MINGGU,23829,4,23392,426,7,11,2021-12-03
317106,JAKARTA PUSAT,MENTENG,6433,0,6314,119,0,0,2021-12-03
317505,JAKARTA TIMUR,PASAR REBO,17644,2,17316,326,0,2,2021-12-03
317104,JAKARTA PUSAT,SENEN,9395,5,9219,168,3,8,2021-12-03
317410,JAKARTA SELATAN,PESANGGRAHAN,16377,0,16124,252,1,1,2021-12-03
317502,JAKARTA TIMUR,PULO GADUNG,21799,3,21396,400,0,3,2021-12-03
317102,JAKARTA PUSAT,SAWAH BESAR,9159,1,8984,172,2,3,2021-12-03
317402,JAKARTA SELATAN,SETIA BUDI,12001,0,11818,183,0,0,2021-12-03
317304,JAKARTA BARAT,TAMBORA,14125,1,13869,253,2,3,2021-12-03
317107,JAKARTA PUSAT,TANAH ABANG,11050,4,10820,223,3,7,2021-12-03
317202,JAKARTA UTARA,TANJUNG PRIOK,25779,3,25345,425,6,9,2021-12-03
317401,JAKARTA SELATAN,TEBET,16954,0,16675,279,0,0,2021-12-03
317201,JAKARTA UTARA,PENJARINGAN,18638,1,18403,229,5,6,2021-12-03
317203,JAKARTA UTARA,KOJA,17232,0,16892,338,2,2,2021-12-03
317303,JAKARTA BARAT,TAMAN SARI,8756,0,8615,140,1,1,2021-12-03
310102,KAB.ADM.KEP.SERIBU,KEP. SERIBU SELATAN,704,0,694,10,0,0,2021-12-03
310101,KAB.ADM.KEP.SERIBU,KEP. SERIBU UTARA,640,0,634,6,0,0,2021-12-03
111111,Luar DKI & Proses Update,Luar DKI & Proses Update,143008,137,141294,1273,304,441,2021-12-03
317105,JAKARTA PUSAT,CEMPAKA PUTIH,10524,2,10353,168,1,3,2021-12-03
317301,JAKARTA BARAT,CENGKARENG,28699,6,28110,559,24,30,2021-12-03
317406,JAKARTA SELATAN,CILANDAK,17697,1,17434,261,1,2,2021-12-03
317204,JAKARTA UTARA,CILINCING,17429,2,17085,340,2,4,2021-12-03
317510,JAKARTA TIMUR,CIPAYUNG,25198,3,24926,267,2,5,2021-12-03
317509,JAKARTA TIMUR,CIRACAS,22515,3,22131,379,2,5,2021-12-03
317507,JAKARTA TIMUR,DUREN SAWIT,29474,0,28858,611,5,5,2021-12-03
317101,JAKARTA PUSAT,GAMBIR,8567,2,8431,134,0,2,2021-12-03
317506,JAKARTA TIMUR,CAKUNG,22662,3,22244,413,2,5,2021-12-03
317409,JAKARTA SELATAN,JAGAKARSA,26607,2,26190,406,9,11,2021-12-03
317503,JAKARTA TIMUR,JATINEGARA,19579,6,19188,383,2,8,2021-12-03
317108,JAKARTA PUSAT,JOHAR BARU,8683,0,8525,157,1,1,2021-12-03
317306,JAKARTA BARAT,KALI DERES,18029,0,17706,316,7,7,2021-12-03
317407,JAKARTA SELATAN,KEBAYORAN BARU,13890,4,13692,185,9,13,2021-12-03
317405,JAKARTA SELATAN,KEBAYORAN LAMA,20054,3,19685,362,4,7,2021-12-03
317305,JAKARTA BARAT,KEBON JERUK,22092,2,21712,374,4,6,2021-12-03
317206,JAKARTA UTARA,KELAPA GADING,12652,5,12450,192,5,10,2021-12-03
317103,JAKARTA PUSAT,KEMAYORAN,19960,1,19584,373,2,3,2021-12-03
317302,JAKARTA BARAT,GROGOL PETAMBURAN,19083,1,18784,298,0,1,2021-12-03
317308,JAKARTA BARAT,KEMBANGAN,20249,0,19943,303,3,3,2021-12-03
317505,JAKARTA TIMUR,PASAR REBO,17644,2,17316,326,0,2,2021-12-04
317404,JAKARTA SELATAN,PASAR MINGGU,23829,4,23392,426,7,11,2021-12-04
317408,JAKARTA SELATAN,PANCORAN,14336,3,14101,227,5,8,2021-12-04
317501,JAKARTA TIMUR,MATRAMAN,14225,0,13945,279,1,1,2021-12-04
317106,JAKARTA PUSAT,MENTENG,6433,0,6314,119,0,0,2021-12-04
317201,JAKARTA UTARA,PENJARINGAN,18638,1,18403,229,5,6,2021-12-04
317403,JAKARTA SELATAN,MAMPANG PRAPATAN,11511,0,11332,179,0,0,2021-12-04
317307,JAKARTA BARAT,PALMERAH,15836,1,15506,329,0,1,2021-12-04
317410,JAKARTA SELATAN,PESANGGRAHAN,16377,0,16124,252,1,1,2021-12-04
317303,JAKARTA BARAT,TAMAN SARI,8756,0,8615,140,1,1,2021-12-04
317102,JAKARTA PUSAT,SAWAH BESAR,9159,1,8984,172,2,3,2021-12-04
317104,JAKARTA PUSAT,SENEN,9395,5,9219,168,3,8,2021-12-04
317402,JAKARTA SELATAN,SETIA BUDI,12001,0,11818,183,0,0,2021-12-04
317304,JAKARTA BARAT,TAMBORA,14125,1,13869,253,2,3,2021-12-04
317107,JAKARTA PUSAT,TANAH ABANG,11050,4,10820,223,3,7,2021-12-04
317202,JAKARTA UTARA,TANJUNG PRIOK,25779,3,25345,425,6,9,2021-12-04
317401,JAKARTA SELATAN,TEBET,16954,0,16675,279,0,0,2021-12-04
317508,JAKARTA TIMUR,MAKASAR,17478,1,17178,297,2,3,2021-12-04
111111,Luar DKI & Proses Update,Luar DKI & Proses Update,143008,137,141294,1273,304,441,2021-12-04
317502,JAKARTA TIMUR,PULO GADUNG,21799,3,21396,400,0,3,2021-12-04
317504,JAKARTA TIMUR,KRAMAT JATI,21632,3,21225,402,2,5,2021-12-04
317205,JAKARTA UTARA,PADEMANGAN,12886,0,12721,163,2,2,2021-12-04
310101,KAB.ADM.KEP.SERIBU,KEP. SERIBU UTARA,640,0,634,6,0,0,2021-12-04
317506,JAKARTA TIMUR,CAKUNG,22662,3,22244,413,2,5,2021-12-04
317203,JAKARTA UTARA,KOJA,17232,0,16892,338,2,2,2021-12-04
317105,JAKARTA PUSAT,CEMPAKA PUTIH,10524,2,10353,168,1,3,2021-12-04
317301,JAKARTA BARAT,CENGKARENG,28699,6,28110,559,24,30,2021-12-04
317204,JAKARTA UTARA,CILINCING,17429,2,17085,340,2,4,2021-12-04
317510,JAKARTA TIMUR,CIPAYUNG,25198,3,24926,267,2,5,2021-12-04
317509,JAKARTA TIMUR,CIRACAS,22515,3,22131,379,2,5,2021-12-04
317507,JAKARTA TIMUR,DUREN SAWIT,29474,0,28858,611,5,5,2021-12-04
317101,JAKARTA PUSAT,GAMBIR,8567,2,8431,134,0,2,2021-12-04
317302,JAKARTA BARAT,GROGOL PETAMBURAN,19083,1,18784,298,0,1,2021-12-04
317406,JAKARTA SELATAN,CILANDAK,17697,1,17434,261,1,2,2021-12-04
317503,JAKARTA TIMUR,JATINEGARA,19579,6,19188,383,2,8,2021-12-04
317409,JAKARTA SELATAN,JAGAKARSA,26607,2,26190,406,9,11,2021-12-04
317308,JAKARTA BARAT,KEMBANGAN,20249,0,19943,303,3,3,2021-12-04
317206,JAKARTA UTARA,KELAPA GADING,12652,5,12450,192,5,10,2021-12-04
317305,JAKARTA BARAT,KEBON JERUK,22092,2,21712,374,4,6,2021-12-04
317103,JAKARTA PUSAT,KEMAYORAN,19960,1,19584,373,2,3,2021-12-04
317407,JAKARTA SELATAN,KEBAYORAN BARU,13890,4,13692,185,9,13,2021-12-04
317306,JAKARTA BARAT,KALI DERES,18029,0,17706,316,7,7,2021-12-04
317108,JAKARTA PUSAT,JOHAR BARU,8683,0,8525,157,1,1,2021-12-04
317405,JAKARTA SELATAN,KEBAYORAN LAMA,20054,3,19685,362,4,7,2021-12-04
310102,KAB.ADM.KEP.SERIBU,KEP. SERIBU SELATAN,704,0,694,10,0,0,2021-12-04
317308,JAKARTA BARAT,KEMBANGAN,20249,0,19943,303,3,3,2021-12-05
310102,KAB.ADM.KEP.SERIBU,KEP. SERIBU SELATAN,704,0,694,10,0,0,2021-12-05
310101,KAB.ADM.KEP.SERIBU,KEP. SERIBU UTARA,640,0,634,6,0,0,2021-12-05
317203,JAKARTA UTARA,KOJA,17232,0,16892,338,2,2,2021-12-05
317504,JAKARTA TIMUR,KRAMAT JATI,21632,2,21227,402,1,3,2021-12-05
317508,JAKARTA TIMUR,MAKASAR,17478,1,17178,297,2,3,2021-12-05
317205,JAKARTA UTARA,PADEMANGAN,12886,0,12721,163,2,2,2021-12-05
317501,JAKARTA TIMUR,MATRAMAN,14225,0,13945,279,1,1,2021-12-05
317106,JAKARTA PUSAT,MENTENG,6433,0,6314,119,0,0,2021-12-05
317307,JAKARTA BARAT,PALMERAH,15836,1,15506,329,0,1,2021-12-05
317505,JAKARTA TIMUR,PASAR REBO,17645,2,17316,326,1,3,2021-12-05
317404,JAKARTA SELATAN,PASAR MINGGU,23830,4,23395,426,5,9,2021-12-05
317103,JAKARTA PUSAT,KEMAYORAN,19959,1,19584,373,1,2,2021-12-05
317403,JAKARTA SELATAN,MAMPANG PRAPATAN,11511,0,11332,179,0,0,2021-12-05
317206,JAKARTA UTARA,KELAPA GADING,12652,4,12451,192,5,9,2021-12-05
317509,JAKARTA TIMUR,CIRACAS,22516,3,22131,379,3,6,2021-12-05
317405,JAKARTA SELATAN,KEBAYORAN LAMA,20054,3,19685,362,4,7,2021-12-05
317506,JAKARTA TIMUR,CAKUNG,22664,4,22244,413,3,7,2021-12-05
317105,JAKARTA PUSAT,CEMPAKA PUTIH,10525,3,10353,168,1,4,2021-12-05
317301,JAKARTA BARAT,CENGKARENG,28707,6,28113,559,29,35,2021-12-05
317406,JAKARTA SELATAN,CILANDAK,17697,1,17434,261,1,2,2021-12-05
317204,JAKARTA UTARA,CILINCING,17430,3,17085,340,2,5,2021-12-05
317510,JAKARTA TIMUR,CIPAYUNG,25199,3,24926,267,3,6,2021-12-05
317305,JAKARTA BARAT,KEBON JERUK,22093,2,21711,375,5,7,2021-12-05
317507,JAKARTA TIMUR,DUREN SAWIT,29476,0,28859,611,6,6,2021-12-05
317302,JAKARTA BARAT,GROGOL PETAMBURAN,19084,1,18784,298,1,2,2021-12-05
317409,JAKARTA SELATAN,JAGAKARSA,26608,2,26191,406,9,11,2021-12-05
317503,JAKARTA TIMUR,JATINEGARA,19581,7,19190,383,1,8,2021-12-05
317108,JAKARTA PUSAT,JOHAR BARU,8684,1,8525,157,1,2,2021-12-05
317306,JAKARTA BARAT,KALI DERES,18030,1,17706,316,7,8,2021-12-05
317407,JAKARTA SELATAN,KEBAYORAN BARU,13891,4,13693,185,9,13,2021-12-05
317101,JAKARTA PUSAT,GAMBIR,8567,2,8431,134,0,2,2021-12-05
317201,JAKARTA UTARA,PENJARINGAN,18638,1,18403,229,5,6,2021-12-05
317408,JAKARTA SELATAN,PANCORAN,14336,3,14101,227,5,8,2021-12-05
317502,JAKARTA TIMUR,PULO GADUNG,21800,2,21398,400,0,2,2021-12-05
317102,JAKARTA PUSAT,SAWAH BESAR,9159,1,8984,172,2,3,2021-12-05
317104,JAKARTA PUSAT,SENEN,9395,4,9220,168,3,7,2021-12-05
317402,JAKARTA SELATAN,SETIA BUDI,12002,0,11818,183,1,1,2021-12-05
317303,JAKARTA BARAT,TAMAN SARI,8756,0,8615,140,1,1,2021-12-05
317304,JAKARTA BARAT,TAMBORA,14127,2,13870,253,2,4,2021-12-05
317107,JAKARTA PUSAT,TANAH ABANG,11050,4,10820,223,3,7,2021-12-05
317202,JAKARTA UTARA,TANJUNG PRIOK,25780,3,25345,425,7,10,2021-12-05
317401,JAKARTA SELATAN,TEBET,16954,0,16675,279,0,0,2021-12-05
111111,Luar DKI & Proses Update,Luar DKI & Proses Update,143008,137,141294,1273,304,441,2021-12-05
317410,JAKARTA SELATAN,PESANGGRAHAN,16378,1,16124,252,1,2,2021-12-05
317505,JAKARTA TIMUR,PASAR REBO,17645,2,17316,326,1,3,2021-12-06
317404,JAKARTA SELATAN,PASAR MINGGU,23833,2,23399,426,6,8,2021-12-06
317408,JAKARTA SELATAN,PANCORAN,14336,3,14103,227,3,6,2021-12-06
317501,JAKARTA TIMUR,MATRAMAN,14225,0,13946,279,0,0,2021-12-06
317205,JAKARTA UTARA,PADEMANGAN,12886,0,12721,163,2,2,2021-12-06
317106,JAKARTA PUSAT,MENTENG,6433,0,6314,119,0,0,2021-12-06
317201,JAKARTA UTARA,PENJARINGAN,18638,1,18403,229,5,6,2021-12-06
317307,JAKARTA BARAT,PALMERAH,15836,1,15506,329,0,1,2021-12-06
317410,JAKARTA SELATAN,PESANGGRAHAN,16378,1,16124,252,1,2,2021-12-06
317304,JAKARTA BARAT,TAMBORA,14127,2,13870,253,2,4,2021-12-06
317102,JAKARTA PUSAT,SAWAH BESAR,9159,1,8984,172,2,3,2021-12-06
317104,JAKARTA PUSAT,SENEN,9395,4,9220,168,3,7,2021-12-06
317402,JAKARTA SELATAN,SETIA BUDI,12002,0,11818,183,1,1,2021-12-06
317303,JAKARTA BARAT,TAMAN SARI,8756,0,8615,140,1,1,2021-12-06
317403,JAKARTA SELATAN,MAMPANG PRAPATAN,11511,0,11332,179,0,0,2021-12-06
317107,JAKARTA PUSAT,TANAH ABANG,11050,4,10820,223,3,7,2021-12-06
317202,JAKARTA UTARA,TANJUNG PRIOK,25780,3,25346,425,6,9,2021-12-06
317401,JAKARTA SELATAN,TEBET,16954,0,16675,279,0,0,2021-12-06
111111,Luar DKI & Proses Update,Luar DKI & Proses Update,143008,137,141294,1273,304,441,2021-12-06
317502,JAKARTA TIMUR,PULO GADUNG,21800,0,21399,401,0,0,2021-12-06
317508,JAKARTA TIMUR,MAKASAR,17478,0,17179,297,2,2,2021-12-06
317506,JAKARTA TIMUR,CAKUNG,22664,4,22244,413,3,7,2021-12-06
317203,JAKARTA UTARA,KOJA,17232,0,16892,338,2,2,2021-12-06
317406,JAKARTA SELATAN,CILANDAK,17698,0,17435,261,2,2,2021-12-06
317504,JAKARTA TIMUR,KRAMAT JATI,21632,2,21227,402,1,3,2021-12-06
317105,JAKARTA PUSAT,CEMPAKA PUTIH,10526,3,10353,168,2,5,2021-12-06
317204,JAKARTA UTARA,CILINCING,17430,3,17087,340,0,3,2021-12-06
317510,JAKARTA TIMUR,CIPAYUNG,25199,3,24926,267,3,6,2021-12-06
317509,JAKARTA TIMUR,CIRACAS,22516,3,22132,379,2,5,2021-12-06
317507,JAKARTA TIMUR,DUREN SAWIT,29476,0,28859,611,6,6,2021-12-06
317101,JAKARTA PUSAT,GAMBIR,8566,1,8431,134,0,1,2021-12-06
317302,JAKARTA BARAT,GROGOL PETAMBURAN,19084,1,18784,298,1,2,2021-12-06
317409,JAKARTA SELATAN,JAGAKARSA,26608,2,26192,406,8,10,2021-12-06
317301,JAKARTA BARAT,CENGKARENG,28708,4,28121,559,24,28,2021-12-06
317108,JAKARTA PUSAT,JOHAR BARU,8684,1,8525,157,1,2,2021-12-06
317306,JAKARTA BARAT,KALI DERES,18030,1,17708,316,5,6,2021-12-06
317407,JAKARTA SELATAN,KEBAYORAN BARU,13891,3,13698,185,5,8,2021-12-06
317405,JAKARTA SELATAN,KEBAYORAN LAMA,20054,3,19687,362,2,5,2021-12-06
317305,JAKARTA BARAT,KEBON JERUK,22094,2,21716,375,1,3,2021-12-06
317206,JAKARTA UTARA,KELAPA GADING,12652,2,12454,192,4,6,2021-12-06
317103,JAKARTA PUSAT,KEMAYORAN,19959,1,19584,373,1,2,2021-12-06
310101,KAB.ADM.KEP.SERIBU,KEP. SERIBU UTARA,640,0,634,6,0,0,2021-12-06
317308,JAKARTA BARAT,KEMBANGAN,20249,0,19943,303,3,3,2021-12-06
310102,KAB.ADM.KEP.SERIBU,KEP. SERIBU SELATAN,704,0,694,10,0,0,2021-12-06
317503,JAKARTA TIMUR,JATINEGARA,19581,7,19190,383,1,8,2021-12-06
317404,JAKARTA SELATAN,PASAR MINGGU,23834,2,23399,426,7,9,2021-12-07
317408,JAKARTA SELATAN,PANCORAN,14335,2,14103,227,3,5,2021-12-07
317501,JAKARTA TIMUR,MATRAMAN,14225,0,13946,279,0,0,2021-12-07
317205,JAKARTA UTARA,PADEMANGAN,12887,0,12722,163,2,2,2021-12-07
317106,JAKARTA PUSAT,MENTENG,6433,0,6314,119,0,0,2021-12-07
317505,JAKARTA TIMUR,PASAR REBO,17645,2,17316,326,1,3,2021-12-07
317307,JAKARTA BARAT,PALMERAH,15836,0,15506,329,1,1,2021-12-07
317201,JAKARTA UTARA,PENJARINGAN,18638,0,18404,229,5,5,2021-12-07
317402,JAKARTA SELATAN,SETIA BUDI,12001,0,11818,183,0,0,2021-12-07
317502,JAKARTA TIMUR,PULO GADUNG,21800,0,21399,401,0,0,2021-12-07
317102,JAKARTA PUSAT,SAWAH BESAR,9159,1,8984,172,2,3,2021-12-07
317303,JAKARTA BARAT,TAMAN SARI,8757,0,8615,140,2,2,2021-12-07
317304,JAKARTA BARAT,TAMBORA,14127,1,13871,253,2,3,2021-12-07
317107,JAKARTA PUSAT,TANAH ABANG,11050,4,10821,223,2,6,2021-12-07
317202,JAKARTA UTARA,TANJUNG PRIOK,25780,3,25346,425,6,9,2021-12-07
317401,JAKARTA SELATAN,TEBET,16954,0,16675,279,0,0,2021-12-07
317403,JAKARTA SELATAN,MAMPANG PRAPATAN,11511,0,11332,179,0,0,2021-12-07
111111,Luar DKI & Proses Update,Luar DKI & Proses Update,143008,137,141294,1273,304,441,2021-12-07
317410,JAKARTA SELATAN,PESANGGRAHAN,16378,1,16124,252,1,2,2021-12-07
317508,JAKARTA TIMUR,MAKASAR,17478,0,17178,298,2,2,2021-12-07
317104,JAKARTA PUSAT,SENEN,9396,5,9222,168,1,6,2021-12-07
317203,JAKARTA UTARA,KOJA,17233,0,16892,338,3,3,2021-12-07
317506,JAKARTA TIMUR,CAKUNG,22664,3,22244,413,4,7,2021-12-07
317105,JAKARTA PUSAT,CEMPAKA PUTIH,10526,3,10353,168,2,5,2021-12-07
317301,JAKARTA BARAT,CENGKARENG,28710,5,28122,559,24,29,2021-12-07
317504,JAKARTA TIMUR,KRAMAT JATI,21632,2,21227,402,1,3,2021-12-07
317406,JAKARTA SELATAN,CILANDAK,17698,0,17436,261,1,1,2021-12-07
317204,JAKARTA UTARA,CILINCING,17432,4,17088,340,0,4,2021-12-07
317510,JAKARTA TIMUR,CIPAYUNG,25200,4,24926,267,3,7,2021-12-07
317509,JAKARTA TIMUR,CIRACAS,22516,3,22132,379,2,5,2021-12-07
317507,JAKARTA TIMUR,DUREN SAWIT,29477,1,28859,611,6,7,2021-12-07
317101,JAKARTA PUSAT,GAMBIR,8566,1,8431,134,0,1,2021-12-07
317302,JAKARTA BARAT,GROGOL PETAMBURAN,19085,1,18784,298,2,3,2021-12-07
310101,KAB.ADM.KEP.SERIBU,KEP. SERIBU UTARA,640,0,634,6,0,0,2021-12-07
317503,JAKARTA TIMUR,JATINEGARA,19580,6,19191,383,0,6,2021-12-07
317206,JAKARTA UTARA,KELAPA GADING,12650,0,12454,192,4,4,2021-12-07
317308,JAKARTA BARAT,KEMBANGAN,20249,0,19944,303,2,2,2021-12-07
310102,KAB.ADM.KEP.SERIBU,KEP. SERIBU SELATAN,704,0,694,10,0,0,2021-12-07
317409,JAKARTA SELATAN,JAGAKARSA,26609,3,26192,406,8,11,2021-12-07
317103,JAKARTA PUSAT,KEMAYORAN,19959,1,19585,373,0,1,2021-12-07
317405,JAKARTA SELATAN,KEBAYORAN LAMA,20055,2,19689,362,2,4,2021-12-07
317407,JAKARTA SELATAN,KEBAYORAN BARU,13891,2,13699,185,5,7,2021-12-07
317306,JAKARTA BARAT,KALI DERES,18030,1,17708,316,5,6,2021-12-07
317108,JAKARTA PUSAT,JOHAR BARU,8683,0,8526,157,0,0,2021-12-07
317305,JAKARTA BARAT,KEBON JERUK,22097,4,21717,375,1,5,2021-12-07
317201,JAKARTA UTARA,PENJARINGAN,18641,0,18404,229,8,8,2021-12-08
317106,JAKARTA PUSAT,MENTENG,6433,0,6314,119,0,0,2021-12-08
317205,JAKARTA UTARA,PADEMANGAN,12888,1,12722,163,2,3,2021-12-08
317307,JAKARTA BARAT,PALMERAH,15837,0,15506,329,2,2,2021-12-08
317408,JAKARTA SELATAN,PANCORAN,14337,3,14105,227,2,5,2021-12-08
317404,JAKARTA SELATAN,PASAR MINGGU,23835,2,23401,426,6,8,2021-12-08
317505,JAKARTA TIMUR,PASAR REBO,17645,2,17316,326,1,3,2021-12-08
317410,JAKARTA SELATAN,PESANGGRAHAN,16378,1,16124,252,1,2,2021-12-08
317402,JAKARTA SELATAN,SETIA BUDI,12002,0,11818,183,1,1,2021-12-08
317102,JAKARTA PUSAT,SAWAH BESAR,9159,0,8985,172,2,2,2021-12-08
317104,JAKARTA PUSAT,SENEN,9397,2,9227,168,0,2,2021-12-08
317501,JAKARTA TIMUR,MATRAMAN,14225,0,13946,279,0,0,2021-12-08
317303,JAKARTA BARAT,TAMAN SARI,8758,1,8615,140,2,3,2021-12-08
317304,JAKARTA BARAT,TAMBORA,14127,1,13871,253,2,3,2021-12-08
317107,JAKARTA PUSAT,TANAH ABANG,11050,2,10824,223,1,3,2021-12-08
317202,JAKARTA UTARA,TANJUNG PRIOK,25780,1,25348,425,6,7,2021-12-08
317401,JAKARTA SELATAN,TEBET,16954,0,16675,279,0,0,2021-12-08
111111,Luar DKI & Proses Update,Luar DKI & Proses Update,143008,137,141294,1273,304,441,2021-12-08
317502,JAKARTA TIMUR,PULO GADUNG,21800,0,21399,401,0,0,2021-12-08
317403,JAKARTA SELATAN,MAMPANG PRAPATAN,11511,0,11332,179,0,0,2021-12-08
317203,JAKARTA UTARA,KOJA,17233,0,16892,338,3,3,2021-12-08
317504,JAKARTA TIMUR,KRAMAT JATI,21631,1,21227,402,1,2,2021-12-08
317506,JAKARTA TIMUR,CAKUNG,22665,3,22244,413,5,8,2021-12-08
317105,JAKARTA PUSAT,CEMPAKA PUTIH,10526,3,10353,168,2,5,2021-12-08
317301,JAKARTA BARAT,CENGKARENG,28709,4,28123,559,23,27,2021-12-08
317406,JAKARTA SELATAN,CILANDAK,17699,1,17436,261,1,2,2021-12-08
317204,JAKARTA UTARA,CILINCING,17432,4,17088,340,0,4,2021-12-08
317510,JAKARTA TIMUR,CIPAYUNG,25200,4,24926,267,3,7,2021-12-08
317509,JAKARTA TIMUR,CIRACAS,22516,3,22132,379,2,5,2021-12-08
317507,JAKARTA TIMUR,DUREN SAWIT,29477,1,28859,611,6,7,2021-12-08
317101,JAKARTA PUSAT,GAMBIR,8566,1,8431,134,0,1,2021-12-08
317508,JAKARTA TIMUR,MAKASAR,17480,2,17178,298,2,4,2021-12-08
317302,JAKARTA BARAT,GROGOL PETAMBURAN,19085,2,18784,298,1,3,2021-12-08
317503,JAKARTA TIMUR,JATINEGARA,19581,4,19194,383,0,4,2021-12-08
317108,JAKARTA PUSAT,JOHAR BARU,8683,0,8526,157,0,0,2021-12-08
317306,JAKARTA BARAT,KALI DERES,18030,1,17711,316,2,3,2021-12-08
317407,JAKARTA SELATAN,KEBAYORAN BARU,13889,1,13702,185,1,2,2021-12-08
317305,JAKARTA BARAT,KEBON JERUK,22099,4,21717,375,3,7,2021-12-08
317206,JAKARTA UTARA,KELAPA GADING,12650,0,12457,192,1,1,2021-12-08
317103,JAKARTA PUSAT,KEMAYORAN,19959,1,19585,373,0,1,2021-12-08
317308,JAKARTA BARAT,KEMBANGAN,20251,2,19944,303,2,4,2021-12-08
310102,KAB.ADM.KEP.SERIBU,KEP. SERIBU SELATAN,704,0,694,10,0,0,2021-12-08
310101,KAB.ADM.KEP.SERIBU,KEP. SERIBU UTARA,640,0,634,6,0,0,2021-12-08
317409,JAKARTA SELATAN,JAGAKARSA,26610,4,26192,406,8,12,2021-12-08
317405,JAKARTA SELATAN,KEBAYORAN LAMA,20057,3,19689,363,2,5,2021-12-08
111111,Luar DKI & Proses Update,Luar DKI & Proses Update,143008,137,141294,1273,304,441,2021-12-09
317106,JAKARTA PUSAT,MENTENG,6433,0,6314,119,0,0,2021-12-09
317506,JAKARTA TIMUR,CAKUNG,22664,3,22244,413,4,7,2021-12-09
317504,JAKARTA TIMUR,KRAMAT JATI,21631,0,21229,402,0,0,2021-12-09
317203,JAKARTA UTARA,KOJA,17234,1,16892,338,3,4,2021-12-09
310101,KAB.ADM.KEP.SERIBU,KEP. SERIBU UTARA,640,0,634,6,0,0,2021-12-09
310102,KAB.ADM.KEP.SERIBU,KEP. SERIBU SELATAN,704,0,694,10,0,0,2021-12-09
317308,JAKARTA BARAT,KEMBANGAN,20251,2,19944,303,2,4,2021-12-09
317103,JAKARTA PUSAT,KEMAYORAN,19962,3,19585,373,1,4,2021-12-09
317206,JAKARTA UTARA,KELAPA GADING,12650,0,12457,192,1,1,2021-12-09
317305,JAKARTA BARAT,KEBON JERUK,22099,4,21717,375,3,7,2021-12-09
317405,JAKARTA SELATAN,KEBAYORAN LAMA,20057,3,19691,363,0,3,2021-12-09
317407,JAKARTA SELATAN,KEBAYORAN BARU,13889,0,13703,185,1,1,2021-12-09
317306,JAKARTA BARAT,KALI DERES,18030,0,17711,316,3,3,2021-12-09
317108,JAKARTA PUSAT,JOHAR BARU,8683,0,8526,157,0,0,2021-12-09
317503,JAKARTA TIMUR,JATINEGARA,19581,2,19196,383,0,2,2021-12-09
317409,JAKARTA SELATAN,JAGAKARSA,26612,3,26198,406,5,8,2021-12-09
317302,JAKARTA BARAT,GROGOL PETAMBURAN,19086,2,18784,298,2,4,2021-12-09
317101,JAKARTA PUSAT,GAMBIR,8566,1,8431,134,0,1,2021-12-09
317507,JAKARTA TIMUR,DUREN SAWIT,29477,1,28860,611,5,6,2021-12-09
317509,JAKARTA TIMUR,CIRACAS,22517,0,22135,379,3,3,2021-12-09
317510,JAKARTA TIMUR,CIPAYUNG,25201,4,24926,267,4,8,2021-12-09
317204,JAKARTA UTARA,CILINCING,17433,5,17088,340,0,5,2021-12-09
317406,JAKARTA SELATAN,CILANDAK,17699,1,17436,261,1,2,2021-12-09
317301,JAKARTA BARAT,CENGKARENG,28709,4,28131,559,15,19,2021-12-09
317105,JAKARTA PUSAT,CEMPAKA PUTIH,10525,3,10353,168,1,4,2021-12-09
317501,JAKARTA TIMUR,MATRAMAN,14225,0,13946,279,0,0,2021-12-09
317508,JAKARTA TIMUR,MAKASAR,17482,4,17178,298,2,6,2021-12-09
317403,JAKARTA SELATAN,MAMPANG PRAPATAN,11511,0,11332,179,0,0,2021-12-09
317502,JAKARTA TIMUR,PULO GADUNG,21800,0,21399,401,0,0,2021-12-09
317102,JAKARTA PUSAT,SAWAH BESAR,9159,0,8985,172,2,2,2021-12-09
317201,JAKARTA UTARA,PENJARINGAN,18642,1,18405,229,7,8,2021-12-09
317505,JAKARTA TIMUR,PASAR REBO,17645,0,17318,326,1,1,2021-12-09
317404,JAKARTA SELATAN,PASAR MINGGU,23835,1,23403,426,5,6,2021-12-09
317408,JAKARTA SELATAN,PANCORAN,14337,2,14107,227,1,3,2021-12-09
317205,JAKARTA UTARA,PADEMANGAN,12888,1,12722,163,2,3,2021-12-09
317410,JAKARTA SELATAN,PESANGGRAHAN,16378,1,16125,252,0,1,2021-12-09
317307,JAKARTA BARAT,PALMERAH,15837,0,15506,329,2,2,2021-12-09
317402,JAKARTA SELATAN,SETIA BUDI,12002,0,11818,183,1,1,2021-12-09
317104,JAKARTA PUSAT,SENEN,9395,0,9227,168,0,0,2021-12-09
317303,JAKARTA BARAT,TAMAN SARI,8758,1,8615,140,2,3,2021-12-09
317304,JAKARTA BARAT,TAMBORA,14127,1,13871,253,2,3,2021-12-09
317107,JAKARTA PUSAT,TANAH ABANG,11051,1,10825,223,2,3,2021-12-09
317401,JAKARTA SELATAN,TEBET,16954,0,16675,279,0,0,2021-12-09
317202,JAKARTA UTARA,TANJUNG PRIOK,25782,3,25352,425,2,5,2021-12-09
317405,JAKARTA SELATAN,KEBAYORAN LAMA,20057,1,19693,363,0,1,2021-12-10
317305,JAKARTA BARAT,KEBON JERUK,22103,4,21718,375,6,10,2021-12-10
317206,JAKARTA UTARA,KELAPA GADING,12650,0,12457,192,1,1,2021-12-10
317103,JAKARTA PUSAT,KEMAYORAN,19964,4,19585,373,2,6,2021-12-10
317308,JAKARTA BARAT,KEMBANGAN,20251,2,19944,303,2,4,2021-12-10
310102,KAB.ADM.KEP.SERIBU,KEP. SERIBU SELATAN,704,0,694,10,0,0,2021-12-10
310101,KAB.ADM.KEP.SERIBU,KEP. SERIBU UTARA,640,0,634,6,0,0,2021-12-10
317203,JAKARTA UTARA,KOJA,17234,1,16893,338,2,3,2021-12-10
317504,JAKARTA TIMUR,KRAMAT JATI,21631,0,21229,402,0,0,2021-12-10
317508,JAKARTA TIMUR,MAKASAR,17482,4,17178,298,2,6,2021-12-10
317407,JAKARTA SELATAN,KEBAYORAN BARU,13889,0,13703,185,1,1,2021-12-10
317306,JAKARTA BARAT,KALI DERES,18031,1,17713,316,1,2,2021-12-10
317105,JAKARTA PUSAT,CEMPAKA PUTIH,10526,1,10356,168,1,2,2021-12-10
317503,JAKARTA TIMUR,JATINEGARA,19581,2,19196,383,0,2,2021-12-10
317506,JAKARTA TIMUR,CAKUNG,22664,2,22245,413,4,6,2021-12-10
317403,JAKARTA SELATAN,MAMPANG PRAPATAN,11511,0,11332,179,0,0,2021-12-10
317409,JAKARTA SELATAN,JAGAKARSA,26612,2,26199,406,5,7,2021-12-10
317302,JAKARTA BARAT,GROGOL PETAMBURAN,19086,2,18784,298,2,4,2021-12-10
317101,JAKARTA PUSAT,GAMBIR,8567,2,8431,134,0,2,2021-12-10
317507,JAKARTA TIMUR,DUREN SAWIT,29477,1,28860,611,5,6,2021-12-10
317509,JAKARTA TIMUR,CIRACAS,22517,0,22136,379,2,2,2021-12-10
317510,JAKARTA TIMUR,CIPAYUNG,25201,3,24928,267,3,6,2021-12-10
317204,JAKARTA UTARA,CILINCING,17433,5,17088,340,0,5,2021-12-10
317406,JAKARTA SELATAN,CILANDAK,17699,1,17436,261,1,2,2021-12-10
317301,JAKARTA BARAT,CENGKARENG,28713,4,28131,559,19,23,2021-12-10
317108,JAKARTA PUSAT,JOHAR BARU,8684,1,8526,157,0,1,2021-12-10
317501,JAKARTA TIMUR,MATRAMAN,14225,0,13946,279,0,0,2021-12-10
317408,JAKARTA SELATAN,PANCORAN,14337,2,14107,227,1,3,2021-12-10
317205,JAKARTA UTARA,PADEMANGAN,12888,1,12723,163,1,2,2021-12-10
317106,JAKARTA PUSAT,MENTENG,6433,0,6314,119,0,0,2021-12-10
111111,Luar DKI & Proses Update,Luar DKI & Proses Update,143008,137,141294,1273,304,441,2021-12-10
317401,JAKARTA SELATAN,TEBET,16954,0,16675,279,0,0,2021-12-10
317202,JAKARTA UTARA,TANJUNG PRIOK,25782,3,25353,425,1,4,2021-12-10
317304,JAKARTA BARAT,TAMBORA,14127,1,13871,253,2,3,2021-12-10
317303,JAKARTA BARAT,TAMAN SARI,8758,1,8615,140,2,3,2021-12-10
317402,JAKARTA SELATAN,SETIA BUDI,12002,0,11818,183,1,1,2021-12-10
317107,JAKARTA PUSAT,TANAH ABANG,11051,0,10826,223,2,2,2021-12-10
317102,JAKARTA PUSAT,SAWAH BESAR,9159,0,8986,172,1,1,2021-12-10
317502,JAKARTA TIMUR,PULO GADUNG,21800,0,21399,401,0,0,2021-12-10
317410,JAKARTA SELATAN,PESANGGRAHAN,16378,1,16125,252,0,1,2021-12-10
317201,JAKARTA UTARA,PENJARINGAN,18642,1,18405,229,7,8,2021-12-10
317505,JAKARTA TIMUR,PASAR REBO,17645,0,17318,326,1,1,2021-12-10
317404,JAKARTA SELATAN,PASAR MINGGU,23835,1,23403,426,5,6,2021-12-10
317307,JAKARTA BARAT,PALMERAH,15837,0,15506,329,2,2,2021-12-10
317104,JAKARTA PUSAT,SENEN,9396,1,9227,168,0,1,2021-12-10
317402,JAKARTA SELATAN,SETIA BUDI,12002,0,11818,183,1,1,2021-12-11
111111,Luar DKI & Proses Update,Luar DKI & Proses Update,143008,137,141294,1273,304,441,2021-12-11
317401,JAKARTA SELATAN,TEBET,16955,1,16675,279,0,1,2021-12-11
317202,JAKARTA UTARA,TANJUNG PRIOK,25782,3,25354,425,0,3,2021-12-11
317107,JAKARTA PUSAT,TANAH ABANG,11051,0,10827,223,1,1,2021-12-11
317304,JAKARTA BARAT,TAMBORA,14127,1,13871,253,2,3,2021-12-11
317303,JAKARTA BARAT,TAMAN SARI,8758,1,8616,140,1,2,2021-12-11
317104,JAKARTA PUSAT,SENEN,9396,1,9227,168,0,1,2021-12-11
317307,JAKARTA BARAT,PALMERAH,15837,0,15506,329,2,2,2021-12-11
317502,JAKARTA TIMUR,PULO GADUNG,21801,0,21399,401,1,1,2021-12-11
317410,JAKARTA SELATAN,PESANGGRAHAN,16378,1,16125,252,0,1,2021-12-11
317201,JAKARTA UTARA,PENJARINGAN,18642,1,18406,229,6,7,2021-12-11
317505,JAKARTA TIMUR,PASAR REBO,17645,0,17318,326,1,1,2021-12-11
317404,JAKARTA SELATAN,PASAR MINGGU,23835,1,23403,426,5,6,2021-12-11
317408,JAKARTA SELATAN,PANCORAN,14338,1,14109,227,1,2,2021-12-11
317205,JAKARTA UTARA,PADEMANGAN,12888,1,12724,163,0,1,2021-12-11
317106,JAKARTA PUSAT,MENTENG,6433,0,6314,119,0,0,2021-12-11
317102,JAKARTA PUSAT,SAWAH BESAR,9159,0,8987,172,0,0,2021-12-11
317501,JAKARTA TIMUR,MATRAMAN,14225,0,13946,279,0,0,2021-12-11
317403,JAKARTA SELATAN,MAMPANG PRAPATAN,11512,0,11332,179,1,1,2021-12-11
317506,JAKARTA TIMUR,CAKUNG,22666,3,22246,413,4,7,2021-12-11
317508,JAKARTA TIMUR,MAKASAR,17482,4,17180,298,0,4,2021-12-11
317504,JAKARTA TIMUR,KRAMAT JATI,21631,0,21229,402,0,0,2021-12-11
310101,KAB.ADM.KEP.SERIBU,KEP. SERIBU UTARA,640,0,634,6,0,0,2021-12-11
310102,KAB.ADM.KEP.SERIBU,KEP. SERIBU SELATAN,704,0,694,10,0,0,2021-12-11
317308,JAKARTA BARAT,KEMBANGAN,20251,2,19945,303,1,3,2021-12-11
317103,JAKARTA PUSAT,KEMAYORAN,19964,4,19585,373,2,6,2021-12-11
317206,JAKARTA UTARA,KELAPA GADING,12650,0,12457,192,1,1,2021-12-11
317305,JAKARTA BARAT,KEBON JERUK,22103,4,21718,375,6,10,2021-12-11
317405,JAKARTA SELATAN,KEBAYORAN LAMA,20058,2,19693,363,0,2,2021-12-11
317407,JAKARTA SELATAN,KEBAYORAN BARU,13889,0,13704,185,0,0,2021-12-11
317306,JAKARTA BARAT,KALI DERES,18032,2,17713,316,1,3,2021-12-11
317203,JAKARTA UTARA,KOJA,17236,3,16893,338,2,5,2021-12-11
317503,JAKARTA TIMUR,JATINEGARA,19582,2,19196,383,1,3,2021-12-11
317108,JAKARTA PUSAT,JOHAR BARU,8686,2,8526,157,1,3,2021-12-11
317105,JAKARTA PUSAT,CEMPAKA PUTIH,10528,1,10356,168,3,4,2021-12-11
317406,JAKARTA SELATAN,CILANDAK,17699,1,17436,261,1,2,2021-12-11
317204,JAKARTA UTARA,CILINCING,17433,5,17088,340,0,5,2021-12-11
317510,JAKARTA TIMUR,CIPAYUNG,25201,3,24929,267,2,5,2021-12-11
317301,JAKARTA BARAT,CENGKARENG,28714,5,28135,559,15,20,2021-12-11
317507,JAKARTA TIMUR,DUREN SAWIT,29479,1,28863,611,4,5,2021-12-11
317101,JAKARTA PUSAT,GAMBIR,8567,2,8431,134,0,2,2021-12-11
317302,JAKARTA BARAT,GROGOL PETAMBURAN,19085,2,18784,298,1,3,2021-12-11
317409,JAKARTA SELATAN,JAGAKARSA,26615,4,26201,406,4,8,2021-12-11
317509,JAKARTA TIMUR,CIRACAS,22518,1,22136,379,2,3,2021-12-11
317501,JAKARTA TIMUR,MATRAMAN,14225,0,13946,279,0,0,2021-12-12
317201,JAKARTA UTARA,PENJARINGAN,18643,1,18409,229,4,5,2021-12-12
317106,JAKARTA PUSAT,MENTENG,6433,0,6314,119,0,0,2021-12-12
317205,JAKARTA UTARA,PADEMANGAN,12889,1,12724,163,1,2,2021-12-12
317307,JAKARTA BARAT,PALMERAH,15837,0,15506,329,2,2,2021-12-12
317408,JAKARTA SELATAN,PANCORAN,14339,1,14109,227,2,3,2021-12-12
317404,JAKARTA SELATAN,PASAR MINGGU,23836,2,23407,426,1,3,2021-12-12
317505,JAKARTA TIMUR,PASAR REBO,17645,0,17318,326,1,1,2021-12-12
317410,JAKARTA SELATAN,PESANGGRAHAN,16378,1,16125,252,0,1,2021-12-12
317304,JAKARTA BARAT,TAMBORA,14128,1,13872,253,2,3,2021-12-12
317102,JAKARTA PUSAT,SAWAH BESAR,9159,0,8987,172,0,0,2021-12-12
317104,JAKARTA PUSAT,SENEN,9396,1,9227,168,0,1,2021-12-12
317402,JAKARTA SELATAN,SETIA BUDI,12003,0,11818,183,2,2,2021-12-12
317303,JAKARTA BARAT,TAMAN SARI,8757,1,8616,140,0,1,2021-12-12
317107,JAKARTA PUSAT,TANAH ABANG,11051,0,10827,223,1,1,2021-12-12
317202,JAKARTA UTARA,TANJUNG PRIOK,25783,2,25355,425,1,3,2021-12-12
317401,JAKARTA SELATAN,TEBET,16955,0,16675,279,1,1,2021-12-12
111111,Luar DKI & Proses Update,Luar DKI & Proses Update,143008,137,141294,1273,304,441,2021-12-12
317403,JAKARTA SELATAN,MAMPANG PRAPATAN,11515,0,11332,179,4,4,2021-12-12
317502,JAKARTA TIMUR,PULO GADUNG,21802,1,21399,401,1,2,2021-12-12
317508,JAKARTA TIMUR,MAKASAR,17483,4,17180,298,1,5,2021-12-12
310101,KAB.ADM.KEP.SERIBU,KEP. SERIBU UTARA,640,0,634,6,0,0,2021-12-12
317203,JAKARTA UTARA,KOJA,17237,4,16894,338,1,5,2021-12-12
317506,JAKARTA TIMUR,CAKUNG,22666,3,22247,413,3,6,2021-12-12
317105,JAKARTA PUSAT,CEMPAKA PUTIH,10530,1,10356,168,5,6,2021-12-12
317504,JAKARTA TIMUR,KRAMAT JATI,21631,0,21229,402,0,0,2021-12-12
317406,JAKARTA SELATAN,CILANDAK,17699,1,17437,261,0,1,2021-12-12
317204,JAKARTA UTARA,CILINCING,17434,5,17088,340,1,6,2021-12-12
317510,JAKARTA TIMUR,CIPAYUNG,25201,3,24929,267,2,5,2021-12-12
317509,JAKARTA TIMUR,CIRACAS,22518,1,22136,379,2,3,2021-12-12
317507,JAKARTA TIMUR,DUREN SAWIT,29479,1,28864,611,3,4,2021-12-12
317101,JAKARTA PUSAT,GAMBIR,8567,2,8431,134,0,2,2021-12-12
317302,JAKARTA BARAT,GROGOL PETAMBURAN,19085,1,18785,298,1,2,2021-12-12
317409,JAKARTA SELATAN,JAGAKARSA,26617,4,26201,406,6,10,2021-12-12
317301,JAKARTA BARAT,CENGKARENG,28714,4,28136,559,15,19,2021-12-12
317108,JAKARTA PUSAT,JOHAR BARU,8686,2,8526,157,1,3,2021-12-12
317503,JAKARTA TIMUR,JATINEGARA,19582,2,19196,383,1,3,2021-12-12
317308,JAKARTA BARAT,KEMBANGAN,20250,1,19945,303,1,2,2021-12-12
317103,JAKARTA PUSAT,KEMAYORAN,19964,3,19586,373,2,5,2021-12-12
317206,JAKARTA UTARA,KELAPA GADING,12652,2,12458,192,0,2,2021-12-12
310102,KAB.ADM.KEP.SERIBU,KEP. SERIBU SELATAN,704,0,694,10,0,0,2021-12-12
317405,JAKARTA SELATAN,KEBAYORAN LAMA,20058,1,19693,363,1,2,2021-12-12
317407,JAKARTA SELATAN,KEBAYORAN BARU,13889,0,13704,185,0,0,2021-12-12
317306,JAKARTA BARAT,KALI DERES,18032,2,17713,316,1,3,2021-12-12
317305,JAKARTA BARAT,KEBON JERUK,22103,4,21718,375,6,10,2021-12-12
317106,JAKARTA PUSAT,MENTENG,6433,0,6314,119,0,0,2021-12-13
317410,JAKARTA SELATAN,PESANGGRAHAN,16379,1,16126,252,0,1,2021-12-13
317205,JAKARTA UTARA,PADEMANGAN,12889,1,12724,163,1,2,2021-12-13
317307,JAKARTA BARAT,PALMERAH,15837,0,15507,329,1,1,2021-12-13
317408,JAKARTA SELATAN,PANCORAN,14339,1,14109,227,2,3,2021-12-13
317404,JAKARTA SELATAN,PASAR MINGGU,23836,2,23407,426,1,3,2021-12-13
317505,JAKARTA TIMUR,PASAR REBO,17645,0,17319,326,0,0,2021-12-13
317201,JAKARTA UTARA,PENJARINGAN,18643,1,18409,229,4,5,2021-12-13
317502,JAKARTA TIMUR,PULO GADUNG,21802,1,21399,401,1,2,2021-12-13
317304,JAKARTA BARAT,TAMBORA,14127,1,13872,253,1,2,2021-12-13
317104,JAKARTA PUSAT,SENEN,9395,0,9227,168,0,0,2021-12-13
317402,JAKARTA SELATAN,SETIA BUDI,12002,0,11818,183,1,1,2021-12-13
317303,JAKARTA BARAT,TAMAN SARI,8757,1,8616,140,0,1,2021-12-13
317107,JAKARTA PUSAT,TANAH ABANG,11051,0,10827,223,1,1,2021-12-13
317202,JAKARTA UTARA,TANJUNG PRIOK,25783,2,25355,425,1,3,2021-12-13
317401,JAKARTA SELATAN,TEBET,16956,1,16675,279,1,2,2021-12-13
317403,JAKARTA SELATAN,MAMPANG PRAPATAN,11511,0,11332,179,0,0,2021-12-13
111111,Luar DKI & Proses Update,Luar DKI & Proses Update,143008,137,141294,1273,304,441,2021-12-13
317102,JAKARTA PUSAT,SAWAH BESAR,9159,0,8987,172,0,0,2021-12-13
317508,JAKARTA TIMUR,MAKASAR,17483,4,17180,298,1,5,2021-12-13
317501,JAKARTA TIMUR,MATRAMAN,14226,1,13946,279,0,1,2021-12-13
317203,JAKARTA UTARA,KOJA,17237,4,16894,338,1,5,2021-12-13
317504,JAKARTA TIMUR,KRAMAT JATI,21631,0,21229,402,0,0,2021-12-13
317406,JAKARTA SELATAN,CILANDAK,17699,1,17437,261,0,1,2021-12-13
317105,JAKARTA PUSAT,CEMPAKA PUTIH,10529,1,10356,168,4,5,2021-12-13
317506,JAKARTA TIMUR,CAKUNG,22666,2,22249,413,2,4,2021-12-13
317204,JAKARTA UTARA,CILINCING,17433,4,17088,340,1,5,2021-12-13
317510,JAKARTA TIMUR,CIPAYUNG,25201,1,24931,267,2,3,2021-12-13
317509,JAKARTA TIMUR,CIRACAS,22518,0,22137,379,2,2,2021-12-13
317507,JAKARTA TIMUR,DUREN SAWIT,29478,1,28864,611,2,3,2021-12-13
317101,JAKARTA PUSAT,GAMBIR,8566,0,8432,134,0,0,2021-12-13
317302,JAKARTA BARAT,GROGOL PETAMBURAN,19085,1,18786,298,0,1,2021-12-13
317409,JAKARTA SELATAN,JAGAKARSA,26616,3,26201,406,6,9,2021-12-13
317301,JAKARTA BARAT,CENGKARENG,28714,3,28148,559,4,7,2021-12-13
317108,JAKARTA PUSAT,JOHAR BARU,8685,2,8526,157,0,2,2021-12-13
317306,JAKARTA BARAT,KALI DERES,18032,2,17714,316,0,2,2021-12-13
317407,JAKARTA SELATAN,KEBAYORAN BARU,13889,0,13704,185,0,0,2021-12-13
317405,JAKARTA SELATAN,KEBAYORAN LAMA,20059,1,19693,363,2,3,2021-12-13
317305,JAKARTA BARAT,KEBON JERUK,22103,4,21718,375,6,10,2021-12-13
317206,JAKARTA UTARA,KELAPA GADING,12652,2,12458,192,0,2,2021-12-13
317103,JAKARTA PUSAT,KEMAYORAN,19964,4,19586,373,1,5,2021-12-13
317308,JAKARTA BARAT,KEMBANGAN,20250,1,19946,303,0,1,2021-12-13
310102,KAB.ADM.KEP.SERIBU,KEP. SERIBU SELATAN,704,0,694,10,0,0,2021-12-13
310101,KAB.ADM.KEP.SERIBU,KEP. SERIBU UTARA,640,0,634,6,0,0,2021-12-13
317503,JAKARTA TIMUR,JATINEGARA,19583,3,19196,383,1,4,2021-12-13
317505,JAKARTA TIMUR,PASAR REBO,17645,0,17319,326,0,0,2021-12-14
317404,JAKARTA SELATAN,PASAR MINGGU,23836,2,23408,426,0,2,2021-12-14
317408,JAKARTA SELATAN,PANCORAN,14340,1,14109,227,3,4,2021-12-14
317501,JAKARTA TIMUR,MATRAMAN,14226,1,13946,279,0,1,2021-12-14
317205,JAKARTA UTARA,PADEMANGAN,12889,1,12724,163,1,2,2021-12-14
317106,JAKARTA PUSAT,MENTENG,6433,0,6314,119,0,0,2021-12-14
317201,JAKARTA UTARA,PENJARINGAN,18643,1,18409,229,4,5,2021-12-14
317307,JAKARTA BARAT,PALMERAH,15838,0,15507,329,2,2,2021-12-14
317410,JAKARTA SELATAN,PESANGGRAHAN,16378,0,16126,252,0,0,2021-12-14
317304,JAKARTA BARAT,TAMBORA,14127,0,13874,253,0,0,2021-12-14
317102,JAKARTA PUSAT,SAWAH BESAR,9159,0,8987,172,0,0,2021-12-14
317104,JAKARTA PUSAT,SENEN,9395,0,9227,168,0,0,2021-12-14
317402,JAKARTA SELATAN,SETIA BUDI,12002,0,11818,183,1,1,2021-12-14
317303,JAKARTA BARAT,TAMAN SARI,8757,1,8616,140,0,1,2021-12-14
317107,JAKARTA PUSAT,TANAH ABANG,11051,0,10827,223,1,1,2021-12-14
317202,JAKARTA UTARA,TANJUNG PRIOK,25783,2,25355,425,1,3,2021-12-14
317401,JAKARTA SELATAN,TEBET,16956,1,16675,279,1,2,2021-12-14
111111,Luar DKI & Proses Update,Luar DKI & Proses Update,143008,137,141294,1273,304,441,2021-12-14
317403,JAKARTA SELATAN,MAMPANG PRAPATAN,11511,0,11332,179,0,0,2021-12-14
317502,JAKARTA TIMUR,PULO GADUNG,21802,1,21399,401,1,2,2021-12-14
317508,JAKARTA TIMUR,MAKASAR,17482,4,17180,298,0,4,2021-12-14
310101,KAB.ADM.KEP.SERIBU,KEP. SERIBU UTARA,640,0,634,6,0,0,2021-12-14
317203,JAKARTA UTARA,KOJA,17237,4,16895,338,0,4,2021-12-14
317504,JAKARTA TIMUR,KRAMAT JATI,21631,0,21229,402,0,0,2021-12-14
317105,JAKARTA PUSAT,CEMPAKA PUTIH,10529,0,10357,168,4,4,2021-12-14
317506,JAKARTA TIMUR,CAKUNG,22666,1,22250,413,2,3,2021-12-14
317204,JAKARTA UTARA,CILINCING,17433,2,17090,340,1,3,2021-12-14
317510,JAKARTA TIMUR,CIPAYUNG,25202,1,24932,267,2,3,2021-12-14
317509,JAKARTA TIMUR,CIRACAS,22518,0,22137,379,2,2,2021-12-14
317507,JAKARTA TIMUR,DUREN SAWIT,29478,0,28865,611,2,2,2021-12-14
317101,JAKARTA PUSAT,GAMBIR,8566,0,8432,134,0,0,2021-12-14
317302,JAKARTA BARAT,GROGOL PETAMBURAN,19085,0,18787,298,0,0,2021-12-14
317409,JAKARTA SELATAN,JAGAKARSA,26615,1,26203,406,5,6,2021-12-14
317301,JAKARTA BARAT,CENGKARENG,28716,3,28148,559,6,9,2021-12-14
317108,JAKARTA PUSAT,JOHAR BARU,8685,2,8526,157,0,2,2021-12-14
317503,JAKARTA TIMUR,JATINEGARA,19582,2,19196,383,1,3,2021-12-14
310102,KAB.ADM.KEP.SERIBU,KEP. SERIBU SELATAN,704,0,694,10,0,0,2021-12-14
317308,JAKARTA BARAT,KEMBANGAN,20250,1,19946,303,0,1,2021-12-14
317103,JAKARTA PUSAT,KEMAYORAN,19964,4,19586,373,1,5,2021-12-14
317406,JAKARTA SELATAN,CILANDAK,17699,1,17437,261,0,1,2021-12-14
317305,JAKARTA BARAT,KEBON JERUK,22103,1,21722,375,5,6,2021-12-14
317405,JAKARTA SELATAN,KEBAYORAN LAMA,20059,0,19694,363,2,2,2021-12-14
317407,JAKARTA SELATAN,KEBAYORAN BARU,13889,0,13704,185,0,0,2021-12-14
317306,JAKARTA BARAT,KALI DERES,18032,2,17714,316,0,2,2021-12-14
317206,JAKARTA UTARA,KELAPA GADING,12652,2,12458,192,0,2,2021-12-14
317501,JAKARTA TIMUR,MATRAMAN,14227,1,13946,279,1,2,2021-12-15
317106,JAKARTA PUSAT,MENTENG,6433,0,6314,119,0,0,2021-12-15
317205,JAKARTA UTARA,PADEMANGAN,12889,1,12724,163,1,2,2021-12-15
317307,JAKARTA BARAT,PALMERAH,15837,0,15507,329,1,1,2021-12-15
317408,JAKARTA SELATAN,PANCORAN,14338,0,14109,227,2,2,2021-12-15
317404,JAKARTA SELATAN,PASAR MINGGU,23837,3,23408,426,0,3,2021-12-15
317505,JAKARTA TIMUR,PASAR REBO,17645,0,17319,326,0,0,2021-12-15
317201,JAKARTA UTARA,PENJARINGAN,18644,2,18409,229,4,6,2021-12-15
317410,JAKARTA SELATAN,PESANGGRAHAN,16378,0,16126,252,0,0,2021-12-15
317102,JAKARTA PUSAT,SAWAH BESAR,9159,0,8987,172,0,0,2021-12-15
317104,JAKARTA PUSAT,SENEN,9395,0,9227,168,0,0,2021-12-15
317402,JAKARTA SELATAN,SETIA BUDI,12002,0,11818,183,1,1,2021-12-15
317304,JAKARTA BARAT,TAMBORA,14128,0,13874,253,1,1,2021-12-15
317107,JAKARTA PUSAT,TANAH ABANG,11050,0,10827,223,0,0,2021-12-15
317202,JAKARTA UTARA,TANJUNG PRIOK,25784,2,25355,425,2,4,2021-12-15
317401,JAKARTA SELATAN,TEBET,16956,1,16675,279,1,2,2021-12-15
111111,Luar DKI & Proses Update,Luar DKI & Proses Update,143008,137,141294,1273,304,441,2021-12-15
317403,JAKARTA SELATAN,MAMPANG PRAPATAN,11511,0,11332,179,0,0,2021-12-15
317502,JAKARTA TIMUR,PULO GADUNG,21802,1,21399,401,1,2,2021-12-15
317303,JAKARTA BARAT,TAMAN SARI,8757,1,8616,140,0,1,2021-12-15
317504,JAKARTA TIMUR,KRAMAT JATI,21631,0,21229,402,0,0,2021-12-15
317203,JAKARTA UTARA,KOJA,17237,4,16895,338,0,4,2021-12-15
317301,JAKARTA BARAT,CENGKARENG,28716,3,28148,559,6,9,2021-12-15
317105,JAKARTA PUSAT,CEMPAKA PUTIH,10529,0,10357,168,4,4,2021-12-15
317506,JAKARTA TIMUR,CAKUNG,22666,1,22250,413,2,3,2021-12-15
317204,JAKARTA UTARA,CILINCING,17433,1,17091,340,1,2,2021-12-15
317510,JAKARTA TIMUR,CIPAYUNG,25202,0,24933,267,2,2,2021-12-15
317509,JAKARTA TIMUR,CIRACAS,22517,0,22137,379,1,1,2021-12-15
317507,JAKARTA TIMUR,DUREN SAWIT,29479,1,28865,611,2,3,2021-12-15
317101,JAKARTA PUSAT,GAMBIR,8566,0,8432,134,0,0,2021-12-15
317302,JAKARTA BARAT,GROGOL PETAMBURAN,19086,0,18788,298,0,0,2021-12-15
317409,JAKARTA SELATAN,JAGAKARSA,26614,1,26203,406,4,5,2021-12-15
317406,JAKARTA SELATAN,CILANDAK,17701,1,17437,261,2,3,2021-12-15
317108,JAKARTA PUSAT,JOHAR BARU,8686,2,8526,157,1,3,2021-12-15
317503,JAKARTA TIMUR,JATINEGARA,19582,1,19197,383,1,2,2021-12-15
310101,KAB.ADM.KEP.SERIBU,KEP. SERIBU UTARA,640,0,634,6,0,0,2021-12-15
310102,KAB.ADM.KEP.SERIBU,KEP. SERIBU SELATAN,704,0,694,10,0,0,2021-12-15
317308,JAKARTA BARAT,KEMBANGAN,20250,0,19947,303,0,0,2021-12-15
317103,JAKARTA PUSAT,KEMAYORAN,19964,4,19586,373,1,5,2021-12-15
317508,JAKARTA TIMUR,MAKASAR,17482,3,17181,298,0,3,2021-12-15
317305,JAKARTA BARAT,KEBON JERUK,22103,1,21723,375,4,5,2021-12-15
317405,JAKARTA SELATAN,KEBAYORAN LAMA,20059,0,19695,363,1,1,2021-12-15
317407,JAKARTA SELATAN,KEBAYORAN BARU,13889,0,13704,185,0,0,2021-12-15
317306,JAKARTA BARAT,KALI DERES,18032,2,17714,316,0,2,2021-12-15
317206,JAKARTA UTARA,KELAPA GADING,12652,2,12458,192,0,2,2021-12-15
111111,Luar DKI & Proses Update,Luar DKI & Proses Update,143008,137,141294,1273,304,441,2021-12-16
317501,JAKARTA TIMUR,MATRAMAN,14227,1,13946,279,1,2,2021-12-16
317106,JAKARTA PUSAT,MENTENG,6434,0,6314,119,1,1,2021-12-16
317205,JAKARTA UTARA,PADEMANGAN,12889,0,12725,163,1,1,2021-12-16
317307,JAKARTA BARAT,PALMERAH,15838,0,15508,329,1,1,2021-12-16
317408,JAKARTA SELATAN,PANCORAN,14338,0,14109,227,2,2,2021-12-16
317404,JAKARTA SELATAN,PASAR MINGGU,23837,2,23409,426,0,2,2021-12-16
317505,JAKARTA TIMUR,PASAR REBO,17645,0,17319,326,0,0,2021-12-16
317201,JAKARTA UTARA,PENJARINGAN,18644,2,18412,229,1,3,2021-12-16
317102,JAKARTA PUSAT,SAWAH BESAR,9159,0,8987,172,0,0,2021-12-16
317502,JAKARTA TIMUR,PULO GADUNG,21804,2,21399,401,2,4,2021-12-16
317104,JAKARTA PUSAT,SENEN,9395,0,9227,168,0,0,2021-12-16
317402,JAKARTA SELATAN,SETIA BUDI,12002,0,11819,183,0,0,2021-12-16
317303,JAKARTA BARAT,TAMAN SARI,8757,0,8617,140,0,0,2021-12-16
317107,JAKARTA PUSAT,TANAH ABANG,11050,0,10827,223,0,0,2021-12-16
317202,JAKARTA UTARA,TANJUNG PRIOK,25784,2,25355,425,2,4,2021-12-16
317401,JAKARTA SELATAN,TEBET,16956,1,16675,279,1,2,2021-12-16
317403,JAKARTA SELATAN,MAMPANG PRAPATAN,11511,0,11332,179,0,0,2021-12-16
317410,JAKARTA SELATAN,PESANGGRAHAN,16378,0,16126,252,0,0,2021-12-16
317304,JAKARTA BARAT,TAMBORA,14128,0,13874,253,1,1,2021-12-16
317508,JAKARTA TIMUR,MAKASAR,17482,3,17181,298,0,3,2021-12-16
317203,JAKARTA UTARA,KOJA,17237,4,16895,338,0,4,2021-12-16
317506,JAKARTA TIMUR,CAKUNG,22666,1,22251,413,1,2,2021-12-16
317105,JAKARTA PUSAT,CEMPAKA PUTIH,10529,0,10357,168,4,4,2021-12-16
317406,JAKARTA SELATAN,CILANDAK,17701,1,17437,261,2,3,2021-12-16
317204,JAKARTA UTARA,CILINCING,17433,1,17091,340,1,2,2021-12-16
317504,JAKARTA TIMUR,KRAMAT JATI,21632,1,21229,402,0,1,2021-12-16
317510,JAKARTA TIMUR,CIPAYUNG,25202,0,24933,267,2,2,2021-12-16
317509,JAKARTA TIMUR,CIRACAS,22517,0,22137,379,1,1,2021-12-16
317507,JAKARTA TIMUR,DUREN SAWIT,29479,1,28865,611,2,3,2021-12-16
317101,JAKARTA PUSAT,GAMBIR,8567,1,8432,134,0,1,2021-12-16
317302,JAKARTA BARAT,GROGOL PETAMBURAN,19086,0,18788,298,0,0,2021-12-16
317409,JAKARTA SELATAN,JAGAKARSA,26614,0,26204,406,4,4,2021-12-16
317301,JAKARTA BARAT,CENGKARENG,28722,2,28149,559,12,14,2021-12-16
317108,JAKARTA PUSAT,JOHAR BARU,8686,2,8526,157,1,3,2021-12-16
317306,JAKARTA BARAT,KALI DERES,18034,3,17714,316,1,4,2021-12-16
317407,JAKARTA SELATAN,KEBAYORAN BARU,13889,0,13704,185,0,0,2021-12-16
317405,JAKARTA SELATAN,KEBAYORAN LAMA,20059,0,19695,363,1,1,2021-12-16
317305,JAKARTA BARAT,KEBON JERUK,22102,2,21722,375,3,5,2021-12-16
310101,KAB.ADM.KEP.SERIBU,KEP. SERIBU UTARA,640,0,634,6,0,0,2021-12-16
317503,JAKARTA TIMUR,JATINEGARA,19583,0,19198,383,2,2,2021-12-16
317206,JAKARTA UTARA,KELAPA GADING,12652,2,12458,192,0,2,2021-12-16
317103,JAKARTA PUSAT,KEMAYORAN,19964,2,19588,373,1,3,2021-12-16
310102,KAB.ADM.KEP.SERIBU,KEP. SERIBU SELATAN,704,0,694,10,0,0,2021-12-16
317308,JAKARTA BARAT,KEMBANGAN,20252,0,19947,303,2,2,2021-12-16
317305,JAKARTA BARAT,KEBON JERUK,22102,0,21724,375,3,3,2021-12-17
317405,JAKARTA SELATAN,KEBAYORAN LAMA,20060,1,19695,363,1,2,2021-12-17
317306,JAKARTA BARAT,KALI DERES,18034,3,17714,316,1,4,2021-12-17
317407,JAKARTA SELATAN,KEBAYORAN BARU,13889,0,13704,185,0,0,2021-12-17
111111,Luar DKI & Proses Update,Luar DKI & Proses Update,143008,137,141294,1273,304,441,2021-12-17
317108,JAKARTA PUSAT,JOHAR BARU,8687,3,8526,157,1,4,2021-12-17
317302,JAKARTA BARAT,GROGOL PETAMBURAN,19087,1,18788,298,0,1,2021-12-17
317409,JAKARTA SELATAN,JAGAKARSA,26614,0,26204,406,4,4,2021-12-17
317101,JAKARTA PUSAT,GAMBIR,8568,1,8432,134,1,2,2021-12-17
317507,JAKARTA TIMUR,DUREN SAWIT,29479,1,28865,611,2,3,2021-12-17
317509,JAKARTA TIMUR,CIRACAS,22517,0,22138,379,0,0,2021-12-17
317510,JAKARTA TIMUR,CIPAYUNG,25202,0,24934,267,1,1,2021-12-17
317204,JAKARTA UTARA,CILINCING,17433,0,17092,340,1,1,2021-12-17
317406,JAKARTA SELATAN,CILANDAK,17701,0,17438,261,2,2,2021-12-17
317105,JAKARTA PUSAT,CEMPAKA PUTIH,10531,0,10357,168,6,6,2021-12-17
317506,JAKARTA TIMUR,CAKUNG,22666,1,22251,413,1,2,2021-12-17
317503,JAKARTA TIMUR,JATINEGARA,19583,0,19198,383,2,2,2021-12-17
317301,JAKARTA BARAT,CENGKARENG,28725,2,28150,559,14,16,2021-12-17
317206,JAKARTA UTARA,KELAPA GADING,12652,2,12458,192,0,2,2021-12-17
317107,JAKARTA PUSAT,TANAH ABANG,11051,0,10827,223,1,1,2021-12-17
317401,JAKARTA SELATAN,TEBET,16956,1,16675,279,1,2,2021-12-17
317202,JAKARTA UTARA,TANJUNG PRIOK,25783,0,25356,425,2,2,2021-12-17
317304,JAKARTA BARAT,TAMBORA,14130,0,13874,253,3,3,2021-12-17
317303,JAKARTA BARAT,TAMAN SARI,8757,0,8617,140,0,0,2021-12-17
317402,JAKARTA SELATAN,SETIA BUDI,12002,0,11819,183,0,0,2021-12-17
317104,JAKARTA PUSAT,SENEN,9395,0,9227,168,0,0,2021-12-17
317102,JAKARTA PUSAT,SAWAH BESAR,9161,2,8987,172,0,2,2021-12-17
317502,JAKARTA TIMUR,PULO GADUNG,21803,1,21399,401,2,3,2021-12-17
317201,JAKARTA UTARA,PENJARINGAN,18644,1,18413,229,1,2,2021-12-17
317505,JAKARTA TIMUR,PASAR REBO,17645,0,17319,326,0,0,2021-12-17
317404,JAKARTA SELATAN,PASAR MINGGU,23837,2,23409,426,0,2,2021-12-17
317408,JAKARTA SELATAN,PANCORAN,14338,0,14109,227,2,2,2021-12-17
317410,JAKARTA SELATAN,PESANGGRAHAN,16378,0,16126,252,0,0,2021-12-17
317205,JAKARTA UTARA,PADEMANGAN,12888,0,12725,163,0,0,2021-12-17
317106,JAKARTA PUSAT,MENTENG,6434,0,6314,119,1,1,2021-12-17
317501,JAKARTA TIMUR,MATRAMAN,14227,1,13946,279,1,2,2021-12-17
317403,JAKARTA SELATAN,MAMPANG PRAPATAN,11512,0,11332,179,1,1,2021-12-17
317508,JAKARTA TIMUR,MAKASAR,17482,1,17183,298,0,1,2021-12-17
317504,JAKARTA TIMUR,KRAMAT JATI,21632,1,21229,402,0,1,2021-12-17
317203,JAKARTA UTARA,KOJA,17237,4,16895,338,0,4,2021-12-17
310101,KAB.ADM.KEP.SERIBU,KEP. SERIBU UTARA,640,0,634,6,0,0,2021-12-17
310102,KAB.ADM.KEP.SERIBU,KEP. SERIBU SELATAN,704,0,694,10,0,0,2021-12-17
317307,JAKARTA BARAT,PALMERAH,15838,0,15508,329,1,1,2021-12-17
317308,JAKARTA BARAT,KEMBANGAN,20252,0,19947,303,2,2,2021-12-17
317103,JAKARTA PUSAT,KEMAYORAN,19965,1,19589,373,2,3,2021-12-17
317404,JAKARTA SELATAN,PASAR MINGGU,23838,3,23409,426,0,3,2021-12-18
317408,JAKARTA SELATAN,PANCORAN,14338,0,14110,227,1,1,2021-12-18
317307,JAKARTA BARAT,PALMERAH,15838,0,15508,329,1,1,2021-12-18
317205,JAKARTA UTARA,PADEMANGAN,12922,34,12725,163,0,34,2021-12-18
317508,JAKARTA TIMUR,MAKASAR,17482,0,17184,298,0,0,2021-12-18
317501,JAKARTA TIMUR,MATRAMAN,14227,1,13946,279,1,2,2021-12-18
317403,JAKARTA SELATAN,MAMPANG PRAPATAN,11512,0,11332,179,1,1,2021-12-18
317505,JAKARTA TIMUR,PASAR REBO,17646,0,17319,326,1,1,2021-12-18
317106,JAKARTA PUSAT,MENTENG,6434,0,6314,119,1,1,2021-12-18
317201,JAKARTA UTARA,PENJARINGAN,18646,1,18413,229,3,4,2021-12-18
317107,JAKARTA PUSAT,TANAH ABANG,11051,0,10827,223,1,1,2021-12-18
317502,JAKARTA TIMUR,PULO GADUNG,21803,1,21400,401,1,2,2021-12-18
317102,JAKARTA PUSAT,SAWAH BESAR,9161,2,8987,172,0,2,2021-12-18
317104,JAKARTA PUSAT,SENEN,9395,0,9227,168,0,0,2021-12-18
317402,JAKARTA SELATAN,SETIA BUDI,12002,0,11819,183,0,0,2021-12-18
317303,JAKARTA BARAT,TAMAN SARI,8757,0,8617,140,0,0,2021-12-18
317304,JAKARTA BARAT,TAMBORA,14131,0,13874,253,4,4,2021-12-18
111111,Luar DKI & Proses Update,Luar DKI & Proses Update,143008,137,141294,1273,304,441,2021-12-18
317202,JAKARTA UTARA,TANJUNG PRIOK,25783,0,25356,425,2,2,2021-12-18
317401,JAKARTA SELATAN,TEBET,16956,1,16675,279,1,2,2021-12-18
317504,JAKARTA TIMUR,KRAMAT JATI,21632,1,21229,402,0,1,2021-12-18
317410,JAKARTA SELATAN,PESANGGRAHAN,16378,0,16126,252,0,0,2021-12-18
317203,JAKARTA UTARA,KOJA,17237,2,16897,338,0,2,2021-12-18
317308,JAKARTA BARAT,KEMBANGAN,20252,0,19947,303,2,2,2021-12-18
310102,KAB.ADM.KEP.SERIBU,KEP. SERIBU SELATAN,704,0,694,10,0,0,2021-12-18
310101,KAB.ADM.KEP.SERIBU,KEP. SERIBU UTARA,640,0,634,6,0,0,2021-12-18
317506,JAKARTA TIMUR,CAKUNG,22666,0,22253,413,0,0,2021-12-18
317105,JAKARTA PUSAT,CEMPAKA PUTIH,10531,0,10358,168,5,5,2021-12-18
317301,JAKARTA BARAT,CENGKARENG,28726,3,28150,559,14,17,2021-12-18
317406,JAKARTA SELATAN,CILANDAK,17702,0,17438,261,3,3,2021-12-18
317204,JAKARTA UTARA,CILINCING,17433,0,17092,340,1,1,2021-12-18
317509,JAKARTA TIMUR,CIRACAS,22518,0,22138,379,1,1,2021-12-18
317507,JAKARTA TIMUR,DUREN SAWIT,29479,1,28867,611,0,1,2021-12-18
317101,JAKARTA PUSAT,GAMBIR,8566,0,8432,134,0,0,2021-12-18
317302,JAKARTA BARAT,GROGOL PETAMBURAN,19087,0,18788,298,1,1,2021-12-18
317510,JAKARTA TIMUR,CIPAYUNG,25202,0,24934,267,1,1,2021-12-18
317503,JAKARTA TIMUR,JATINEGARA,19585,0,19199,383,3,3,2021-12-18
317108,JAKARTA PUSAT,JOHAR BARU,8687,2,8527,157,1,3,2021-12-18
317306,JAKARTA BARAT,KALI DERES,18034,3,17714,316,1,4,2021-12-18
317407,JAKARTA SELATAN,KEBAYORAN BARU,13889,0,13704,185,0,0,2021-12-18
317405,JAKARTA SELATAN,KEBAYORAN LAMA,20060,1,19695,363,1,2,2021-12-18
317305,JAKARTA BARAT,KEBON JERUK,22102,0,21725,375,2,2,2021-12-18
317206,JAKARTA UTARA,KELAPA GADING,12652,2,12458,192,0,2,2021-12-18
317103,JAKARTA PUSAT,KEMAYORAN,19965,1,19590,373,1,2,2021-12-18
317409,JAKARTA SELATAN,JAGAKARSA,26614,0,26206,406,2,2,2021-12-18
317505,JAKARTA TIMUR,PASAR REBO,17646,0,17319,326,1,1,2021-12-19
317404,JAKARTA SELATAN,PASAR MINGGU,23838,3,23409,426,0,3,2021-12-19
317408,JAKARTA SELATAN,PANCORAN,14339,0,14110,227,2,2,2021-12-19
317307,JAKARTA BARAT,PALMERAH,15838,0,15508,329,1,1,2021-12-19
317403,JAKARTA SELATAN,MAMPANG PRAPATAN,11513,1,11332,179,1,2,2021-12-19
317106,JAKARTA PUSAT,MENTENG,6434,0,6314,119,1,1,2021-12-19
317501,JAKARTA TIMUR,MATRAMAN,14227,1,13946,279,1,2,2021-12-19
317201,JAKARTA UTARA,PENJARINGAN,18646,1,18413,229,3,4,2021-12-19
317205,JAKARTA UTARA,PADEMANGAN,12934,41,12730,163,0,41,2021-12-19
317410,JAKARTA SELATAN,PESANGGRAHAN,16378,0,16126,252,0,0,2021-12-19
111111,Luar DKI & Proses Update,Luar DKI & Proses Update,143008,137,141294,1273,304,441,2021-12-19
317102,JAKARTA PUSAT,SAWAH BESAR,9161,2,8987,172,0,2,2021-12-19
317104,JAKARTA PUSAT,SENEN,9395,0,9227,168,0,0,2021-12-19
317402,JAKARTA SELATAN,SETIA BUDI,12002,0,11819,183,0,0,2021-12-19
317303,JAKARTA BARAT,TAMAN SARI,8757,0,8617,140,0,0,2021-12-19
317304,JAKARTA BARAT,TAMBORA,14131,0,13874,253,4,4,2021-12-19
317107,JAKARTA PUSAT,TANAH ABANG,11051,0,10827,223,1,1,2021-12-19
317202,JAKARTA UTARA,TANJUNG PRIOK,25783,0,25357,425,1,1,2021-12-19
317401,JAKARTA SELATAN,TEBET,16956,0,16676,279,1,1,2021-12-19
317508,JAKARTA TIMUR,MAKASAR,17482,0,17184,298,0,0,2021-12-19
317502,JAKARTA TIMUR,PULO GADUNG,21803,1,21400,401,1,2,2021-12-19
317504,JAKARTA TIMUR,KRAMAT JATI,21632,1,21229,402,0,1,2021-12-19
317308,JAKARTA BARAT,KEMBANGAN,20253,0,19947,303,3,3,2021-12-19
310101,KAB.ADM.KEP.SERIBU,KEP. SERIBU UTARA,640,0,634,6,0,0,2021-12-19
317203,JAKARTA UTARA,KOJA,17237,0,16899,338,0,0,2021-12-19
317105,JAKARTA PUSAT,CEMPAKA PUTIH,10531,0,10358,168,5,5,2021-12-19
317301,JAKARTA BARAT,CENGKARENG,28726,2,28155,559,10,12,2021-12-19
317406,JAKARTA SELATAN,CILANDAK,17702,0,17438,261,3,3,2021-12-19
317204,JAKARTA UTARA,CILINCING,17433,0,17092,340,1,1,2021-12-19
317510,JAKARTA TIMUR,CIPAYUNG,25202,0,24934,267,1,1,2021-12-19
317509,JAKARTA TIMUR,CIRACAS,22519,0,22138,379,2,2,2021-12-19
317507,JAKARTA TIMUR,DUREN SAWIT,29479,1,28867,611,0,1,2021-12-19
317101,JAKARTA PUSAT,GAMBIR,8566,0,8432,134,0,0,2021-12-19
317302,JAKARTA BARAT,GROGOL PETAMBURAN,19087,0,18788,298,1,1,2021-12-19
317506,JAKARTA TIMUR,CAKUNG,22667,1,22253,413,0,1,2021-12-19
317503,JAKARTA TIMUR,JATINEGARA,19585,0,19199,383,3,3,2021-12-19
317409,JAKARTA SELATAN,JAGAKARSA,26615,0,26206,406,3,3,2021-12-19
317103,JAKARTA PUSAT,KEMAYORAN,19967,2,19591,373,1,3,2021-12-19
317206,JAKARTA UTARA,KELAPA GADING,12653,1,12460,192,0,1,2021-12-19
317305,JAKARTA BARAT,KEBON JERUK,22102,0,21727,375,0,0,2021-12-19
310102,KAB.ADM.KEP.SERIBU,KEP. SERIBU SELATAN,704,0,694,10,0,0,2021-12-19
317407,JAKARTA SELATAN,KEBAYORAN BARU,13890,0,13704,185,1,1,2021-12-19
317306,JAKARTA BARAT,KALI DERES,18035,2,17716,316,1,3,2021-12-19
317108,JAKARTA PUSAT,JOHAR BARU,8687,1,8528,157,1,2,2021-12-19
317405,JAKARTA SELATAN,KEBAYORAN LAMA,20061,2,19695,363,1,3,2021-12-19
317403,JAKARTA SELATAN,MAMPANG PRAPATAN,11513,1,11332,179,1,2,2021-12-20
317505,JAKARTA TIMUR,PASAR REBO,17646,0,17319,326,1,1,2021-12-20
317501,JAKARTA TIMUR,MATRAMAN,14227,1,13946,279,1,2,2021-12-20
317106,JAKARTA PUSAT,MENTENG,6434,0,6314,119,1,1,2021-12-20
317205,JAKARTA UTARA,PADEMANGAN,12935,41,12730,163,1,42,2021-12-20
317307,JAKARTA BARAT,PALMERAH,15839,0,15508,329,2,2,2021-12-20
317408,JAKARTA SELATAN,PANCORAN,14339,0,14111,227,1,1,2021-12-20
317404,JAKARTA SELATAN,PASAR MINGGU,23838,3,23409,426,0,3,2021-12-20
317201,JAKARTA UTARA,PENJARINGAN,18646,1,18414,229,2,3,2021-12-20
317402,JAKARTA SELATAN,SETIA BUDI,12002,0,11819,183,0,0,2021-12-20
317502,JAKARTA TIMUR,PULO GADUNG,21803,1,21400,401,1,2,2021-12-20
317102,JAKARTA PUSAT,SAWAH BESAR,9161,2,8987,172,0,2,2021-12-20
317104,JAKARTA PUSAT,SENEN,9395,0,9227,168,0,0,2021-12-20
317303,JAKARTA BARAT,TAMAN SARI,8757,0,8617,140,0,0,2021-12-20
317304,JAKARTA BARAT,TAMBORA,14131,0,13875,253,3,3,2021-12-20
317107,JAKARTA PUSAT,TANAH ABANG,11051,0,10827,223,1,1,2021-12-20
317202,JAKARTA UTARA,TANJUNG PRIOK,25783,0,25357,425,1,1,2021-12-20
317508,JAKARTA TIMUR,MAKASAR,17482,0,17184,298,0,0,2021-12-20
111111,Luar DKI & Proses Update,Luar DKI & Proses Update,143008,137,141294,1273,304,441,2021-12-20
317410,JAKARTA SELATAN,PESANGGRAHAN,16378,0,16126,252,0,0,2021-12-20
317504,JAKARTA TIMUR,KRAMAT JATI,21632,1,21229,402,0,1,2021-12-20
317401,JAKARTA SELATAN,TEBET,16956,0,16676,280,0,0,2021-12-20
310101,KAB.ADM.KEP.SERIBU,KEP. SERIBU UTARA,640,0,634,6,0,0,2021-12-20
317203,JAKARTA UTARA,KOJA,17237,0,16899,338,0,0,2021-12-20
317105,JAKARTA PUSAT,CEMPAKA PUTIH,10531,2,10361,168,0,2,2021-12-20
317301,JAKARTA BARAT,CENGKARENG,28731,2,28155,559,15,17,2021-12-20
317406,JAKARTA SELATAN,CILANDAK,17702,0,17438,261,3,3,2021-12-20
317204,JAKARTA UTARA,CILINCING,17434,0,17094,340,0,0,2021-12-20
317510,JAKARTA TIMUR,CIPAYUNG,25202,0,24935,267,0,0,2021-12-20
317509,JAKARTA TIMUR,CIRACAS,22519,0,22138,379,2,2,2021-12-20
317507,JAKARTA TIMUR,DUREN SAWIT,29479,1,28867,611,0,1,2021-12-20
317101,JAKARTA PUSAT,GAMBIR,8567,0,8432,134,1,1,2021-12-20
317302,JAKARTA BARAT,GROGOL PETAMBURAN,19087,0,18788,298,1,1,2021-12-20
317506,JAKARTA TIMUR,CAKUNG,22667,1,22253,413,0,1,2021-12-20
317503,JAKARTA TIMUR,JATINEGARA,19585,0,19199,383,3,3,2021-12-20
317409,JAKARTA SELATAN,JAGAKARSA,26615,0,26208,406,1,1,2021-12-20
317308,JAKARTA BARAT,KEMBANGAN,20253,0,19947,303,3,3,2021-12-20
317103,JAKARTA PUSAT,KEMAYORAN,19967,2,19591,373,1,3,2021-12-20
317206,JAKARTA UTARA,KELAPA GADING,12653,1,12459,192,1,2,2021-12-20
310102,KAB.ADM.KEP.SERIBU,KEP. SERIBU SELATAN,704,0,694,10,0,0,2021-12-20
317405,JAKARTA SELATAN,KEBAYORAN LAMA,20063,4,19695,363,1,5,2021-12-20
317407,JAKARTA SELATAN,KEBAYORAN BARU,13890,0,13704,185,1,1,2021-12-20
317306,JAKARTA BARAT,KALI DERES,18036,2,17716,316,2,4,2021-12-20
317108,JAKARTA PUSAT,JOHAR BARU,8687,1,8528,157,1,2,2021-12-20
317305,JAKARTA BARAT,KEBON JERUK,22103,0,21727,375,1,1,2021-12-20
317201,JAKARTA UTARA,PENJARINGAN,18646,1,18414,229,2,3,2021-12-21
317501,JAKARTA TIMUR,MATRAMAN,14227,1,13946,279,1,2,2021-12-21
317106,JAKARTA PUSAT,MENTENG,6434,0,6314,119,1,1,2021-12-21
317205,JAKARTA UTARA,PADEMANGAN,12941,41,12730,163,7,48,2021-12-21
317307,JAKARTA BARAT,PALMERAH,15838,0,15508,329,1,1,2021-12-21
317408,JAKARTA SELATAN,PANCORAN,14339,0,14111,227,1,1,2021-12-21
317404,JAKARTA SELATAN,PASAR MINGGU,23838,2,23410,426,0,2,2021-12-21
317505,JAKARTA TIMUR,PASAR REBO,17646,0,17319,326,1,1,2021-12-21
317410,JAKARTA SELATAN,PESANGGRAHAN,16378,0,16126,252,0,0,2021-12-21
317304,JAKARTA BARAT,TAMBORA,14131,0,13875,253,3,3,2021-12-21
317102,JAKARTA PUSAT,SAWAH BESAR,9161,2,8987,172,0,2,2021-12-21
317104,JAKARTA PUSAT,SENEN,9396,1,9227,168,0,1,2021-12-21
317402,JAKARTA SELATAN,SETIA BUDI,12002,0,11819,183,0,0,2021-12-21
317303,JAKARTA BARAT,TAMAN SARI,8757,0,8617,140,0,0,2021-12-21
317107,JAKARTA PUSAT,TANAH ABANG,11051,0,10827,223,1,1,2021-12-21
317202,JAKARTA UTARA,TANJUNG PRIOK,25783,0,25357,425,1,1,2021-12-21
317401,JAKARTA SELATAN,TEBET,16957,0,16676,280,1,1,2021-12-21
111111,Luar DKI & Proses Update,Luar DKI & Proses Update,143008,137,141294,1273,304,441,2021-12-21
317403,JAKARTA SELATAN,MAMPANG PRAPATAN,11513,1,11332,179,1,2,2021-12-21
317502,JAKARTA TIMUR,PULO GADUNG,21803,0,21401,401,1,1,2021-12-21
317508,JAKARTA TIMUR,MAKASAR,17482,0,17184,298,0,0,2021-12-21
317503,JAKARTA TIMUR,JATINEGARA,19586,1,19199,383,3,4,2021-12-21
317203,JAKARTA UTARA,KOJA,17237,1,16898,338,0,1,2021-12-21
317105,JAKARTA PUSAT,CEMPAKA PUTIH,10532,3,10361,168,0,3,2021-12-21
317301,JAKARTA BARAT,CENGKARENG,28728,1,28155,559,13,14,2021-12-21
317406,JAKARTA SELATAN,CILANDAK,17702,0,17438,261,3,3,2021-12-21
317204,JAKARTA UTARA,CILINCING,17434,0,17094,340,0,0,2021-12-21
317510,JAKARTA TIMUR,CIPAYUNG,25203,1,24935,267,0,1,2021-12-21
317509,JAKARTA TIMUR,CIRACAS,22519,0,22138,379,2,2,2021-12-21
317507,JAKARTA TIMUR,DUREN SAWIT,29479,1,28867,611,0,1,2021-12-21
317101,JAKARTA PUSAT,GAMBIR,8566,0,8432,134,0,0,2021-12-21
317302,JAKARTA BARAT,GROGOL PETAMBURAN,19089,2,18788,298,1,3,2021-12-21
317409,JAKARTA SELATAN,JAGAKARSA,26616,0,26208,406,2,2,2021-12-21
317504,JAKARTA TIMUR,KRAMAT JATI,21633,2,21229,402,0,2,2021-12-21
317108,JAKARTA PUSAT,JOHAR BARU,8687,1,8528,157,1,2,2021-12-21
317306,JAKARTA BARAT,KALI DERES,18035,2,17716,316,1,3,2021-12-21
317407,JAKARTA SELATAN,KEBAYORAN BARU,13891,0,13704,185,2,2,2021-12-21
317405,JAKARTA SELATAN,KEBAYORAN LAMA,20062,3,19695,363,1,4,2021-12-21
317305,JAKARTA BARAT,KEBON JERUK,22103,0,21727,375,1,1,2021-12-21
317206,JAKARTA UTARA,KELAPA GADING,12653,1,12459,192,1,2,2021-12-21
317103,JAKARTA PUSAT,KEMAYORAN,19967,2,19591,373,1,3,2021-12-21
317308,JAKARTA BARAT,KEMBANGAN,20253,0,19947,303,3,3,2021-12-21
310102,KAB.ADM.KEP.SERIBU,KEP. SERIBU SELATAN,704,0,694,10,0,0,2021-12-21
310101,KAB.ADM.KEP.SERIBU,KEP. SERIBU UTARA,640,0,634,6,0,0,2021-12-21
317506,JAKARTA TIMUR,CAKUNG,22668,1,22254,413,0,1,2021-12-21
317505,JAKARTA TIMUR,PASAR REBO,17647,1,17319,326,1,2,2021-12-22
317404,JAKARTA SELATAN,PASAR MINGGU,23838,2,23410,426,0,2,2021-12-22
317408,JAKARTA SELATAN,PANCORAN,14341,0,14111,227,3,3,2021-12-22
317106,JAKARTA PUSAT,MENTENG,6434,0,6314,119,1,1,2021-12-22
317205,JAKARTA UTARA,PADEMANGAN,12897,2,12725,163,7,9,2021-12-22
317201,JAKARTA UTARA,PENJARINGAN,18647,0,18415,229,3,3,2021-12-22
317501,JAKARTA TIMUR,MATRAMAN,14228,0,13948,279,1,1,2021-12-22
317307,JAKARTA BARAT,PALMERAH,15838,0,15508,329,1,1,2021-12-22
317410,JAKARTA SELATAN,PESANGGRAHAN,16378,0,16126,252,0,0,2021-12-22
317304,JAKARTA BARAT,TAMBORA,14131,0,13875,253,3,3,2021-12-22
317102,JAKARTA PUSAT,SAWAH BESAR,9161,2,8987,172,0,2,2021-12-22
317104,JAKARTA PUSAT,SENEN,9396,0,9227,168,1,1,2021-12-22
317402,JAKARTA SELATAN,SETIA BUDI,12002,0,11819,183,0,0,2021-12-22
317303,JAKARTA BARAT,TAMAN SARI,8757,0,8617,140,0,0,2021-12-22
317107,JAKARTA PUSAT,TANAH ABANG,11052,0,10827,223,2,2,2021-12-22
317202,JAKARTA UTARA,TANJUNG PRIOK,25783,0,25357,425,1,1,2021-12-22
317401,JAKARTA SELATAN,TEBET,16956,0,16676,280,0,0,2021-12-22
317403,JAKARTA SELATAN,MAMPANG PRAPATAN,11513,1,11332,179,1,2,2021-12-22
111111,Luar DKI & Proses Update,Luar DKI & Proses Update,143008,137,141294,1273,304,441,2021-12-22
317502,JAKARTA TIMUR,PULO GADUNG,21803,0,21401,401,1,1,2021-12-22
317508,JAKARTA TIMUR,MAKASAR,17482,0,17184,298,0,0,2021-12-22
317504,JAKARTA TIMUR,KRAMAT JATI,21633,2,21229,402,0,2,2021-12-22
317203,JAKARTA UTARA,KOJA,17237,1,16898,338,0,1,2021-12-22
317506,JAKARTA TIMUR,CAKUNG,22670,2,22254,413,1,3,2021-12-22
317301,JAKARTA BARAT,CENGKARENG,28735,1,28155,559,20,21,2021-12-22
317406,JAKARTA SELATAN,CILANDAK,17704,0,17438,261,5,5,2021-12-22
317204,JAKARTA UTARA,CILINCING,17435,1,17094,340,0,1,2021-12-22
317510,JAKARTA TIMUR,CIPAYUNG,25204,2,24935,267,0,2,2021-12-22
317509,JAKARTA TIMUR,CIRACAS,22521,1,22138,379,3,4,2021-12-22
317507,JAKARTA TIMUR,DUREN SAWIT,29480,2,28867,611,0,2,2021-12-22
317101,JAKARTA PUSAT,GAMBIR,8567,0,8432,134,1,1,2021-12-22
317302,JAKARTA BARAT,GROGOL PETAMBURAN,19090,2,18789,298,1,3,2021-12-22
317409,JAKARTA SELATAN,JAGAKARSA,26617,0,26208,406,3,3,2021-12-22
317105,JAKARTA PUSAT,CEMPAKA PUTIH,10533,3,10361,168,1,4,2021-12-22
317108,JAKARTA PUSAT,JOHAR BARU,8687,1,8528,157,1,2,2021-12-22
317306,JAKARTA BARAT,KALI DERES,18037,3,17716,316,2,5,2021-12-22
317407,JAKARTA SELATAN,KEBAYORAN BARU,13890,0,13704,185,1,1,2021-12-22
317405,JAKARTA SELATAN,KEBAYORAN LAMA,20063,3,19696,363,1,4,2021-12-22
317305,JAKARTA BARAT,KEBON JERUK,22105,1,21727,375,2,3,2021-12-22
317206,JAKARTA UTARA,KELAPA GADING,12653,1,12459,192,1,2,2021-12-22
317103,JAKARTA PUSAT,KEMAYORAN,19967,2,19591,373,1,3,2021-12-22
317308,JAKARTA BARAT,KEMBANGAN,20253,0,19947,303,3,3,2021-12-22
310102,KAB.ADM.KEP.SERIBU,KEP. SERIBU SELATAN,704,0,694,10,0,0,2021-12-22
310101,KAB.ADM.KEP.SERIBU,KEP. SERIBU UTARA,640,0,634,6,0,0,2021-12-22
317503,JAKARTA TIMUR,JATINEGARA,19585,0,19199,383,3,3,2021-12-22
317201,JAKARTA UTARA,PENJARINGAN,18647,0,18415,229,3,3,2021-12-23
317505,JAKARTA TIMUR,PASAR REBO,17647,1,17319,326,1,2,2021-12-23
317404,JAKARTA SELATAN,PASAR MINGGU,23838,2,23410,426,0,2,2021-12-23
317106,JAKARTA PUSAT,MENTENG,6434,0,6315,119,0,0,2021-12-23
317307,JAKARTA BARAT,PALMERAH,15838,0,15508,329,1,1,2021-12-23
317205,JAKARTA UTARA,PADEMANGAN,12897,2,12725,163,7,9,2021-12-23
317410,JAKARTA SELATAN,PESANGGRAHAN,16381,2,16126,252,1,3,2021-12-23
317408,JAKARTA SELATAN,PANCORAN,14341,0,14111,227,3,3,2021-12-23
317502,JAKARTA TIMUR,PULO GADUNG,21803,0,21401,401,1,1,2021-12-23
317304,JAKARTA BARAT,TAMBORA,14132,1,13875,253,3,4,2021-12-23
317104,JAKARTA PUSAT,SENEN,9396,0,9227,168,1,1,2021-12-23
317402,JAKARTA SELATAN,SETIA BUDI,12002,0,11819,183,0,0,2021-12-23
317303,JAKARTA BARAT,TAMAN SARI,8757,0,8617,140,0,0,2021-12-23
317107,JAKARTA PUSAT,TANAH ABANG,11053,0,10827,223,3,3,2021-12-23
317202,JAKARTA UTARA,TANJUNG PRIOK,25785,0,25358,425,2,2,2021-12-23
317401,JAKARTA SELATAN,TEBET,16957,0,16676,280,1,1,2021-12-23
111111,Luar DKI & Proses Update,Luar DKI & Proses Update,143008,137,141294,1273,304,441,2021-12-23
317501,JAKARTA TIMUR,MATRAMAN,14228,0,13949,279,0,0,2021-12-23
317102,JAKARTA PUSAT,SAWAH BESAR,9161,2,8987,172,0,2,2021-12-23
317403,JAKARTA SELATAN,MAMPANG PRAPATAN,11514,1,11332,179,2,3,2021-12-23
317301,JAKARTA BARAT,CENGKARENG,28728,1,28157,559,11,12,2021-12-23
317504,JAKARTA TIMUR,KRAMAT JATI,21632,1,21229,402,0,1,2021-12-23
317204,JAKARTA UTARA,CILINCING,17435,1,17094,340,0,1,2021-12-23
317506,JAKARTA TIMUR,CAKUNG,22670,2,22254,413,1,3,2021-12-23
317508,JAKARTA TIMUR,MAKASAR,17482,0,17184,298,0,0,2021-12-23
317510,JAKARTA TIMUR,CIPAYUNG,25204,2,24935,267,0,2,2021-12-23
317509,JAKARTA TIMUR,CIRACAS,22521,1,22138,379,3,4,2021-12-23
317406,JAKARTA SELATAN,CILANDAK,17703,0,17438,261,4,4,2021-12-23
317101,JAKARTA PUSAT,GAMBIR,8567,0,8432,134,1,1,2021-12-23
317302,JAKARTA BARAT,GROGOL PETAMBURAN,19089,1,18789,298,1,2,2021-12-23
317409,JAKARTA SELATAN,JAGAKARSA,26617,0,26208,406,3,3,2021-12-23
317503,JAKARTA TIMUR,JATINEGARA,19585,0,19200,383,2,2,2021-12-23
317507,JAKARTA TIMUR,DUREN SAWIT,29480,1,28868,611,0,1,2021-12-23
317306,JAKARTA BARAT,KALI DERES,18036,3,17716,316,1,4,2021-12-23
317203,JAKARTA UTARA,KOJA,17237,1,16898,338,0,1,2021-12-23
310101,KAB.ADM.KEP.SERIBU,KEP. SERIBU UTARA,640,0,634,6,0,0,2021-12-23
317108,JAKARTA PUSAT,JOHAR BARU,8687,0,8529,157,1,1,2021-12-23
317308,JAKARTA BARAT,KEMBANGAN,20253,0,19947,303,3,3,2021-12-23
310102,KAB.ADM.KEP.SERIBU,KEP. SERIBU SELATAN,704,0,694,10,0,0,2021-12-23
317206,JAKARTA UTARA,KELAPA GADING,12653,1,12459,192,1,2,2021-12-23
317305,JAKARTA BARAT,KEBON JERUK,22104,1,21727,375,1,2,2021-12-23
317405,JAKARTA SELATAN,KEBAYORAN LAMA,20062,3,19696,363,0,3,2021-12-23
317407,JAKARTA SELATAN,KEBAYORAN BARU,13889,0,13704,185,0,0,2021-12-23
317103,JAKARTA PUSAT,KEMAYORAN,19967,2,19591,373,1,3,2021-12-23
317105,JAKARTA PUSAT,CEMPAKA PUTIH,10533,3,10361,168,1,4,2021-12-23
317203,JAKARTA UTARA,KOJA,17238,2,16898,338,0,2,2021-12-24
317401,JAKARTA SELATAN,TEBET,16959,0,16676,280,3,3,2021-12-24
317202,JAKARTA UTARA,TANJUNG PRIOK,25785,1,25358,425,1,2,2021-12-24
317107,JAKARTA PUSAT,TANAH ABANG,11051,0,10827,223,1,1,2021-12-24
317304,JAKARTA BARAT,TAMBORA,14132,1,13877,253,1,2,2021-12-24
317303,JAKARTA BARAT,TAMAN SARI,8757,0,8617,140,0,0,2021-12-24
317402,JAKARTA SELATAN,SETIA BUDI,12002,0,11819,183,0,0,2021-12-24
310101,KAB.ADM.KEP.SERIBU,KEP. SERIBU UTARA,640,0,634,6,0,0,2021-12-24
317501,JAKARTA TIMUR,MATRAMAN,14228,0,13949,279,0,0,2021-12-24
317408,JAKARTA SELATAN,PANCORAN,14342,0,14111,227,4,4,2021-12-24
317504,JAKARTA TIMUR,KRAMAT JATI,21632,1,21229,402,0,1,2021-12-24
317502,JAKARTA TIMUR,PULO GADUNG,21804,0,21401,401,2,2,2021-12-24
317410,JAKARTA SELATAN,PESANGGRAHAN,16381,2,16126,252,1,3,2021-12-24
317201,JAKARTA UTARA,PENJARINGAN,18649,1,18415,229,4,5,2021-12-24
317505,JAKARTA TIMUR,PASAR REBO,17647,1,17319,326,1,2,2021-12-24
317404,JAKARTA SELATAN,PASAR MINGGU,23838,1,23411,426,0,1,2021-12-24
317307,JAKARTA BARAT,PALMERAH,15838,0,15509,329,0,0,2021-12-24
317205,JAKARTA UTARA,PADEMANGAN,12890,1,12725,163,1,2,2021-12-24
317106,JAKARTA PUSAT,MENTENG,6434,0,6315,119,0,0,2021-12-24
317104,JAKARTA PUSAT,SENEN,9395,0,9227,168,0,0,2021-12-24
310102,KAB.ADM.KEP.SERIBU,KEP. SERIBU SELATAN,704,0,694,10,0,0,2021-12-24
317102,JAKARTA PUSAT,SAWAH BESAR,9161,0,8989,172,0,0,2021-12-24
317103,JAKARTA PUSAT,KEMAYORAN,19974,5,19591,373,5,10,2021-12-24
317403,JAKARTA SELATAN,MAMPANG PRAPATAN,11514,2,11332,179,1,3,2021-12-24
317506,JAKARTA TIMUR,CAKUNG,22670,2,22254,413,1,3,2021-12-24
317105,JAKARTA PUSAT,CEMPAKA PUTIH,10535,3,10361,168,3,6,2021-12-24
317301,JAKARTA BARAT,CENGKARENG,28728,0,28161,559,8,8,2021-12-24
317406,JAKARTA SELATAN,CILANDAK,17703,0,17440,261,2,2,2021-12-24
317204,JAKARTA UTARA,CILINCING,17435,1,17094,340,0,1,2021-12-24
317510,JAKARTA TIMUR,CIPAYUNG,25204,2,24935,267,0,2,2021-12-24
317509,JAKARTA TIMUR,CIRACAS,22523,1,22138,379,5,6,2021-12-24
317507,JAKARTA TIMUR,DUREN SAWIT,29480,1,28868,611,0,1,2021-12-24
317308,JAKARTA BARAT,KEMBANGAN,20254,1,19949,303,1,2,2021-12-24
317101,JAKARTA PUSAT,GAMBIR,8566,0,8432,134,0,0,2021-12-24
111111,Luar DKI & Proses Update,Luar DKI & Proses Update,143008,137,141294,1273,304,441,2021-12-24
317409,JAKARTA SELATAN,JAGAKARSA,26617,0,26208,406,3,3,2021-12-24
317503,JAKARTA TIMUR,JATINEGARA,19585,0,19200,383,2,2,2021-12-24
317108,JAKARTA PUSAT,JOHAR BARU,8687,0,8529,157,1,1,2021-12-24
317306,JAKARTA BARAT,KALI DERES,18036,2,17717,316,1,3,2021-12-24
317407,JAKARTA SELATAN,KEBAYORAN BARU,13889,0,13704,185,0,0,2021-12-24
317405,JAKARTA SELATAN,KEBAYORAN LAMA,20062,3,19696,363,0,3,2021-12-24
317305,JAKARTA BARAT,KEBON JERUK,22105,1,21727,375,2,3,2021-12-24
317206,JAKARTA UTARA,KELAPA GADING,12653,1,12459,192,1,2,2021-12-24
317302,JAKARTA BARAT,GROGOL PETAMBURAN,19089,1,18789,298,1,2,2021-12-24
317508,JAKARTA TIMUR,MAKASAR,17482,0,17184,298,0,0,2021-12-24
317405,JAKARTA SELATAN,KEBAYORAN LAMA,20062,3,19696,363,0,3,2021-12-25
317506,JAKARTA TIMUR,CAKUNG,22671,3,22254,413,1,4,2021-12-25
317508,JAKARTA TIMUR,MAKASAR,17483,1,17184,298,0,1,2021-12-25
317403,JAKARTA SELATAN,MAMPANG PRAPATAN,11517,5,11333,179,0,5,2021-12-25
317501,JAKARTA TIMUR,MATRAMAN,14228,0,13949,279,0,0,2021-12-25
317106,JAKARTA PUSAT,MENTENG,6434,0,6315,119,0,0,2021-12-25
317205,JAKARTA UTARA,PADEMANGAN,12890,1,12726,163,0,1,2021-12-25
317307,JAKARTA BARAT,PALMERAH,15839,1,15509,329,0,1,2021-12-25
317408,JAKARTA SELATAN,PANCORAN,14343,1,14111,227,4,5,2021-12-25
317404,JAKARTA SELATAN,PASAR MINGGU,23839,2,23411,426,0,2,2021-12-25
317201,JAKARTA UTARA,PENJARINGAN,18649,1,18416,229,3,4,2021-12-25
317410,JAKARTA SELATAN,PESANGGRAHAN,16381,0,16126,252,3,3,2021-12-25
317502,JAKARTA TIMUR,PULO GADUNG,21805,1,21402,401,1,2,2021-12-25
317102,JAKARTA PUSAT,SAWAH BESAR,9162,0,8989,172,1,1,2021-12-25
317104,JAKARTA PUSAT,SENEN,9395,0,9227,168,0,0,2021-12-25
317402,JAKARTA SELATAN,SETIA BUDI,12002,0,11819,183,0,0,2021-12-25
317303,JAKARTA BARAT,TAMAN SARI,8757,0,8617,140,0,0,2021-12-25
317304,JAKARTA BARAT,TAMBORA,14132,1,13877,253,1,2,2021-12-25
317107,JAKARTA PUSAT,TANAH ABANG,11052,0,10828,223,1,1,2021-12-25
317202,JAKARTA UTARA,TANJUNG PRIOK,25787,2,25358,425,2,4,2021-12-25
317401,JAKARTA SELATAN,TEBET,16959,0,16676,280,3,3,2021-12-25
317504,JAKARTA TIMUR,KRAMAT JATI,21632,0,21230,402,0,0,2021-12-25
317203,JAKARTA UTARA,KOJA,17239,3,16898,338,0,3,2021-12-25
317505,JAKARTA TIMUR,PASAR REBO,17649,3,17320,326,0,3,2021-12-25
310102,KAB.ADM.KEP.SERIBU,KEP. SERIBU SELATAN,704,0,694,10,0,0,2021-12-25
310101,KAB.ADM.KEP.SERIBU,KEP. SERIBU UTARA,640,0,634,6,0,0,2021-12-25
317301,JAKARTA BARAT,CENGKARENG,28728,0,28166,559,3,3,2021-12-25
317406,JAKARTA SELATAN,CILANDAK,17705,0,17440,261,4,4,2021-12-25
317204,JAKARTA UTARA,CILINCING,17437,3,17094,340,0,3,2021-12-25
317510,JAKARTA TIMUR,CIPAYUNG,25204,2,24935,267,0,2,2021-12-25
317509,JAKARTA TIMUR,CIRACAS,22523,1,22138,379,5,6,2021-12-25
317507,JAKARTA TIMUR,DUREN SAWIT,29480,1,28868,611,0,1,2021-12-25
317101,JAKARTA PUSAT,GAMBIR,8566,0,8432,134,0,0,2021-12-25
317302,JAKARTA BARAT,GROGOL PETAMBURAN,19089,1,18789,298,1,2,2021-12-25
317409,JAKARTA SELATAN,JAGAKARSA,26617,0,26208,406,3,3,2021-12-25
317105,JAKARTA PUSAT,CEMPAKA PUTIH,10536,1,10363,168,4,5,2021-12-25
317108,JAKARTA PUSAT,JOHAR BARU,8688,1,8529,157,1,2,2021-12-25
111111,Luar DKI & Proses Update,Luar DKI & Proses Update,143008,137,141294,1273,304,441,2021-12-25
317306,JAKARTA BARAT,KALI DERES,18037,2,17718,316,1,3,2021-12-25
317407,JAKARTA SELATAN,KEBAYORAN BARU,13890,1,13704,185,0,1,2021-12-25
317305,JAKARTA BARAT,KEBON JERUK,22105,1,21727,375,2,3,2021-12-25
317206,JAKARTA UTARA,KELAPA GADING,12653,1,12459,192,1,2,2021-12-25
317103,JAKARTA PUSAT,KEMAYORAN,19979,10,19592,373,4,14,2021-12-25
317308,JAKARTA BARAT,KEMBANGAN,20254,1,19949,303,1,2,2021-12-25
317503,JAKARTA TIMUR,JATINEGARA,19586,1,19201,383,1,2,2021-12-25
317504,JAKARTA TIMUR,KRAMAT JATI,21632,0,21230,402,0,0,2021-12-26
317408,JAKARTA SELATAN,PANCORAN,14343,1,14111,227,4,5,2021-12-26
317307,JAKARTA BARAT,PALMERAH,15839,1,15509,329,0,1,2021-12-26
317205,JAKARTA UTARA,PADEMANGAN,12890,1,12726,163,0,1,2021-12-26
317508,JAKARTA TIMUR,MAKASAR,17483,1,17184,298,0,1,2021-12-26
317501,JAKARTA TIMUR,MATRAMAN,14229,0,13949,279,1,1,2021-12-26
317403,JAKARTA SELATAN,MAMPANG PRAPATAN,11517,5,11333,179,0,5,2021-12-26
317404,JAKARTA SELATAN,PASAR MINGGU,23839,0,23412,426,1,1,2021-12-26
317106,JAKARTA PUSAT,MENTENG,6434,0,6315,119,0,0,2021-12-26
317505,JAKARTA TIMUR,PASAR REBO,17649,3,17320,326,0,3,2021-12-26
317104,JAKARTA PUSAT,SENEN,9396,1,9227,168,0,1,2021-12-26
317410,JAKARTA SELATAN,PESANGGRAHAN,16381,0,16126,252,3,3,2021-12-26
317502,JAKARTA TIMUR,PULO GADUNG,21807,1,21402,401,3,4,2021-12-26
317102,JAKARTA PUSAT,SAWAH BESAR,9162,0,8989,172,1,1,2021-12-26
317303,JAKARTA BARAT,TAMAN SARI,8757,0,8617,140,0,0,2021-12-26
317304,JAKARTA BARAT,TAMBORA,14132,1,13878,253,0,1,2021-12-26
317107,JAKARTA PUSAT,TANAH ABANG,11052,0,10828,223,1,1,2021-12-26
317202,JAKARTA UTARA,TANJUNG PRIOK,25789,3,25358,425,3,6,2021-12-26
317401,JAKARTA SELATAN,TEBET,16959,0,16676,280,3,3,2021-12-26
317201,JAKARTA UTARA,PENJARINGAN,18650,2,18416,229,3,5,2021-12-26
317203,JAKARTA UTARA,KOJA,17239,3,16898,338,0,3,2021-12-26
317402,JAKARTA SELATAN,SETIA BUDI,12002,0,11819,183,0,0,2021-12-26
310102,KAB.ADM.KEP.SERIBU,KEP. SERIBU SELATAN,704,0,694,10,0,0,2021-12-26
310101,KAB.ADM.KEP.SERIBU,KEP. SERIBU UTARA,640,0,634,6,0,0,2021-12-26
317105,JAKARTA PUSAT,CEMPAKA PUTIH,10537,2,10363,168,4,6,2021-12-26
317301,JAKARTA BARAT,CENGKARENG,28730,1,28167,559,3,4,2021-12-26
317406,JAKARTA SELATAN,CILANDAK,17705,0,17441,261,3,3,2021-12-26
317204,JAKARTA UTARA,CILINCING,17437,3,17094,340,0,3,2021-12-26
111111,Luar DKI & Proses Update,Luar DKI & Proses Update,143008,137,141294,1273,304,441,2021-12-26
317510,JAKARTA TIMUR,CIPAYUNG,25205,2,24935,267,1,3,2021-12-26
317509,JAKARTA TIMUR,CIRACAS,22523,1,22139,379,4,5,2021-12-26
317507,JAKARTA TIMUR,DUREN SAWIT,29481,1,28868,611,1,2,2021-12-26
317101,JAKARTA PUSAT,GAMBIR,8566,0,8432,134,0,0,2021-12-26
317506,JAKARTA TIMUR,CAKUNG,22672,4,22254,413,1,5,2021-12-26
317409,JAKARTA SELATAN,JAGAKARSA,26618,1,26208,406,3,4,2021-12-26
317503,JAKARTA TIMUR,JATINEGARA,19587,2,19202,383,0,2,2021-12-26
317108,JAKARTA PUSAT,JOHAR BARU,8688,1,8529,157,1,2,2021-12-26
317306,JAKARTA BARAT,KALI DERES,18037,2,17718,316,1,3,2021-12-26
317407,JAKARTA SELATAN,KEBAYORAN BARU,13889,0,13704,185,0,0,2021-12-26
317405,JAKARTA SELATAN,KEBAYORAN LAMA,20063,3,19697,363,0,3,2021-12-26
317305,JAKARTA BARAT,KEBON JERUK,22105,1,21727,375,2,3,2021-12-26
317206,JAKARTA UTARA,KELAPA GADING,12653,1,12459,192,1,2,2021-12-26
317103,JAKARTA PUSAT,KEMAYORAN,19984,14,19593,373,4,18,2021-12-26
317308,JAKARTA BARAT,KEMBANGAN,20254,1,19949,303,1,2,2021-12-26
317302,JAKARTA BARAT,GROGOL PETAMBURAN,19089,1,18790,298,0,1,2021-12-26
317505,JAKARTA TIMUR,PASAR REBO,17649,3,17320,326,0,3,2021-12-27
317404,JAKARTA SELATAN,PASAR MINGGU,23839,0,23412,426,1,1,2021-12-27
317408,JAKARTA SELATAN,PANCORAN,14342,0,14111,227,4,4,2021-12-27
317403,JAKARTA SELATAN,MAMPANG PRAPATAN,11517,5,11333,179,0,5,2021-12-27
317205,JAKARTA UTARA,PADEMANGAN,12891,0,12727,163,1,1,2021-12-27
317501,JAKARTA TIMUR,MATRAMAN,14229,0,13949,279,1,1,2021-12-27
317201,JAKARTA UTARA,PENJARINGAN,18650,2,18417,229,2,4,2021-12-27
317307,JAKARTA BARAT,PALMERAH,15838,0,15509,329,0,0,2021-12-27
317410,JAKARTA SELATAN,PESANGGRAHAN,16381,0,16126,252,3,3,2021-12-27
317303,JAKARTA BARAT,TAMAN SARI,8757,0,8617,140,0,0,2021-12-27
317102,JAKARTA PUSAT,SAWAH BESAR,9162,0,8989,172,1,1,2021-12-27
317104,JAKARTA PUSAT,SENEN,9396,1,9227,168,0,1,2021-12-27
317402,JAKARTA SELATAN,SETIA BUDI,12002,0,11819,183,0,0,2021-12-27
317304,JAKARTA BARAT,TAMBORA,14132,1,13878,253,0,1,2021-12-27
317107,JAKARTA PUSAT,TANAH ABANG,11053,1,10828,223,1,2,2021-12-27
317202,JAKARTA UTARA,TANJUNG PRIOK,25790,3,25358,425,4,7,2021-12-27
317401,JAKARTA SELATAN,TEBET,16959,0,16676,280,3,3,2021-12-27
111111,Luar DKI & Proses Update,Luar DKI & Proses Update,143008,137,141294,1273,304,441,2021-12-27
317508,JAKARTA TIMUR,MAKASAR,17483,1,17184,298,0,1,2021-12-27
317502,JAKARTA TIMUR,PULO GADUNG,21807,1,21402,401,3,4,2021-12-27
317504,JAKARTA TIMUR,KRAMAT JATI,21632,0,21230,402,0,0,2021-12-27
317106,JAKARTA PUSAT,MENTENG,6434,0,6315,119,0,0,2021-12-27
310101,KAB.ADM.KEP.SERIBU,KEP. SERIBU UTARA,640,0,634,6,0,0,2021-12-27
317506,JAKARTA TIMUR,CAKUNG,22671,3,22254,413,1,4,2021-12-27
317203,JAKARTA UTARA,KOJA,17239,3,16898,338,0,3,2021-12-27
317105,JAKARTA PUSAT,CEMPAKA PUTIH,10537,2,10363,168,4,6,2021-12-27
317301,JAKARTA BARAT,CENGKARENG,28729,1,28168,559,1,2,2021-12-27
317204,JAKARTA UTARA,CILINCING,17437,3,17094,340,0,3,2021-12-27
317510,JAKARTA TIMUR,CIPAYUNG,25205,1,24936,267,1,2,2021-12-27
317509,JAKARTA TIMUR,CIRACAS,22523,0,22141,379,3,3,2021-12-27
317507,JAKARTA TIMUR,DUREN SAWIT,29481,0,28869,611,1,1,2021-12-27
317101,JAKARTA PUSAT,GAMBIR,8566,0,8432,134,0,0,2021-12-27
317302,JAKARTA BARAT,GROGOL PETAMBURAN,19089,1,18790,298,0,1,2021-12-27
317406,JAKARTA SELATAN,CILANDAK,17703,0,17441,261,1,1,2021-12-27
317503,JAKARTA TIMUR,JATINEGARA,19587,2,19202,383,0,2,2021-12-27
317308,JAKARTA BARAT,KEMBANGAN,20254,1,19950,303,0,1,2021-12-27
317409,JAKARTA SELATAN,JAGAKARSA,26617,0,26209,406,2,2,2021-12-27
310102,KAB.ADM.KEP.SERIBU,KEP. SERIBU SELATAN,704,0,694,10,0,0,2021-12-27
317206,JAKARTA UTARA,KELAPA GADING,12653,0,12460,192,1,1,2021-12-27
317103,JAKARTA PUSAT,KEMAYORAN,19988,17,19594,373,4,21,2021-12-27
317405,JAKARTA SELATAN,KEBAYORAN LAMA,20062,2,19697,363,0,2,2021-12-27
317407,JAKARTA SELATAN,KEBAYORAN BARU,13889,0,13704,185,0,0,2021-12-27
317306,JAKARTA BARAT,KALI DERES,18037,2,17718,316,1,3,2021-12-27
317108,JAKARTA PUSAT,JOHAR BARU,8688,1,8529,157,1,2,2021-12-27
317305,JAKARTA BARAT,KEBON JERUK,22105,0,21729,375,1,1,2021-12-27
317103,JAKARTA PUSAT,KEMAYORAN,19988,17,19594,373,4,21,2021-12-28
317308,JAKARTA BARAT,KEMBANGAN,20254,1,19950,303,0,1,2021-12-28
310102,KAB.ADM.KEP.SERIBU,KEP. SERIBU SELATAN,704,0,694,10,0,0,2021-12-28
310101,KAB.ADM.KEP.SERIBU,KEP. SERIBU UTARA,640,0,634,6,0,0,2021-12-28
317203,JAKARTA UTARA,KOJA,17240,4,16897,339,0,4,2021-12-28
317504,JAKARTA TIMUR,KRAMAT JATI,21632,0,21230,402,0,0,2021-12-28
317501,JAKARTA TIMUR,MATRAMAN,14229,0,13949,279,1,1,2021-12-28
317403,JAKARTA SELATAN,MAMPANG PRAPATAN,11517,4,11334,179,0,4,2021-12-28
317307,JAKARTA BARAT,PALMERAH,15838,0,15509,329,0,0,2021-12-28
317106,JAKARTA PUSAT,MENTENG,6434,0,6315,119,0,0,2021-12-28
317205,JAKARTA UTARA,PADEMANGAN,12891,0,12727,163,1,1,2021-12-28
317206,JAKARTA UTARA,KELAPA GADING,12654,0,12461,192,1,1,2021-12-28
317508,JAKARTA TIMUR,MAKASAR,17483,1,17184,298,0,1,2021-12-28
317305,JAKARTA BARAT,KEBON JERUK,22106,0,21730,375,1,1,2021-12-28
317510,JAKARTA TIMUR,CIPAYUNG,25208,4,24936,267,1,5,2021-12-28
317407,JAKARTA SELATAN,KEBAYORAN BARU,13889,0,13704,185,0,0,2021-12-28
317306,JAKARTA BARAT,KALI DERES,18039,0,17720,316,3,3,2021-12-28
317108,JAKARTA PUSAT,JOHAR BARU,8688,2,8529,157,0,2,2021-12-28
317503,JAKARTA TIMUR,JATINEGARA,19587,2,19202,383,0,2,2021-12-28
317409,JAKARTA SELATAN,JAGAKARSA,26620,1,26210,406,3,4,2021-12-28
317302,JAKARTA BARAT,GROGOL PETAMBURAN,19090,1,18791,298,0,1,2021-12-28
317101,JAKARTA PUSAT,GAMBIR,8566,0,8432,134,0,0,2021-12-28
317507,JAKARTA TIMUR,DUREN SAWIT,29482,0,28869,611,2,2,2021-12-28
317509,JAKARTA TIMUR,CIRACAS,22523,0,22141,379,3,3,2021-12-28
317204,JAKARTA UTARA,CILINCING,17437,3,17094,340,0,3,2021-12-28
317406,JAKARTA SELATAN,CILANDAK,17703,0,17441,261,1,1,2021-12-28
317301,JAKARTA BARAT,CENGKARENG,28735,0,28175,559,1,1,2021-12-28
317105,JAKARTA PUSAT,CEMPAKA PUTIH,10537,2,10363,168,4,6,2021-12-28
317506,JAKARTA TIMUR,CAKUNG,22671,2,22255,413,1,3,2021-12-28
317405,JAKARTA SELATAN,KEBAYORAN LAMA,20062,1,19698,363,0,1,2021-12-28
317408,JAKARTA SELATAN,PANCORAN,14342,0,14112,227,3,3,2021-12-28
317303,JAKARTA BARAT,TAMAN SARI,8757,0,8617,140,0,0,2021-12-28
317505,JAKARTA TIMUR,PASAR REBO,17648,2,17320,326,0,2,2021-12-28
111111,Luar DKI & Proses Update,Luar DKI & Proses Update,143008,137,141294,1273,304,441,2021-12-28
317404,JAKARTA SELATAN,PASAR MINGGU,23839,0,23412,426,1,1,2021-12-28
317401,JAKARTA SELATAN,TEBET,16959,0,16676,280,3,3,2021-12-28
317202,JAKARTA UTARA,TANJUNG PRIOK,25787,2,25358,425,2,4,2021-12-28
317107,JAKARTA PUSAT,TANAH ABANG,11053,1,10828,223,1,2,2021-12-28
317102,JAKARTA PUSAT,SAWAH BESAR,9162,0,8989,172,1,1,2021-12-28
317402,JAKARTA SELATAN,SETIA BUDI,12002,0,11819,183,0,0,2021-12-28
317410,JAKARTA SELATAN,PESANGGRAHAN,16381,0,16126,252,3,3,2021-12-28
317201,JAKARTA UTARA,PENJARINGAN,18650,2,18417,229,2,4,2021-12-28
317304,JAKARTA BARAT,TAMBORA,14132,1,13878,253,0,1,2021-12-28
317104,JAKARTA PUSAT,SENEN,9396,1,9227,168,0,1,2021-12-28
317502,JAKARTA TIMUR,PULO GADUNG,21807,1,21402,401,3,4,2021-12-28
317105,JAKARTA PUSAT,CEMPAKA PUTIH,10537,2,10365,168,2,4,2021-12-29
317501,JAKARTA TIMUR,MATRAMAN,14229,0,13949,279,1,1,2021-12-29
317106,JAKARTA PUSAT,MENTENG,6434,0,6315,119,0,0,2021-12-29
317205,JAKARTA UTARA,PADEMANGAN,12891,0,12727,163,1,1,2021-12-29
317307,JAKARTA BARAT,PALMERAH,15838,0,15509,329,0,0,2021-12-29
317408,JAKARTA SELATAN,PANCORAN,14342,0,14112,227,3,3,2021-12-29
317404,JAKARTA SELATAN,PASAR MINGGU,23839,0,23412,426,1,1,2021-12-29
317201,JAKARTA UTARA,PENJARINGAN,18650,1,18417,230,2,3,2021-12-29
317506,JAKARTA TIMUR,CAKUNG,22671,2,22255,413,1,3,2021-12-29
317502,JAKARTA TIMUR,PULO GADUNG,21807,1,21402,401,3,4,2021-12-29
317102,JAKARTA PUSAT,SAWAH BESAR,9162,0,8989,172,1,1,2021-12-29
317104,JAKARTA PUSAT,SENEN,9396,1,9227,168,0,1,2021-12-29
317402,JAKARTA SELATAN,SETIA BUDI,12002,0,11819,183,0,0,2021-12-29
317303,JAKARTA BARAT,TAMAN SARI,8757,0,8617,140,0,0,2021-12-29
317304,JAKARTA BARAT,TAMBORA,14132,1,13878,253,0,1,2021-12-29
317107,JAKARTA PUSAT,TANAH ABANG,11054,1,10828,223,2,3,2021-12-29
317202,JAKARTA UTARA,TANJUNG PRIOK,25788,2,25358,425,3,5,2021-12-29
317401,JAKARTA SELATAN,TEBET,16959,0,16676,280,3,3,2021-12-29
111111,Luar DKI & Proses Update,Luar DKI & Proses Update,143008,137,141294,1273,304,441,2021-12-29
317403,JAKARTA SELATAN,MAMPANG PRAPATAN,11519,4,11334,179,2,6,2021-12-29
317508,JAKARTA TIMUR,MAKASAR,17483,1,17184,298,0,1,2021-12-29
317410,JAKARTA SELATAN,PESANGGRAHAN,16381,0,16126,252,3,3,2021-12-29
317203,JAKARTA UTARA,KOJA,17240,4,16897,339,0,4,2021-12-29
317301,JAKARTA BARAT,CENGKARENG,28735,0,28175,559,1,1,2021-12-29
317504,JAKARTA TIMUR,KRAMAT JATI,21633,0,21230,402,1,1,2021-12-29
317406,JAKARTA SELATAN,CILANDAK,17704,0,17441,261,2,2,2021-12-29
317204,JAKARTA UTARA,CILINCING,17437,3,17094,340,0,3,2021-12-29
317510,JAKARTA TIMUR,CIPAYUNG,25206,3,24936,267,0,3,2021-12-29
317509,JAKARTA TIMUR,CIRACAS,22523,0,22141,379,3,3,2021-12-29
317507,JAKARTA TIMUR,DUREN SAWIT,29482,0,28869,611,2,2,2021-12-29
317101,JAKARTA PUSAT,GAMBIR,8566,0,8432,134,0,0,2021-12-29
317302,JAKARTA BARAT,GROGOL PETAMBURAN,19091,1,18791,298,1,2,2021-12-29
317409,JAKARTA SELATAN,JAGAKARSA,26620,1,26210,406,3,4,2021-12-29
317503,JAKARTA TIMUR,JATINEGARA,19588,3,19202,383,0,3,2021-12-29
317505,JAKARTA TIMUR,PASAR REBO,17648,2,17320,326,0,2,2021-12-29
317306,JAKARTA BARAT,KALI DERES,18038,0,17720,316,2,2,2021-12-29
317108,JAKARTA PUSAT,JOHAR BARU,8688,1,8529,158,0,1,2021-12-29
310101,KAB.ADM.KEP.SERIBU,KEP. SERIBU UTARA,640,0,634,6,0,0,2021-12-29
317308,JAKARTA BARAT,KEMBANGAN,20256,2,19950,303,1,3,2021-12-29
317103,JAKARTA PUSAT,KEMAYORAN,19988,16,19599,373,0,16,2021-12-29
310102,KAB.ADM.KEP.SERIBU,KEP. SERIBU SELATAN,704,0,694,10,0,0,2021-12-29
317305,JAKARTA BARAT,KEBON JERUK,22107,0,21730,375,2,2,2021-12-29
317405,JAKARTA SELATAN,KEBAYORAN LAMA,20062,0,19699,363,0,0,2021-12-29
317407,JAKARTA SELATAN,KEBAYORAN BARU,13889,0,13704,185,0,0,2021-12-29
317206,JAKARTA UTARA,KELAPA GADING,12654,0,12461,192,1,1,2021-12-29
317501,JAKARTA TIMUR,MATRAMAN,14230,1,13949,279,1,2,2021-12-30
317505,JAKARTA TIMUR,PASAR REBO,17648,1,17321,326,0,1,2021-12-30
317106,JAKARTA PUSAT,MENTENG,6434,0,6315,119,0,0,2021-12-30
317205,JAKARTA UTARA,PADEMANGAN,12891,0,12727,163,1,1,2021-12-30
317307,JAKARTA BARAT,PALMERAH,15838,0,15509,329,0,0,2021-12-30
317408,JAKARTA SELATAN,PANCORAN,14342,0,14115,227,0,0,2021-12-30
317404,JAKARTA SELATAN,PASAR MINGGU,23840,1,23412,426,1,2,2021-12-30
317201,JAKARTA UTARA,PENJARINGAN,18650,1,18418,230,1,2,2021-12-30
317402,JAKARTA SELATAN,SETIA BUDI,12004,0,11819,183,2,2,2021-12-30
317502,JAKARTA TIMUR,PULO GADUNG,21807,1,21402,401,3,4,2021-12-30
317102,JAKARTA PUSAT,SAWAH BESAR,9165,3,8989,172,1,4,2021-12-30
317104,JAKARTA PUSAT,SENEN,9396,1,9227,168,0,1,2021-12-30
317303,JAKARTA BARAT,TAMAN SARI,8757,0,8617,140,0,0,2021-12-30
317304,JAKARTA BARAT,TAMBORA,14132,1,13878,253,0,1,2021-12-30
317107,JAKARTA PUSAT,TANAH ABANG,11053,1,10828,223,1,2,2021-12-30
317202,JAKARTA UTARA,TANJUNG PRIOK,25788,2,25358,425,3,5,2021-12-30
317401,JAKARTA SELATAN,TEBET,16959,0,16676,280,3,3,2021-12-30
317403,JAKARTA SELATAN,MAMPANG PRAPATAN,11517,4,11334,179,0,4,2021-12-30
317410,JAKARTA SELATAN,PESANGGRAHAN,16381,0,16127,252,2,2,2021-12-30
111111,Luar DKI & Proses Update,Luar DKI & Proses Update,143008,137,141294,1273,304,441,2021-12-30
317504,JAKARTA TIMUR,KRAMAT JATI,21633,0,21230,402,1,1,2021-12-30
317203,JAKARTA UTARA,KOJA,17240,3,16898,339,0,3,2021-12-30
317506,JAKARTA TIMUR,CAKUNG,22671,2,22255,413,1,3,2021-12-30
317105,JAKARTA PUSAT,CEMPAKA PUTIH,10537,1,10367,168,1,2,2021-12-30
317301,JAKARTA BARAT,CENGKARENG,28737,1,28175,559,2,3,2021-12-30
317508,JAKARTA TIMUR,MAKASAR,17484,2,17184,298,0,2,2021-12-30
317406,JAKARTA SELATAN,CILANDAK,17704,0,17441,261,2,2,2021-12-30
317204,JAKARTA UTARA,CILINCING,17437,2,17095,340,0,2,2021-12-30
317510,JAKARTA TIMUR,CIPAYUNG,25207,3,24937,267,0,3,2021-12-30
317509,JAKARTA TIMUR,CIRACAS,22523,0,22142,379,2,2,2021-12-30
317507,JAKARTA TIMUR,DUREN SAWIT,29482,0,28869,611,2,2,2021-12-30
317101,JAKARTA PUSAT,GAMBIR,8568,1,8432,134,1,2,2021-12-30
317302,JAKARTA BARAT,GROGOL PETAMBURAN,19091,1,18792,298,0,1,2021-12-30
310102,KAB.ADM.KEP.SERIBU,KEP. SERIBU SELATAN,704,0,694,10,0,0,2021-12-30
317503,JAKARTA TIMUR,JATINEGARA,19588,3,19202,383,0,3,2021-12-30
317206,JAKARTA UTARA,KELAPA GADING,12654,0,12461,192,1,1,2021-12-30
317103,JAKARTA PUSAT,KEMAYORAN,19988,16,19599,373,0,16,2021-12-30
317308,JAKARTA BARAT,KEMBANGAN,20257,2,19950,303,2,4,2021-12-30
310101,KAB.ADM.KEP.SERIBU,KEP. SERIBU UTARA,640,0,634,6,0,0,2021-12-30
317409,JAKARTA SELATAN,JAGAKARSA,26620,1,26210,406,3,4,2021-12-30
317405,JAKARTA SELATAN,KEBAYORAN LAMA,20062,0,19699,363,0,0,2021-12-30
317407,JAKARTA SELATAN,KEBAYORAN BARU,13890,1,13704,185,0,1,2021-12-30
317306,JAKARTA BARAT,KALI DERES,18039,0,17721,316,2,2,2021-12-30
317108,JAKARTA PUSAT,JOHAR BARU,8688,1,8529,158,0,1,2021-12-30
317305,JAKARTA BARAT,KEBON JERUK,22107,0,21730,375,2,2,2021-12-30
317201,JAKARTA UTARA,PENJARINGAN,18650,1,18418,230,1,2,2021-12-31
317106,JAKARTA PUSAT,MENTENG,6434,0,6315,119,0,0,2021-12-31
317205,JAKARTA UTARA,PADEMANGAN,12891,0,12727,163,1,1,2021-12-31
317307,JAKARTA BARAT,PALMERAH,15840,2,15509,329,0,2,2021-12-31
317408,JAKARTA SELATAN,PANCORAN,14342,0,14115,227,0,0,2021-12-31
317404,JAKARTA SELATAN,PASAR MINGGU,23841,2,23412,426,1,3,2021-12-31
317505,JAKARTA TIMUR,PASAR REBO,17648,1,17321,326,0,1,2021-12-31
317410,JAKARTA SELATAN,PESANGGRAHAN,16381,0,16129,252,0,0,2021-12-31
317402,JAKARTA SELATAN,SETIA BUDI,12003,1,11819,183,0,1,2021-12-31
317102,JAKARTA PUSAT,SAWAH BESAR,9165,3,8989,172,1,4,2021-12-31
317104,JAKARTA PUSAT,SENEN,9396,1,9227,168,0,1,2021-12-31
317501,JAKARTA TIMUR,MATRAMAN,14229,0,13949,279,1,1,2021-12-31
317303,JAKARTA BARAT,TAMAN SARI,8757,0,8617,140,0,0,2021-12-31
317304,JAKARTA BARAT,TAMBORA,14132,1,13878,253,0,1,2021-12-31
317107,JAKARTA PUSAT,TANAH ABANG,11054,2,10828,223,1,3,2021-12-31
317202,JAKARTA UTARA,TANJUNG PRIOK,25789,3,25359,425,2,5,2021-12-31
317401,JAKARTA SELATAN,TEBET,16960,0,16676,280,4,4,2021-12-31
111111,Luar DKI & Proses Update,Luar DKI & Proses Update,143008,137,141294,1273,304,441,2021-12-31
317502,JAKARTA TIMUR,PULO GADUNG,21807,1,21402,401,3,4,2021-12-31
317403,JAKARTA SELATAN,MAMPANG PRAPATAN,11517,4,11334,179,0,4,2021-12-31
317203,JAKARTA UTARA,KOJA,17240,3,16898,339,0,3,2021-12-31
317504,JAKARTA TIMUR,KRAMAT JATI,21634,1,21230,402,1,2,2021-12-31
317506,JAKARTA TIMUR,CAKUNG,22671,2,22256,413,0,2,2021-12-31
317105,JAKARTA PUSAT,CEMPAKA PUTIH,10537,1,10367,168,1,2,2021-12-31
317301,JAKARTA BARAT,CENGKARENG,28737,1,28176,559,1,2,2021-12-31
317406,JAKARTA SELATAN,CILANDAK,17707,1,17441,261,4,5,2021-12-31
317204,JAKARTA UTARA,CILINCING,17437,2,17095,340,0,2,2021-12-31
317510,JAKARTA TIMUR,CIPAYUNG,25207,2,24937,268,0,2,2021-12-31
317509,JAKARTA TIMUR,CIRACAS,22523,0,22144,379,0,0,2021-12-31
317507,JAKARTA TIMUR,DUREN SAWIT,29482,0,28869,611,2,2,2021-12-31
317101,JAKARTA PUSAT,GAMBIR,8568,1,8432,134,1,2,2021-12-31
317508,JAKARTA TIMUR,MAKASAR,17483,1,17184,298,0,1,2021-12-31
317302,JAKARTA BARAT,GROGOL PETAMBURAN,19094,2,18792,298,2,4,2021-12-31
317503,JAKARTA TIMUR,JATINEGARA,19589,4,19202,383,0,4,2021-12-31
317108,JAKARTA PUSAT,JOHAR BARU,8689,1,8529,158,1,2,2021-12-31
317306,JAKARTA BARAT,KALI DERES,18039,0,17721,316,2,2,2021-12-31
317407,JAKARTA SELATAN,KEBAYORAN BARU,13890,1,13704,185,0,1,2021-12-31
317305,JAKARTA BARAT,KEBON JERUK,22109,0,21731,375,3,3,2021-12-31
317206,JAKARTA UTARA,KELAPA GADING,12654,0,12461,192,1,1,2021-12-31
317103,JAKARTA PUSAT,KEMAYORAN,19988,16,19599,373,0,16,2021-12-31
317308,JAKARTA BARAT,KEMBANGAN,20259,4,19950,303,2,6,2021-12-31
310102,KAB.ADM.KEP.SERIBU,KEP. SERIBU SELATAN,704,0,694,10,0,0,2021-12-31
310101,KAB.ADM.KEP.SERIBU,KEP. SERIBU UTARA,640,0,634,6,0,0,2021-12-31
317409,JAKARTA SELATAN,JAGAKARSA,26621,1,26211,406,3,4,2021-12-31
317405,JAKARTA SELATAN,KEBAYORAN LAMA,20062,0,19699,363,0,0,2021-12-31
317506,JAKARTA TIMUR,CAKUNG,22671,2,22256,413,0,2,2022-01-01
317105,JAKARTA PUSAT,CEMPAKA PUTIH,10538,2,10367,168,1,3,2022-01-01
317301,JAKARTA BARAT,CENGKARENG,28737,0,28176,559,2,2,2022-01-01
317406,JAKARTA SELATAN,CILANDAK,17708,2,17442,261,3,5,2022-01-01
317204,JAKARTA UTARA,CILINCING,17437,2,17095,340,0,2,2022-01-01
317510,JAKARTA TIMUR,CIPAYUNG,25207,2,24937,268,0,2,2022-01-01
317509,JAKARTA TIMUR,CIRACAS,22523,0,22144,379,0,0,2022-01-01
317507,JAKARTA TIMUR,DUREN SAWIT,29482,0,28869,611,2,2,2022-01-01
317101,JAKARTA PUSAT,GAMBIR,8569,1,8432,134,2,3,2022-01-01
317302,JAKARTA BARAT,GROGOL PETAMBURAN,19093,2,18792,298,1,3,2022-01-01
317409,JAKARTA SELATAN,JAGAKARSA,26622,2,26211,406,3,5,2022-01-01
317503,JAKARTA TIMUR,JATINEGARA,19589,4,19202,383,0,4,2022-01-01
317108,JAKARTA PUSAT,JOHAR BARU,8689,1,8529,158,1,2,2022-01-01
317306,JAKARTA BARAT,KALI DERES,18042,3,17721,316,2,5,2022-01-01
317407,JAKARTA SELATAN,KEBAYORAN BARU,13890,1,13704,185,0,1,2022-01-01
317405,JAKARTA SELATAN,KEBAYORAN LAMA,20062,0,19699,363,0,0,2022-01-01
317305,JAKARTA BARAT,KEBON JERUK,22111,0,21731,375,5,5,2022-01-01
317206,JAKARTA UTARA,KELAPA GADING,12654,0,12461,192,1,1,2022-01-01
317103,JAKARTA PUSAT,KEMAYORAN,19988,16,19599,373,0,16,2022-01-01
317308,JAKARTA BARAT,KEMBANGAN,20257,2,19950,303,2,4,2022-01-01
310102,KAB.ADM.KEP.SERIBU,KEP. SERIBU SELATAN,704,0,694,10,0,0,2022-01-01
310101,KAB.ADM.KEP.SERIBU,KEP. SERIBU UTARA,640,0,634,6,0,0,2022-01-01
317203,JAKARTA UTARA,KOJA,17240,3,16898,339,0,3,2022-01-01
317504,JAKARTA TIMUR,KRAMAT JATI,21634,1,21230,402,1,2,2022-01-01
111111,LUAR DKI JAKARTA,LUAR DKI JAKARTA,92180,1,91557,618,4,5,2022-01-01
317508,JAKARTA TIMUR,MAKASAR,17483,1,17184,298,0,1,2022-01-01
317403,JAKARTA SELATAN,MAMPANG PRAPATAN,11518,3,11335,179,1,4,2022-01-01
317501,JAKARTA TIMUR,MATRAMAN,14229,0,13949,279,1,1,2022-01-01
317106,JAKARTA PUSAT,MENTENG,6434,0,6315,119,0,0,2022-01-01
317205,JAKARTA UTARA,PADEMANGAN,12891,0,12727,163,1,1,2022-01-01
317307,JAKARTA BARAT,PALMERAH,15840,2,15509,329,0,2,2022-01-01
317408,JAKARTA SELATAN,PANCORAN,14342,0,14115,227,0,0,2022-01-01
317404,JAKARTA SELATAN,PASAR MINGGU,23841,2,23412,426,1,3,2022-01-01
317505,JAKARTA TIMUR,PASAR REBO,17648,1,17321,326,0,1,2022-01-01
317201,JAKARTA UTARA,PENJARINGAN,18650,1,18419,230,0,1,2022-01-01
317410,JAKARTA SELATAN,PESANGGRAHAN,16381,0,16129,252,0,0,2022-01-01
111111,PROSES UPDATE DATA,PROSES UPDATE DATA,50828,136,49737,655,300,436,2022-01-01
317502,JAKARTA TIMUR,PULO GADUNG,21807,1,21402,401,3,4,2022-01-01
317102,JAKARTA PUSAT,SAWAH BESAR,9165,3,8989,172,1,4,2022-01-01
317104,JAKARTA PUSAT,SENEN,9396,1,9227,168,0,1,2022-01-01
317402,JAKARTA SELATAN,SETIA BUDI,12003,1,11819,183,0,1,2022-01-01
317303,JAKARTA BARAT,TAMAN SARI,8757,0,8617,140,0,0,2022-01-01
317304,JAKARTA BARAT,TAMBORA,14132,1,13878,253,0,1,2022-01-01
317107,JAKARTA PUSAT,TANAH ABANG,11054,2,10828,223,1,3,2022-01-01
317202,JAKARTA UTARA,TANJUNG PRIOK,25789,3,25359,425,2,5,2022-01-01
317401,JAKARTA SELATAN,TEBET,16960,0,16679,280,1,1,2022-01-01
317506,JAKARTA TIMUR,CAKUNG,22671,0,22258,413,0,0,2022-01-02
317105,JAKARTA PUSAT,CEMPAKA PUTIH,10538,1,10368,168,1,2,2022-01-02
317301,JAKARTA BARAT,CENGKARENG,28737,0,28176,559,2,2,2022-01-02
317406,JAKARTA SELATAN,CILANDAK,17709,2,17442,261,4,6,2022-01-02
317204,JAKARTA UTARA,CILINCING,17437,0,17097,340,0,0,2022-01-02
317510,JAKARTA TIMUR,CIPAYUNG,25207,1,24938,268,0,1,2022-01-02
317509,JAKARTA TIMUR,CIRACAS,22523,0,22144,379,0,0,2022-01-02
317507,JAKARTA TIMUR,DUREN SAWIT,29482,0,28869,611,2,2,2022-01-02
317101,JAKARTA PUSAT,GAMBIR,8569,1,8432,134,2,3,2022-01-02
317302,JAKARTA BARAT,GROGOL PETAMBURAN,19094,2,18792,298,2,4,2022-01-02
317409,JAKARTA SELATAN,JAGAKARSA,26622,2,26211,406,3,5,2022-01-02
317503,JAKARTA TIMUR,JATINEGARA,19589,2,19204,383,0,2,2022-01-02
317108,JAKARTA PUSAT,JOHAR BARU,8689,0,8530,158,1,1,2022-01-02
317306,JAKARTA BARAT,KALI DERES,18044,3,17721,316,4,7,2022-01-02
317407,JAKARTA SELATAN,KEBAYORAN BARU,13889,0,13704,185,0,0,2022-01-02
317405,JAKARTA SELATAN,KEBAYORAN LAMA,20063,1,19699,363,0,1,2022-01-02
317305,JAKARTA BARAT,KEBON JERUK,22112,0,21731,375,6,6,2022-01-02
317206,JAKARTA UTARA,KELAPA GADING,12654,0,12461,192,1,1,2022-01-02
317103,JAKARTA PUSAT,KEMAYORAN,19989,0,19615,373,1,1,2022-01-02
317308,JAKARTA BARAT,KEMBANGAN,20257,1,19951,303,2,3,2022-01-02
310102,KAB.ADM.KEP.SERIBU,KEP. SERIBU SELATAN,704,0,694,10,0,0,2022-01-02
310101,KAB.ADM.KEP.SERIBU,KEP. SERIBU UTARA,640,0,634,6,0,0,2022-01-02
317203,JAKARTA UTARA,KOJA,17240,1,16900,339,0,1,2022-01-02
317504,JAKARTA TIMUR,KRAMAT JATI,21634,1,21230,402,1,2,2022-01-02
111111,LUAR DKI JAKARTA,LUAR DKI JAKARTA,92180,0,91560,618,2,2,2022-01-02
317508,JAKARTA TIMUR,MAKASAR,17483,0,17185,298,0,0,2022-01-02
317403,JAKARTA SELATAN,MAMPANG PRAPATAN,11518,1,11337,179,1,2,2022-01-02
317501,JAKARTA TIMUR,MATRAMAN,14229,0,13949,279,1,1,2022-01-02
317106,JAKARTA PUSAT,MENTENG,6434,0,6315,119,0,0,2022-01-02
317205,JAKARTA UTARA,PADEMANGAN,12891,0,12727,163,1,1,2022-01-02
317307,JAKARTA BARAT,PALMERAH,15841,3,15509,329,0,3,2022-01-02
317408,JAKARTA SELATAN,PANCORAN,14343,0,14115,227,1,1,2022-01-02
317404,JAKARTA SELATAN,PASAR MINGGU,23841,2,23412,426,1,3,2022-01-02
317505,JAKARTA TIMUR,PASAR REBO,17648,0,17322,326,0,0,2022-01-02
317201,JAKARTA UTARA,PENJARINGAN,18651,1,18420,230,0,1,2022-01-02
317410,JAKARTA SELATAN,PESANGGRAHAN,16381,0,16129,252,0,0,2022-01-02
111111,PROSES UPDATE DATA,PROSES UPDATE DATA,50921,83,49802,655,381,464,2022-01-02
317502,JAKARTA TIMUR,PULO GADUNG,21807,0,21403,401,3,3,2022-01-02
317102,JAKARTA PUSAT,SAWAH BESAR,9165,3,8989,172,1,4,2022-01-02
317104,JAKARTA PUSAT,SENEN,9396,0,9228,168,0,0,2022-01-02
317402,JAKARTA SELATAN,SETIA BUDI,12003,1,11819,183,0,1,2022-01-02
317303,JAKARTA BARAT,TAMAN SARI,8757,0,8617,140,0,0,2022-01-02
317304,JAKARTA BARAT,TAMBORA,14132,0,13879,253,0,0,2022-01-02
317107,JAKARTA PUSAT,TANAH ABANG,11054,2,10829,223,0,2,2022-01-02
317202,JAKARTA UTARA,TANJUNG PRIOK,25789,2,25360,425,2,4,2022-01-02
317401,JAKARTA SELATAN,TEBET,16961,0,16679,280,2,2,2022-01-02
317506,JAKARTA TIMUR,CAKUNG,22671,0,22258,413,0,0,2022-01-03
317105,JAKARTA PUSAT,CEMPAKA PUTIH,10538,1,10369,168,0,1,2022-01-03
317301,JAKARTA BARAT,CENGKARENG,28738,0,28176,559,3,3,2022-01-03
317406,JAKARTA SELATAN,CILANDAK,17710,2,17442,261,5,7,2022-01-03
317204,JAKARTA UTARA,CILINCING,17437,0,17097,340,0,0,2022-01-03
317510,JAKARTA TIMUR,CIPAYUNG,25207,1,24938,268,0,1,2022-01-03
317509,JAKARTA TIMUR,CIRACAS,22524,0,22144,379,1,1,2022-01-03
317507,JAKARTA TIMUR,DUREN SAWIT,29482,0,28869,611,2,2,2022-01-03
317101,JAKARTA PUSAT,GAMBIR,8570,1,8432,134,3,4,2022-01-03
317302,JAKARTA BARAT,GROGOL PETAMBURAN,19094,2,18792,298,2,4,2022-01-03
317409,JAKARTA SELATAN,JAGAKARSA,26622,2,26211,406,3,5,2022-01-03
317503,JAKARTA TIMUR,JATINEGARA,19589,2,19204,383,0,2,2022-01-03
317108,JAKARTA PUSAT,JOHAR BARU,8689,0,8530,158,1,1,2022-01-03
317306,JAKARTA BARAT,KALI DERES,18043,3,17722,316,2,5,2022-01-03
317407,JAKARTA SELATAN,KEBAYORAN BARU,13891,1,13704,185,1,2,2022-01-03
317405,JAKARTA SELATAN,KEBAYORAN LAMA,20064,2,19699,363,0,2,2022-01-03
317305,JAKARTA BARAT,KEBON JERUK,22116,2,21731,375,8,10,2022-01-03
317206,JAKARTA UTARA,KELAPA GADING,12655,1,12461,192,1,2,2022-01-03
317103,JAKARTA PUSAT,KEMAYORAN,19989,0,19615,373,1,1,2022-01-03
317308,JAKARTA BARAT,KEMBANGAN,20270,1,19951,303,15,16,2022-01-03
310102,KAB.ADM.KEP.SERIBU,KEP. SERIBU SELATAN,704,0,694,10,0,0,2022-01-03
310101,KAB.ADM.KEP.SERIBU,KEP. SERIBU UTARA,640,0,634,6,0,0,2022-01-03
317203,JAKARTA UTARA,KOJA,17240,1,16900,339,0,1,2022-01-03
317504,JAKARTA TIMUR,KRAMAT JATI,21635,2,21230,402,1,3,2022-01-03
111111,LUAR DKI JAKARTA,LUAR DKI JAKARTA,92180,0,91560,618,2,2,2022-01-03
317508,JAKARTA TIMUR,MAKASAR,17485,1,17185,298,1,2,2022-01-03
317403,JAKARTA SELATAN,MAMPANG PRAPATAN,11518,0,11338,179,1,1,2022-01-03
317501,JAKARTA TIMUR,MATRAMAN,14229,0,13950,279,0,0,2022-01-03
317106,JAKARTA PUSAT,MENTENG,6434,0,6315,119,0,0,2022-01-03
317205,JAKARTA UTARA,PADEMANGAN,12891,0,12727,163,1,1,2022-01-03
317307,JAKARTA BARAT,PALMERAH,15841,3,15509,329,0,3,2022-01-03
317408,JAKARTA SELATAN,PANCORAN,14343,0,14115,227,1,1,2022-01-03
317404,JAKARTA SELATAN,PASAR MINGGU,23841,2,23412,426,1,3,2022-01-03
317505,JAKARTA TIMUR,PASAR REBO,17649,1,17322,326,0,1,2022-01-03
317201,JAKARTA UTARA,PENJARINGAN,18654,3,18420,230,1,4,2022-01-03
317410,JAKARTA SELATAN,PESANGGRAHAN,16381,0,16129,252,0,0,2022-01-03
111111,PROSES UPDATE DATA,PROSES UPDATE DATA,51058,98,49814,655,491,589,2022-01-03
317502,JAKARTA TIMUR,PULO GADUNG,21807,0,21406,401,0,0,2022-01-03
317102,JAKARTA PUSAT,SAWAH BESAR,9165,3,8989,172,1,4,2022-01-03
317104,JAKARTA PUSAT,SENEN,9396,0,9228,168,0,0,2022-01-03
317402,JAKARTA SELATAN,SETIA BUDI,12004,2,11819,183,0,2,2022-01-03
317303,JAKARTA BARAT,TAMAN SARI,8759,1,8617,140,1,2,2022-01-03
317304,JAKARTA BARAT,TAMBORA,14132,0,13879,253,0,0,2022-01-03
317107,JAKARTA PUSAT,TANAH ABANG,11054,1,10830,223,0,1,2022-01-03
317202,JAKARTA UTARA,TANJUNG PRIOK,25790,1,25362,425,2,3,2022-01-03
317401,JAKARTA SELATAN,TEBET,16961,0,16679,280,2,2,2022-01-03
317506,JAKARTA TIMUR,CAKUNG,22671,0,22258,413,0,0,2022-01-04
317105,JAKARTA PUSAT,CEMPAKA PUTIH,10539,2,10369,168,0,2,2022-01-04
317301,JAKARTA BARAT,CENGKARENG,28739,1,28176,559,3,4,2022-01-04
317406,JAKARTA SELATAN,CILANDAK,17708,2,17442,261,3,5,2022-01-04
317204,JAKARTA UTARA,CILINCING,17437,0,17097,340,0,0,2022-01-04
317510,JAKARTA TIMUR,CIPAYUNG,25207,1,24938,268,0,1,2022-01-04
317509,JAKARTA TIMUR,CIRACAS,22524,0,22144,379,1,1,2022-01-04
317507,JAKARTA TIMUR,DUREN SAWIT,29483,0,28870,611,2,2,2022-01-04
317101,JAKARTA PUSAT,GAMBIR,8568,1,8432,134,1,2,2022-01-04
317302,JAKARTA BARAT,GROGOL PETAMBURAN,19095,2,18792,298,3,5,2022-01-04
317409,JAKARTA SELATAN,JAGAKARSA,26622,2,26213,406,1,3,2022-01-04
317503,JAKARTA TIMUR,JATINEGARA,19589,2,19204,383,0,2,2022-01-04
317108,JAKARTA PUSAT,JOHAR BARU,8689,0,8530,158,1,1,2022-01-04
317306,JAKARTA BARAT,KALI DERES,18050,3,17722,316,9,12,2022-01-04
317407,JAKARTA SELATAN,KEBAYORAN BARU,13891,1,13704,185,1,2,2022-01-04
317405,JAKARTA SELATAN,KEBAYORAN LAMA,20066,2,19699,363,2,4,2022-01-04
317305,JAKARTA BARAT,KEBON JERUK,22116,2,21731,375,8,10,2022-01-04
317206,JAKARTA UTARA,KELAPA GADING,12656,2,12461,192,1,3,2022-01-04
317103,JAKARTA PUSAT,KEMAYORAN,19989,0,19615,373,1,1,2022-01-04
317308,JAKARTA BARAT,KEMBANGAN,20271,1,19951,303,16,17,2022-01-04
310102,KAB.ADM.KEP.SERIBU,KEP. SERIBU SELATAN,704,0,694,10,0,0,2022-01-04
310101,KAB.ADM.KEP.SERIBU,KEP. SERIBU UTARA,640,0,634,6,0,0,2022-01-04
317203,JAKARTA UTARA,KOJA,17239,0,16900,339,0,0,2022-01-04
317504,JAKARTA TIMUR,KRAMAT JATI,21635,2,21230,402,1,3,2022-01-04
111111,LUAR DKI JAKARTA,LUAR DKI JAKARTA,92180,0,91560,618,2,2,2022-01-04
317508,JAKARTA TIMUR,MAKASAR,17485,1,17185,298,1,2,2022-01-04
317403,JAKARTA SELATAN,MAMPANG PRAPATAN,11519,1,11338,179,1,2,2022-01-04
317501,JAKARTA TIMUR,MATRAMAN,14229,0,13950,279,0,0,2022-01-04
317106,JAKARTA PUSAT,MENTENG,6434,0,6315,119,0,0,2022-01-04
317205,JAKARTA UTARA,PADEMANGAN,12893,2,12727,163,1,3,2022-01-04
317307,JAKARTA BARAT,PALMERAH,15841,3,15509,329,0,3,2022-01-04
317408,JAKARTA SELATAN,PANCORAN,14343,0,14115,227,1,1,2022-01-04
317404,JAKARTA SELATAN,PASAR MINGGU,23841,2,23413,426,0,2,2022-01-04
317505,JAKARTA TIMUR,PASAR REBO,17649,1,17322,326,0,1,2022-01-04
317201,JAKARTA UTARA,PENJARINGAN,18655,3,18420,230,2,5,2022-01-04
317410,JAKARTA SELATAN,PESANGGRAHAN,16383,0,16129,252,2,2,2022-01-04
111111,PROSES UPDATE DATA,PROSES UPDATE DATA,51151,92,49851,655,553,645,2022-01-04
317502,JAKARTA TIMUR,PULO GADUNG,21807,0,21406,401,0,0,2022-01-04
317102,JAKARTA PUSAT,SAWAH BESAR,9166,4,8989,172,1,5,2022-01-04
317104,JAKARTA PUSAT,SENEN,9396,0,9228,168,0,0,2022-01-04
317402,JAKARTA SELATAN,SETIA BUDI,12005,2,11819,183,1,3,2022-01-04
317303,JAKARTA BARAT,TAMAN SARI,8759,1,8617,140,1,2,2022-01-04
317304,JAKARTA BARAT,TAMBORA,14134,1,13879,253,1,2,2022-01-04
317107,JAKARTA PUSAT,TANAH ABANG,11054,1,10830,223,0,1,2022-01-04
317202,JAKARTA UTARA,TANJUNG PRIOK,25790,0,25362,425,3,3,2022-01-04
317401,JAKARTA SELATAN,TEBET,16963,1,16679,280,3,4,2022-01-04
317506,JAKARTA TIMUR,CAKUNG,22671,0,22258,413,0,0,2022-01-05
317105,JAKARTA PUSAT,CEMPAKA PUTIH,10540,3,10369,168,0,3,2022-01-05
317301,JAKARTA BARAT,CENGKARENG,28739,1,28176,559,3,4,2022-01-05
317406,JAKARTA SELATAN,CILANDAK,17708,2,17442,261,3,5,2022-01-05
317204,JAKARTA UTARA,CILINCING,17437,0,17097,340,0,0,2022-01-05
317510,JAKARTA TIMUR,CIPAYUNG,25207,1,24938,268,0,1,2022-01-05
317509,JAKARTA TIMUR,CIRACAS,22524,0,22144,379,1,1,2022-01-05
317507,JAKARTA TIMUR,DUREN SAWIT,29484,0,28870,611,3,3,2022-01-05
317101,JAKARTA PUSAT,GAMBIR,8571,3,8432,134,2,5,2022-01-05
317302,JAKARTA BARAT,GROGOL PETAMBURAN,19095,2,18792,298,3,5,2022-01-05
317409,JAKARTA SELATAN,JAGAKARSA,26623,1,26214,406,2,3,2022-01-05
317503,JAKARTA TIMUR,JATINEGARA,19589,2,19204,383,0,2,2022-01-05
317108,JAKARTA PUSAT,JOHAR BARU,8689,0,8530,158,1,1,2022-01-05
317306,JAKARTA BARAT,KALI DERES,18052,3,17722,316,11,14,2022-01-05
317407,JAKARTA SELATAN,KEBAYORAN BARU,13891,0,13704,185,2,2,2022-01-05
317405,JAKARTA SELATAN,KEBAYORAN LAMA,20067,3,19699,363,2,5,2022-01-05
317305,JAKARTA BARAT,KEBON JERUK,22118,4,21731,375,8,12,2022-01-05
317206,JAKARTA UTARA,KELAPA GADING,12656,2,12461,193,0,2,2022-01-05
317103,JAKARTA PUSAT,KEMAYORAN,19991,0,19615,373,3,3,2022-01-05
317308,JAKARTA BARAT,KEMBANGAN,20271,1,19952,303,15,16,2022-01-05
310102,KAB.ADM.KEP.SERIBU,KEP. SERIBU SELATAN,704,0,694,10,0,0,2022-01-05
310101,KAB.ADM.KEP.SERIBU,KEP. SERIBU UTARA,640,0,634,6,0,0,2022-01-05
317203,JAKARTA UTARA,KOJA,17240,1,16900,339,0,1,2022-01-05
317504,JAKARTA TIMUR,KRAMAT JATI,21636,2,21230,402,2,4,2022-01-05
111111,LUAR DKI JAKARTA,LUAR DKI JAKARTA,92183,2,91561,618,2,4,2022-01-05
317508,JAKARTA TIMUR,MAKASAR,17486,2,17185,298,1,3,2022-01-05
317403,JAKARTA SELATAN,MAMPANG PRAPATAN,11519,1,11338,179,1,2,2022-01-05
317501,JAKARTA TIMUR,MATRAMAN,14229,0,13950,279,0,0,2022-01-05
317106,JAKARTA PUSAT,MENTENG,6434,0,6315,119,0,0,2022-01-05
317205,JAKARTA UTARA,PADEMANGAN,12893,2,12728,163,0,2,2022-01-05
317307,JAKARTA BARAT,PALMERAH,15845,7,15509,329,0,7,2022-01-05
317408,JAKARTA SELATAN,PANCORAN,14343,0,14115,227,1,1,2022-01-05
317404,JAKARTA SELATAN,PASAR MINGGU,23841,2,23413,426,0,2,2022-01-05
317505,JAKARTA TIMUR,PASAR REBO,17650,2,17322,326,0,2,2022-01-05
317201,JAKARTA UTARA,PENJARINGAN,18656,3,18420,230,3,6,2022-01-05
317410,JAKARTA SELATAN,PESANGGRAHAN,16384,1,16129,252,2,3,2022-01-05
111111,PROSES UPDATE DATA,PROSES UPDATE DATA,51378,101,49918,655,704,805,2022-01-05
317502,JAKARTA TIMUR,PULO GADUNG,21807,0,21406,401,0,0,2022-01-05
317102,JAKARTA PUSAT,SAWAH BESAR,9166,4,8989,172,1,5,2022-01-05
317104,JAKARTA PUSAT,SENEN,9396,0,9228,168,0,0,2022-01-05
317402,JAKARTA SELATAN,SETIA BUDI,12006,3,11819,183,1,4,2022-01-05
317303,JAKARTA BARAT,TAMAN SARI,8760,3,8617,140,0,3,2022-01-05
317304,JAKARTA BARAT,TAMBORA,14136,1,13879,253,3,4,2022-01-05
317107,JAKARTA PUSAT,TANAH ABANG,11054,1,10830,223,0,1,2022-01-05
317202,JAKARTA UTARA,TANJUNG PRIOK,25790,0,25362,425,3,3,2022-01-05
317401,JAKARTA SELATAN,TEBET,16965,2,16679,280,4,6,2022-01-05
317506,JAKARTA TIMUR,CAKUNG,22671,0,22258,413,0,0,2022-01-06
317105,JAKARTA PUSAT,CEMPAKA PUTIH,10540,3,10369,168,0,3,2022-01-06
317301,JAKARTA BARAT,CENGKARENG,28736,0,28176,559,1,1,2022-01-06
317406,JAKARTA SELATAN,CILANDAK,17709,3,17443,261,2,5,2022-01-06
317204,JAKARTA UTARA,CILINCING,17437,0,17097,340,0,0,2022-01-06
317510,JAKARTA TIMUR,CIPAYUNG,25207,1,24938,268,0,1,2022-01-06
317509,JAKARTA TIMUR,CIRACAS,22524,0,22144,379,1,1,2022-01-06
317507,JAKARTA TIMUR,DUREN SAWIT,29485,0,28871,611,3,3,2022-01-06
317101,JAKARTA PUSAT,GAMBIR,8569,1,8432,134,2,3,2022-01-06
317302,JAKARTA BARAT,GROGOL PETAMBURAN,19097,3,18792,298,4,7,2022-01-06
317409,JAKARTA SELATAN,JAGAKARSA,26623,2,26214,406,1,3,2022-01-06
317503,JAKARTA TIMUR,JATINEGARA,19590,2,19205,383,0,2,2022-01-06
317108,JAKARTA PUSAT,JOHAR BARU,8689,0,8530,158,1,1,2022-01-06
317306,JAKARTA BARAT,KALI DERES,18056,4,17722,316,14,18,2022-01-06
317407,JAKARTA SELATAN,KEBAYORAN BARU,13891,0,13704,185,2,2,2022-01-06
317405,JAKARTA SELATAN,KEBAYORAN LAMA,20068,3,19700,363,2,5,2022-01-06
317305,JAKARTA BARAT,KEBON JERUK,22120,5,21731,375,9,14,2022-01-06
317206,JAKARTA UTARA,KELAPA GADING,12657,3,12461,193,0,3,2022-01-06
317103,JAKARTA PUSAT,KEMAYORAN,19991,0,19615,373,3,3,2022-01-06
317308,JAKARTA BARAT,KEMBANGAN,20272,1,19953,303,15,16,2022-01-06
310102,KAB.ADM.KEP.SERIBU,KEP. SERIBU SELATAN,704,0,694,10,0,0,2022-01-06
310101,KAB.ADM.KEP.SERIBU,KEP. SERIBU UTARA,640,0,634,6,0,0,2022-01-06
317203,JAKARTA UTARA,KOJA,17240,1,16900,339,0,1,2022-01-06
317504,JAKARTA TIMUR,KRAMAT JATI,21636,2,21230,402,2,4,2022-01-06
111111,LUAR DKI JAKARTA,LUAR DKI JAKARTA,92187,5,91561,618,3,8,2022-01-06
317508,JAKARTA TIMUR,MAKASAR,17486,2,17185,298,1,3,2022-01-06
317403,JAKARTA SELATAN,MAMPANG PRAPATAN,11520,1,11338,179,2,3,2022-01-06
317501,JAKARTA TIMUR,MATRAMAN,14229,0,13950,279,0,0,2022-01-06
317106,JAKARTA PUSAT,MENTENG,6434,0,6315,119,0,0,2022-01-06
317205,JAKARTA UTARA,PADEMANGAN,12891,1,12727,163,0,1,2022-01-06
317307,JAKARTA BARAT,PALMERAH,15846,7,15509,329,1,8,2022-01-06
317408,JAKARTA SELATAN,PANCORAN,14342,0,14115,227,0,0,2022-01-06
317404,JAKARTA SELATAN,PASAR MINGGU,23841,2,23413,426,0,2,2022-01-06
317505,JAKARTA TIMUR,PASAR REBO,17650,2,17322,326,0,2,2022-01-06
317201,JAKARTA UTARA,PENJARINGAN,18656,3,18420,230,3,6,2022-01-06
317410,JAKARTA SELATAN,PESANGGRAHAN,16384,1,16129,252,2,3,2022-01-06
111111,PROSES UPDATE DATA,PROSES UPDATE DATA,51627,140,49964,655,868,1008,2022-01-06
317502,JAKARTA TIMUR,PULO GADUNG,21807,0,21406,401,0,0,2022-01-06
317102,JAKARTA PUSAT,SAWAH BESAR,9166,4,8990,172,0,4,2022-01-06
317104,JAKARTA PUSAT,SENEN,9396,0,9228,168,0,0,2022-01-06
317402,JAKARTA SELATAN,SETIA BUDI,12004,1,11819,183,1,2,2022-01-06
317303,JAKARTA BARAT,TAMAN SARI,8761,3,8617,140,1,4,2022-01-06
317304,JAKARTA BARAT,TAMBORA,14139,4,13879,253,3,7,2022-01-06
317107,JAKARTA PUSAT,TANAH ABANG,11055,1,10830,223,1,2,2022-01-06
317202,JAKARTA UTARA,TANJUNG PRIOK,25793,2,25363,425,3,5,2022-01-06
317401,JAKARTA SELATAN,TEBET,16965,1,16679,280,5,6,2022-01-06
317506,JAKARTA TIMUR,CAKUNG,22673,1,22258,413,1,2,2022-01-07
317105,JAKARTA PUSAT,CEMPAKA PUTIH,10541,3,10369,168,1,4,2022-01-07
317301,JAKARTA BARAT,CENGKARENG,28738,0,28177,559,2,2,2022-01-07
317406,JAKARTA SELATAN,CILANDAK,17709,3,17443,261,2,5,2022-01-07
317204,JAKARTA UTARA,CILINCING,17441,1,17097,340,3,4,2022-01-07
317510,JAKARTA TIMUR,CIPAYUNG,25209,2,24938,268,1,3,2022-01-07
317509,JAKARTA TIMUR,CIRACAS,22524,0,22144,379,1,1,2022-01-07
317507,JAKARTA TIMUR,DUREN SAWIT,29485,0,28871,611,3,3,2022-01-07
317101,JAKARTA PUSAT,GAMBIR,8569,0,8433,134,2,2,2022-01-07
317302,JAKARTA BARAT,GROGOL PETAMBURAN,19097,1,18793,298,5,6,2022-01-07
317409,JAKARTA SELATAN,JAGAKARSA,26626,2,26214,406,4,6,2022-01-07
317503,JAKARTA TIMUR,JATINEGARA,19592,2,19205,383,2,4,2022-01-07
317108,JAKARTA PUSAT,JOHAR BARU,8689,0,8530,158,1,1,2022-01-07
317306,JAKARTA BARAT,KALI DERES,18057,5,17722,316,14,19,2022-01-07
317407,JAKARTA SELATAN,KEBAYORAN BARU,13891,0,13704,185,2,2,2022-01-07
317405,JAKARTA SELATAN,KEBAYORAN LAMA,20069,2,19700,363,4,6,2022-01-07
317305,JAKARTA BARAT,KEBON JERUK,22121,5,21732,375,9,14,2022-01-07
317206,JAKARTA UTARA,KELAPA GADING,12660,4,12461,193,2,6,2022-01-07
317103,JAKARTA PUSAT,KEMAYORAN,19991,0,19615,373,3,3,2022-01-07
317308,JAKARTA BARAT,KEMBANGAN,20275,2,19953,303,17,19,2022-01-07
310102,KAB.ADM.KEP.SERIBU,KEP. SERIBU SELATAN,704,0,694,10,0,0,2022-01-07
310101,KAB.ADM.KEP.SERIBU,KEP. SERIBU UTARA,640,0,634,6,0,0,2022-01-07
317203,JAKARTA UTARA,KOJA,17240,1,16900,339,0,1,2022-01-07
317504,JAKARTA TIMUR,KRAMAT JATI,21638,2,21231,402,3,5,2022-01-07
111111,LUAR DKI JAKARTA,LUAR DKI JAKARTA,92188,7,91561,618,2,9,2022-01-07
317508,JAKARTA TIMUR,MAKASAR,17487,3,17185,298,1,4,2022-01-07
317403,JAKARTA SELATAN,MAMPANG PRAPATAN,11520,2,11338,179,1,3,2022-01-07
317501,JAKARTA TIMUR,MATRAMAN,14231,1,13950,279,1,2,2022-01-07
317106,JAKARTA PUSAT,MENTENG,6434,0,6315,119,0,0,2022-01-07
317205,JAKARTA UTARA,PADEMANGAN,12894,2,12727,163,2,4,2022-01-07
317307,JAKARTA BARAT,PALMERAH,15846,7,15509,329,1,8,2022-01-07
317408,JAKARTA SELATAN,PANCORAN,14342,0,14115,227,0,0,2022-01-07
317404,JAKARTA SELATAN,PASAR MINGGU,23842,2,23414,426,0,2,2022-01-07
317505,JAKARTA TIMUR,PASAR REBO,17649,1,17322,326,0,1,2022-01-07
317201,JAKARTA UTARA,PENJARINGAN,18656,3,18420,230,3,6,2022-01-07
317410,JAKARTA SELATAN,PESANGGRAHAN,16384,1,16129,252,2,3,2022-01-07
111111,PROSES UPDATE DATA,PROSES UPDATE DATA,51880,142,50030,655,1053,1195,2022-01-07
317502,JAKARTA TIMUR,PULO GADUNG,21807,0,21406,401,0,0,2022-01-07
317102,JAKARTA PUSAT,SAWAH BESAR,9169,2,8994,172,1,3,2022-01-07
317104,JAKARTA PUSAT,SENEN,9397,0,9228,168,1,1,2022-01-07
317402,JAKARTA SELATAN,SETIA BUDI,12004,1,11819,183,1,2,2022-01-07
317303,JAKARTA BARAT,TAMAN SARI,8764,3,8617,140,4,7,2022-01-07
317304,JAKARTA BARAT,TAMBORA,14141,4,13879,253,5,9,2022-01-07
317107,JAKARTA PUSAT,TANAH ABANG,11055,1,10830,223,1,2,2022-01-07
317202,JAKARTA UTARA,TANJUNG PRIOK,25795,2,25363,425,5,7,2022-01-07
317401,JAKARTA SELATAN,TEBET,16967,1,16679,280,7,8,2022-01-07
317506,JAKARTA TIMUR,CAKUNG,22674,1,22258,413,2,3,2022-01-08
317105,JAKARTA PUSAT,CEMPAKA PUTIH,10541,4,10369,168,0,4,2022-01-08
317301,JAKARTA BARAT,CENGKARENG,28741,1,28177,559,4,5,2022-01-08
317406,JAKARTA SELATAN,CILANDAK,17709,1,17445,261,2,3,2022-01-08
317204,JAKARTA UTARA,CILINCING,17451,1,17097,340,13,14,2022-01-08
317510,JAKARTA TIMUR,CIPAYUNG,25215,4,24939,268,4,8,2022-01-08
317509,JAKARTA TIMUR,CIRACAS,22529,1,22144,379,5,6,2022-01-08
317507,JAKARTA TIMUR,DUREN SAWIT,29486,0,28871,611,4,4,2022-01-08
317101,JAKARTA PUSAT,GAMBIR,8570,0,8434,134,2,2,2022-01-08
317302,JAKARTA BARAT,GROGOL PETAMBURAN,19097,1,18794,298,4,5,2022-01-08
317409,JAKARTA SELATAN,JAGAKARSA,26624,1,26215,406,2,3,2022-01-08
317503,JAKARTA TIMUR,JATINEGARA,19593,3,19205,383,2,5,2022-01-08
317108,JAKARTA PUSAT,JOHAR BARU,8690,1,8531,158,0,1,2022-01-08
317306,JAKARTA BARAT,KALI DERES,18056,5,17722,316,13,18,2022-01-08
317407,JAKARTA SELATAN,KEBAYORAN BARU,13895,1,13704,185,5,6,2022-01-08
317405,JAKARTA SELATAN,KEBAYORAN LAMA,20069,2,19700,363,4,6,2022-01-08
317305,JAKARTA BARAT,KEBON JERUK,22122,5,21733,375,9,14,2022-01-08
317206,JAKARTA UTARA,KELAPA GADING,12661,4,12461,193,3,7,2022-01-08
317103,JAKARTA PUSAT,KEMAYORAN,19991,1,19615,373,2,3,2022-01-08
317308,JAKARTA BARAT,KEMBANGAN,20275,2,19954,303,16,18,2022-01-08
310102,KAB.ADM.KEP.SERIBU,KEP. SERIBU SELATAN,704,0,694,10,0,0,2022-01-08
310101,KAB.ADM.KEP.SERIBU,KEP. SERIBU UTARA,640,0,634,6,0,0,2022-01-08
317203,JAKARTA UTARA,KOJA,17240,1,16900,339,0,1,2022-01-08
317504,JAKARTA TIMUR,KRAMAT JATI,21639,3,21231,402,3,6,2022-01-08
111111,LUAR DKI JAKARTA,LUAR DKI JAKARTA,92191,8,91562,618,3,11,2022-01-08
317508,JAKARTA TIMUR,MAKASAR,17487,3,17185,298,1,4,2022-01-08
317403,JAKARTA SELATAN,MAMPANG PRAPATAN,11523,4,11338,179,2,6,2022-01-08
317501,JAKARTA TIMUR,MATRAMAN,14231,1,13950,279,1,2,2022-01-08
317106,JAKARTA PUSAT,MENTENG,6434,0,6315,119,0,0,2022-01-08
317205,JAKARTA UTARA,PADEMANGAN,12895,3,12727,163,2,5,2022-01-08
317307,JAKARTA BARAT,PALMERAH,15846,7,15510,329,0,7,2022-01-08
317408,JAKARTA SELATAN,PANCORAN,14342,0,14115,227,0,0,2022-01-08
317404,JAKARTA SELATAN,PASAR MINGGU,23843,3,23414,426,0,3,2022-01-08
317505,JAKARTA TIMUR,PASAR REBO,17649,1,17322,326,0,1,2022-01-08
317201,JAKARTA UTARA,PENJARINGAN,18657,3,18420,230,4,7,2022-01-08
317410,JAKARTA SELATAN,PESANGGRAHAN,16384,1,16129,252,2,3,2022-01-08
111111,PROSES UPDATE DATA,PROSES UPDATE DATA,52087,164,50097,655,1171,1335,2022-01-08
317502,JAKARTA TIMUR,PULO GADUNG,21810,1,21406,401,2,3,2022-01-08
317102,JAKARTA PUSAT,SAWAH BESAR,9167,1,8994,172,0,1,2022-01-08
317104,JAKARTA PUSAT,SENEN,9399,2,9228,168,1,3,2022-01-08
317402,JAKARTA SELATAN,SETIA BUDI,12007,2,11819,183,3,5,2022-01-08
317303,JAKARTA BARAT,TAMAN SARI,8783,4,8617,140,22,26,2022-01-08
317304,JAKARTA BARAT,TAMBORA,14145,4,13879,253,9,13,2022-01-08
317107,JAKARTA PUSAT,TANAH ABANG,11056,1,10830,223,2,3,2022-01-08
317202,JAKARTA UTARA,TANJUNG PRIOK,25796,1,25364,425,6,7,2022-01-08
317401,JAKARTA SELATAN,TEBET,16965,0,16679,280,6,6,2022-01-08
317506,JAKARTA TIMUR,CAKUNG,22674,1,22258,413,2,3,2022-01-09
317105,JAKARTA PUSAT,CEMPAKA PUTIH,10541,4,10369,168,0,4,2022-01-09
317301,JAKARTA BARAT,CENGKARENG,28743,2,28177,559,5,7,2022-01-09
317406,JAKARTA SELATAN,CILANDAK,17710,1,17445,261,3,4,2022-01-09
317204,JAKARTA UTARA,CILINCING,17455,1,17097,340,17,18,2022-01-09
317510,JAKARTA TIMUR,CIPAYUNG,25215,5,24939,268,3,8,2022-01-09
317509,JAKARTA TIMUR,CIRACAS,22530,1,22144,379,6,7,2022-01-09
317507,JAKARTA TIMUR,DUREN SAWIT,29486,0,28871,611,4,4,2022-01-09
317101,JAKARTA PUSAT,GAMBIR,8573,0,8434,134,5,5,2022-01-09
317302,JAKARTA BARAT,GROGOL PETAMBURAN,19098,1,18795,298,4,5,2022-01-09
317409,JAKARTA SELATAN,JAGAKARSA,26624,0,26215,406,3,3,2022-01-09
317503,JAKARTA TIMUR,JATINEGARA,19594,2,19206,383,3,5,2022-01-09
317108,JAKARTA PUSAT,JOHAR BARU,8691,1,8531,158,1,2,2022-01-09
317306,JAKARTA BARAT,KALI DERES,18058,6,17722,316,14,20,2022-01-09
317407,JAKARTA SELATAN,KEBAYORAN BARU,13904,8,13704,185,7,15,2022-01-09
317405,JAKARTA SELATAN,KEBAYORAN LAMA,20073,5,19700,363,5,10,2022-01-09
317305,JAKARTA BARAT,KEBON JERUK,22126,6,21736,375,9,15,2022-01-09
317206,JAKARTA UTARA,KELAPA GADING,12667,4,12462,193,8,12,2022-01-09
317103,JAKARTA PUSAT,KEMAYORAN,19991,1,19615,373,2,3,2022-01-09
317308,JAKARTA BARAT,KEMBANGAN,20276,3,19954,303,16,19,2022-01-09
310102,KAB.ADM.KEP.SERIBU,KEP. SERIBU SELATAN,704,0,694,10,0,0,2022-01-09
310101,KAB.ADM.KEP.SERIBU,KEP. SERIBU UTARA,640,0,634,6,0,0,2022-01-09
317203,JAKARTA UTARA,KOJA,17242,2,16900,339,1,3,2022-01-09
317504,JAKARTA TIMUR,KRAMAT JATI,21639,2,21232,402,3,5,2022-01-09
111111,LUAR DKI JAKARTA,LUAR DKI JAKARTA,90726,9,90100,613,4,13,2022-01-09
317508,JAKARTA TIMUR,MAKASAR,17487,3,17185,298,1,4,2022-01-09
317403,JAKARTA SELATAN,MAMPANG PRAPATAN,11524,3,11338,179,4,7,2022-01-09
317501,JAKARTA TIMUR,MATRAMAN,14231,1,13950,279,1,2,2022-01-09
317106,JAKARTA PUSAT,MENTENG,6434,0,6315,119,0,0,2022-01-09
317205,JAKARTA UTARA,PADEMANGAN,12897,4,12727,163,3,7,2022-01-09
317307,JAKARTA BARAT,PALMERAH,15846,6,15511,329,0,6,2022-01-09
317408,JAKARTA SELATAN,PANCORAN,14342,0,14115,227,0,0,2022-01-09
317404,JAKARTA SELATAN,PASAR MINGGU,23843,2,23415,426,0,2,2022-01-09
317505,JAKARTA TIMUR,PASAR REBO,17650,2,17322,326,0,2,2022-01-09
317201,JAKARTA UTARA,PENJARINGAN,18659,3,18420,230,6,9,2022-01-09
317410,JAKARTA SELATAN,PESANGGRAHAN,16385,2,16129,252,2,4,2022-01-09
111111,PROSES UPDATE DATA,PROSES UPDATE DATA,53875,189,51662,660,1364,1553,2022-01-09
317502,JAKARTA TIMUR,PULO GADUNG,21810,1,21406,401,2,3,2022-01-09
317102,JAKARTA PUSAT,SAWAH BESAR,9168,2,8993,172,1,3,2022-01-09
317104,JAKARTA PUSAT,SENEN,9397,2,9226,168,1,3,2022-01-09
317402,JAKARTA SELATAN,SETIA BUDI,12009,1,11820,183,5,6,2022-01-09
317303,JAKARTA BARAT,TAMAN SARI,8794,7,8617,140,30,37,2022-01-09
317304,JAKARTA BARAT,TAMBORA,14146,5,13879,253,9,14,2022-01-09
317107,JAKARTA PUSAT,TANAH ABANG,11059,0,10831,223,5,5,2022-01-09
317202,JAKARTA UTARA,TANJUNG PRIOK,25800,1,25364,425,10,11,2022-01-09
317401,JAKARTA SELATAN,TEBET,16966,0,16680,280,6,6,2022-01-09
317506,JAKARTA TIMUR,CAKUNG,22677,1,22258,413,5,6,2022-01-10
317105,JAKARTA PUSAT,CEMPAKA PUTIH,10540,2,10370,168,0,2,2022-01-10
317301,JAKARTA BARAT,CENGKARENG,28746,4,28177,559,6,10,2022-01-10
317406,JAKARTA SELATAN,CILANDAK,17712,1,17445,261,5,6,2022-01-10
317204,JAKARTA UTARA,CILINCING,17453,1,17097,340,15,16,2022-01-10
317510,JAKARTA TIMUR,CIPAYUNG,25216,5,24939,268,4,9,2022-01-10
317509,JAKARTA TIMUR,CIRACAS,22533,1,22144,379,9,10,2022-01-10
317507,JAKARTA TIMUR,DUREN SAWIT,29487,1,28871,611,4,5,2022-01-10
317101,JAKARTA PUSAT,GAMBIR,8575,0,8434,134,7,7,2022-01-10
317302,JAKARTA BARAT,GROGOL PETAMBURAN,19101,3,18795,298,5,8,2022-01-10
317409,JAKARTA SELATAN,JAGAKARSA,26625,0,26215,406,4,4,2022-01-10
317503,JAKARTA TIMUR,JATINEGARA,19594,2,19206,383,3,5,2022-01-10
317108,JAKARTA PUSAT,JOHAR BARU,8692,0,8531,158,3,3,2022-01-10
317306,JAKARTA BARAT,KALI DERES,18059,3,17726,316,14,17,2022-01-10
317407,JAKARTA SELATAN,KEBAYORAN BARU,13894,1,13704,185,4,5,2022-01-10
317405,JAKARTA SELATAN,KEBAYORAN LAMA,20075,4,19701,363,7,11,2022-01-10
317305,JAKARTA BARAT,KEBON JERUK,22128,6,21737,375,10,16,2022-01-10
317206,JAKARTA UTARA,KELAPA GADING,12665,5,12461,193,6,11,2022-01-10
317103,JAKARTA PUSAT,KEMAYORAN,19993,2,19615,373,3,5,2022-01-10
317308,JAKARTA BARAT,KEMBANGAN,20279,4,19955,303,17,21,2022-01-10
310102,KAB.ADM.KEP.SERIBU,KEP. SERIBU SELATAN,704,0,694,10,0,0,2022-01-10
310101,KAB.ADM.KEP.SERIBU,KEP. SERIBU UTARA,640,0,634,6,0,0,2022-01-10
317203,JAKARTA UTARA,KOJA,17242,2,16900,339,1,3,2022-01-10
317504,JAKARTA TIMUR,KRAMAT JATI,21640,3,21232,402,3,6,2022-01-10
111111,LUAR DKI JAKARTA,LUAR DKI JAKARTA,90734,12,90102,613,7,19,2022-01-10
317508,JAKARTA TIMUR,MAKASAR,17488,3,17187,298,0,3,2022-01-10
317403,JAKARTA SELATAN,MAMPANG PRAPATAN,11527,3,11339,179,6,9,2022-01-10
317501,JAKARTA TIMUR,MATRAMAN,14231,1,13950,279,1,2,2022-01-10
317106,JAKARTA PUSAT,MENTENG,6438,1,6315,119,3,4,2022-01-10
317205,JAKARTA UTARA,PADEMANGAN,12899,5,12727,163,4,9,2022-01-10
317307,JAKARTA BARAT,PALMERAH,15847,5,15512,329,1,6,2022-01-10
317408,JAKARTA SELATAN,PANCORAN,14342,0,14115,227,0,0,2022-01-10
317404,JAKARTA SELATAN,PASAR MINGGU,23844,2,23415,426,1,3,2022-01-10
317505,JAKARTA TIMUR,PASAR REBO,17650,2,17322,326,0,2,2022-01-10
317201,JAKARTA UTARA,PENJARINGAN,18659,2,18421,230,6,8,2022-01-10
317410,JAKARTA SELATAN,PESANGGRAHAN,16385,1,16129,252,3,4,2022-01-10
111111,PROSES UPDATE DATA,PROSES UPDATE DATA,54168,214,51750,660,1544,1758,2022-01-10
317502,JAKARTA TIMUR,PULO GADUNG,21810,1,21406,401,2,3,2022-01-10
317102,JAKARTA PUSAT,SAWAH BESAR,9167,0,8993,172,2,2,2022-01-10
317104,JAKARTA PUSAT,SENEN,9397,2,9226,168,1,3,2022-01-10
317402,JAKARTA SELATAN,SETIA BUDI,12009,2,11820,183,4,6,2022-01-10
317303,JAKARTA BARAT,TAMAN SARI,8821,9,8619,140,53,62,2022-01-10
317304,JAKARTA BARAT,TAMBORA,14151,5,13879,253,14,19,2022-01-10
317107,JAKARTA PUSAT,TANAH ABANG,11058,0,10831,223,4,4,2022-01-10
317202,JAKARTA UTARA,TANJUNG PRIOK,25801,1,25364,425,11,12,2022-01-10
317401,JAKARTA SELATAN,TEBET,16966,0,16681,280,5,5,2022-01-10
317506,JAKARTA TIMUR,CAKUNG,22678,1,22258,413,6,7,2022-01-11
317105,JAKARTA PUSAT,CEMPAKA PUTIH,10543,2,10371,168,2,4,2022-01-11
317301,JAKARTA BARAT,CENGKARENG,28747,4,28177,559,7,11,2022-01-11
317406,JAKARTA SELATAN,CILANDAK,17714,2,17446,261,5,7,2022-01-11
317204,JAKARTA UTARA,CILINCING,17453,1,17097,340,15,16,2022-01-11
317510,JAKARTA TIMUR,CIPAYUNG,25216,5,24939,268,4,9,2022-01-11
317509,JAKARTA TIMUR,CIRACAS,22533,1,22145,379,8,9,2022-01-11
317507,JAKARTA TIMUR,DUREN SAWIT,29486,1,28871,611,3,4,2022-01-11
317101,JAKARTA PUSAT,GAMBIR,8575,0,8434,134,7,7,2022-01-11
317302,JAKARTA BARAT,GROGOL PETAMBURAN,19105,4,18796,298,7,11,2022-01-11
317409,JAKARTA SELATAN,JAGAKARSA,26626,0,26215,406,5,5,2022-01-11
317503,JAKARTA TIMUR,JATINEGARA,19594,2,19206,383,3,5,2022-01-11
317108,JAKARTA PUSAT,JOHAR BARU,8693,0,8531,158,4,4,2022-01-11
317306,JAKARTA BARAT,KALI DERES,18065,6,17726,316,17,23,2022-01-11
317407,JAKARTA SELATAN,KEBAYORAN BARU,13896,1,13704,185,6,7,2022-01-11
317405,JAKARTA SELATAN,KEBAYORAN LAMA,20074,1,19701,363,9,10,2022-01-11
317305,JAKARTA BARAT,KEBON JERUK,22129,6,21740,375,8,14,2022-01-11
317206,JAKARTA UTARA,KELAPA GADING,12667,5,12461,193,8,13,2022-01-11
317103,JAKARTA PUSAT,KEMAYORAN,19996,3,19616,373,4,7,2022-01-11
317308,JAKARTA BARAT,KEMBANGAN,20284,5,19968,303,8,13,2022-01-11
310102,KAB.ADM.KEP.SERIBU,KEP. SERIBU SELATAN,704,0,694,10,0,0,2022-01-11
310101,KAB.ADM.KEP.SERIBU,KEP. SERIBU UTARA,640,0,634,6,0,0,2022-01-11
317203,JAKARTA UTARA,KOJA,17242,2,16900,339,1,3,2022-01-11
317504,JAKARTA TIMUR,KRAMAT JATI,21640,2,21233,402,3,5,2022-01-11
111111,LUAR DKI JAKARTA,LUAR DKI JAKARTA,90735,12,90103,613,7,19,2022-01-11
317508,JAKARTA TIMUR,MAKASAR,17488,3,17187,298,0,3,2022-01-11
317403,JAKARTA SELATAN,MAMPANG PRAPATAN,11526,2,11340,179,5,7,2022-01-11
317501,JAKARTA TIMUR,MATRAMAN,14231,1,13950,279,1,2,2022-01-11
317106,JAKARTA PUSAT,MENTENG,6439,1,6315,119,4,5,2022-01-11
317205,JAKARTA UTARA,PADEMANGAN,12901,6,12727,163,5,11,2022-01-11
317307,JAKARTA BARAT,PALMERAH,15846,4,15512,329,1,5,2022-01-11
317408,JAKARTA SELATAN,PANCORAN,14342,0,14115,227,0,0,2022-01-11
317404,JAKARTA SELATAN,PASAR MINGGU,23846,3,23415,426,2,5,2022-01-11
317505,JAKARTA TIMUR,PASAR REBO,17650,1,17323,326,0,1,2022-01-11
317201,JAKARTA UTARA,PENJARINGAN,18662,3,18423,230,6,9,2022-01-11
317410,JAKARTA SELATAN,PESANGGRAHAN,16386,3,16129,252,2,5,2022-01-11
111111,PROSES UPDATE DATA,PROSES UPDATE DATA,54632,277,51903,661,1791,2068,2022-01-11
317502,JAKARTA TIMUR,PULO GADUNG,21812,1,21406,401,4,5,2022-01-11
317102,JAKARTA PUSAT,SAWAH BESAR,9170,3,8993,172,2,5,2022-01-11
317104,JAKARTA PUSAT,SENEN,9400,2,9226,168,4,6,2022-01-11
317402,JAKARTA SELATAN,SETIA BUDI,12012,6,11820,183,3,9,2022-01-11
317303,JAKARTA BARAT,TAMAN SARI,8836,12,8619,140,65,77,2022-01-11
317304,JAKARTA BARAT,TAMBORA,14154,6,13879,253,16,22,2022-01-11
317107,JAKARTA PUSAT,TANAH ABANG,11061,0,10831,223,7,7,2022-01-11
317202,JAKARTA UTARA,TANJUNG PRIOK,25803,2,25366,425,10,12,2022-01-11
317401,JAKARTA SELATAN,TEBET,16967,0,16681,280,6,6,2022-01-11
317506,JAKARTA TIMUR,CAKUNG,22679,1,22258,413,7,8,2022-01-12
317105,JAKARTA PUSAT,CEMPAKA PUTIH,10544,2,10371,168,3,5,2022-01-12
317301,JAKARTA BARAT,CENGKARENG,28745,3,28177,559,6,9,2022-01-12
317406,JAKARTA SELATAN,CILANDAK,17716,4,17446,261,5,9,2022-01-12
317204,JAKARTA UTARA,CILINCING,17453,1,17097,340,15,16,2022-01-12
317510,JAKARTA TIMUR,CIPAYUNG,25219,5,24939,268,7,12,2022-01-12
317509,JAKARTA TIMUR,CIRACAS,22533,1,22145,379,8,9,2022-01-12
317507,JAKARTA TIMUR,DUREN SAWIT,29491,4,28871,611,5,9,2022-01-12
317101,JAKARTA PUSAT,GAMBIR,8584,1,8434,134,15,16,2022-01-12
317302,JAKARTA BARAT,GROGOL PETAMBURAN,19114,6,18796,298,14,20,2022-01-12
317409,JAKARTA SELATAN,JAGAKARSA,26629,1,26215,406,7,8,2022-01-12
317503,JAKARTA TIMUR,JATINEGARA,19594,2,19206,383,3,5,2022-01-12
317108,JAKARTA PUSAT,JOHAR BARU,8701,5,8531,158,7,12,2022-01-12
317306,JAKARTA BARAT,KALI DERES,18065,7,17733,316,9,16,2022-01-12
317407,JAKARTA SELATAN,KEBAYORAN BARU,13900,3,13704,185,8,11,2022-01-12
317405,JAKARTA SELATAN,KEBAYORAN LAMA,20078,1,19703,363,11,12,2022-01-12
317305,JAKARTA BARAT,KEBON JERUK,22131,7,21740,375,9,16,2022-01-12
317206,JAKARTA UTARA,KELAPA GADING,12668,5,12461,193,9,14,2022-01-12
317103,JAKARTA PUSAT,KEMAYORAN,19997,6,19616,373,2,8,2022-01-12
317308,JAKARTA BARAT,KEMBANGAN,20287,6,19968,303,10,16,2022-01-12
310102,KAB.ADM.KEP.SERIBU,KEP. SERIBU SELATAN,704,0,694,10,0,0,2022-01-12
310101,KAB.ADM.KEP.SERIBU,KEP. SERIBU UTARA,640,0,634,6,0,0,2022-01-12
317203,JAKARTA UTARA,KOJA,17242,2,16900,339,1,3,2022-01-12
317504,JAKARTA TIMUR,KRAMAT JATI,21641,2,21233,402,4,6,2022-01-12
111111,LUAR DKI JAKARTA,LUAR DKI JAKARTA,90741,10,90106,613,12,22,2022-01-12
317508,JAKARTA TIMUR,MAKASAR,17489,4,17187,298,0,4,2022-01-12
317403,JAKARTA SELATAN,MAMPANG PRAPATAN,11526,3,11340,179,4,7,2022-01-12
317501,JAKARTA TIMUR,MATRAMAN,14231,1,13950,279,1,2,2022-01-12
317106,JAKARTA PUSAT,MENTENG,6441,1,6315,119,6,7,2022-01-12
317205,JAKARTA UTARA,PADEMANGAN,12905,7,12727,163,8,15,2022-01-12
317307,JAKARTA BARAT,PALMERAH,15847,4,15512,329,2,6,2022-01-12
317408,JAKARTA SELATAN,PANCORAN,14349,1,14115,227,6,7,2022-01-12
317404,JAKARTA SELATAN,PASAR MINGGU,23850,4,23415,426,5,9,2022-01-12
317505,JAKARTA TIMUR,PASAR REBO,17649,0,17323,326,0,0,2022-01-12
317201,JAKARTA UTARA,PENJARINGAN,18669,4,18424,230,11,15,2022-01-12
317410,JAKARTA SELATAN,PESANGGRAHAN,16386,3,16131,252,0,3,2022-01-12
111111,PROSES UPDATE DATA,PROSES UPDATE DATA,54926,350,52030,661,1885,2235,2022-01-12
317502,JAKARTA TIMUR,PULO GADUNG,21816,2,21406,401,7,9,2022-01-12
317102,JAKARTA PUSAT,SAWAH BESAR,9175,3,8993,172,7,10,2022-01-12
317104,JAKARTA PUSAT,SENEN,9403,2,9226,168,7,9,2022-01-12
317402,JAKARTA SELATAN,SETIA BUDI,12015,7,11820,183,5,12,2022-01-12
317303,JAKARTA BARAT,TAMAN SARI,8842,14,8619,140,69,83,2022-01-12
317304,JAKARTA BARAT,TAMBORA,14156,7,13880,253,16,23,2022-01-12
317107,JAKARTA PUSAT,TANAH ABANG,11066,0,10831,223,12,12,2022-01-12
317202,JAKARTA UTARA,TANJUNG PRIOK,25806,4,25366,425,11,15,2022-01-12
317401,JAKARTA SELATAN,TEBET,16968,0,16681,280,7,7,2022-01-12
317506,JAKARTA TIMUR,CAKUNG,22683,4,22258,413,8,12,2022-01-13
317105,JAKARTA PUSAT,CEMPAKA PUTIH,10549,3,10371,168,7,10,2022-01-13
317301,JAKARTA BARAT,CENGKARENG,28751,4,28177,559,11,15,2022-01-13
317406,JAKARTA SELATAN,CILANDAK,17723,4,17447,261,11,15,2022-01-13
317204,JAKARTA UTARA,CILINCING,17454,0,17097,340,17,17,2022-01-13
317510,JAKARTA TIMUR,CIPAYUNG,25221,5,24939,268,9,14,2022-01-13
317509,JAKARTA TIMUR,CIRACAS,22539,1,22145,379,14,15,2022-01-13
317507,JAKARTA TIMUR,DUREN SAWIT,29496,7,28872,611,6,13,2022-01-13
317101,JAKARTA PUSAT,GAMBIR,8586,2,8434,134,16,18,2022-01-13
317302,JAKARTA BARAT,GROGOL PETAMBURAN,19116,9,18797,298,12,21,2022-01-13
317409,JAKARTA SELATAN,JAGAKARSA,26634,2,26215,406,11,13,2022-01-13
317503,JAKARTA TIMUR,JATINEGARA,19596,3,19206,383,4,7,2022-01-13
317108,JAKARTA PUSAT,JOHAR BARU,8694,1,8531,158,4,5,2022-01-13
317306,JAKARTA BARAT,KALI DERES,18067,7,17734,316,10,17,2022-01-13
317407,JAKARTA SELATAN,KEBAYORAN BARU,13900,3,13705,185,7,10,2022-01-13
317405,JAKARTA SELATAN,KEBAYORAN LAMA,20088,5,19706,363,14,19,2022-01-13
317305,JAKARTA BARAT,KEBON JERUK,22136,8,21742,375,11,19,2022-01-13
317206,JAKARTA UTARA,KELAPA GADING,12676,9,12462,193,12,21,2022-01-13
317103,JAKARTA PUSAT,KEMAYORAN,19999,7,19617,373,2,9,2022-01-13
317308,JAKARTA BARAT,KEMBANGAN,20290,6,19969,303,12,18,2022-01-13
310102,KAB.ADM.KEP.SERIBU,KEP. SERIBU SELATAN,704,0,694,10,0,0,2022-01-13
310101,KAB.ADM.KEP.SERIBU,KEP. SERIBU UTARA,640,0,634,6,0,0,2022-01-13
317203,JAKARTA UTARA,KOJA,17242,1,16901,339,1,2,2022-01-13
317504,JAKARTA TIMUR,KRAMAT JATI,21643,2,21233,402,6,8,2022-01-13
111111,LUAR DKI JAKARTA,LUAR DKI JAKARTA,90752,12,90109,613,18,30,2022-01-13
317508,JAKARTA TIMUR,MAKASAR,17490,5,17187,298,0,5,2022-01-13
317403,JAKARTA SELATAN,MAMPANG PRAPATAN,11526,2,11340,179,5,7,2022-01-13
317501,JAKARTA TIMUR,MATRAMAN,14231,1,13950,279,1,2,2022-01-13
317106,JAKARTA PUSAT,MENTENG,6442,1,6315,119,7,8,2022-01-13
317205,JAKARTA UTARA,PADEMANGAN,12908,9,12728,163,8,17,2022-01-13
317307,JAKARTA BARAT,PALMERAH,15846,4,15513,329,0,4,2022-01-13
317408,JAKARTA SELATAN,PANCORAN,14349,1,14115,227,6,7,2022-01-13
317404,JAKARTA SELATAN,PASAR MINGGU,23855,6,23417,426,6,12,2022-01-13
317505,JAKARTA TIMUR,PASAR REBO,17651,0,17323,326,2,2,2022-01-13
317201,JAKARTA UTARA,PENJARINGAN,18681,5,18426,230,20,25,2022-01-13
317410,JAKARTA SELATAN,PESANGGRAHAN,16388,3,16132,252,1,4,2022-01-13
111111,PROSES UPDATE DATA,PROSES UPDATE DATA,55255,394,52294,661,1906,2300,2022-01-13
317502,JAKARTA TIMUR,PULO GADUNG,21818,3,21406,401,8,11,2022-01-13
317102,JAKARTA PUSAT,SAWAH BESAR,9180,3,8993,172,12,15,2022-01-13
317104,JAKARTA PUSAT,SENEN,9404,2,9226,168,8,10,2022-01-13
317402,JAKARTA SELATAN,SETIA BUDI,12015,7,11821,183,4,11,2022-01-13
317303,JAKARTA BARAT,TAMAN SARI,8861,14,8620,140,87,101,2022-01-13
317304,JAKARTA BARAT,TAMBORA,14162,9,13881,253,19,28,2022-01-13
317107,JAKARTA PUSAT,TANAH ABANG,11071,3,10831,223,14,17,2022-01-13
317202,JAKARTA UTARA,TANJUNG PRIOK,25808,6,25367,425,10,16,2022-01-13
317401,JAKARTA SELATAN,TEBET,16969,0,16683,280,6,6,2022-01-13
317506,JAKARTA TIMUR,CAKUNG,22683,4,22259,413,7,11,2022-01-14
317105,JAKARTA PUSAT,CEMPAKA PUTIH,10554,2,10372,168,12,14,2022-01-14
317301,JAKARTA BARAT,CENGKARENG,28754,4,28177,559,14,18,2022-01-14
317406,JAKARTA SELATAN,CILANDAK,17726,5,17448,261,12,17,2022-01-14
317204,JAKARTA UTARA,CILINCING,17455,0,17097,340,18,18,2022-01-14
317510,JAKARTA TIMUR,CIPAYUNG,25232,9,24939,268,16,25,2022-01-14
317509,JAKARTA TIMUR,CIRACAS,22548,1,22145,379,23,24,2022-01-14
317507,JAKARTA TIMUR,DUREN SAWIT,29507,9,28872,611,15,24,2022-01-14
317101,JAKARTA PUSAT,GAMBIR,8589,5,8434,134,16,21,2022-01-14
317302,JAKARTA BARAT,GROGOL PETAMBURAN,19122,7,18798,298,19,26,2022-01-14
317409,JAKARTA SELATAN,JAGAKARSA,26636,4,26215,406,11,15,2022-01-14
317503,JAKARTA TIMUR,JATINEGARA,19603,3,19208,383,9,12,2022-01-14
317108,JAKARTA PUSAT,JOHAR BARU,8697,1,8531,158,7,8,2022-01-14
317306,JAKARTA BARAT,KALI DERES,18074,8,17736,316,14,22,2022-01-14
317407,JAKARTA SELATAN,KEBAYORAN BARU,13916,5,13705,185,21,26,2022-01-14
317405,JAKARTA SELATAN,KEBAYORAN LAMA,20100,11,19706,363,20,31,2022-01-14
317305,JAKARTA BARAT,KEBON JERUK,22143,13,21744,375,11,24,2022-01-14
317206,JAKARTA UTARA,KELAPA GADING,12687,9,12464,193,21,30,2022-01-14
317103,JAKARTA PUSAT,KEMAYORAN,20001,8,19617,373,3,11,2022-01-14
317308,JAKARTA BARAT,KEMBANGAN,20295,6,19971,303,15,21,2022-01-14
310102,KAB.ADM.KEP.SERIBU,KEP. SERIBU SELATAN,704,0,694,10,0,0,2022-01-14
310101,KAB.ADM.KEP.SERIBU,KEP. SERIBU UTARA,640,0,634,6,0,0,2022-01-14
317203,JAKARTA UTARA,KOJA,17244,3,16901,339,1,4,2022-01-14
317504,JAKARTA TIMUR,KRAMAT JATI,21646,2,21234,402,8,10,2022-01-14
111111,LUAR DKI JAKARTA,LUAR DKI JAKARTA,90769,17,90111,613,28,45,2022-01-14
317508,JAKARTA TIMUR,MAKASAR,17494,7,17188,298,1,8,2022-01-14
317403,JAKARTA SELATAN,MAMPANG PRAPATAN,11527,2,11340,179,6,8,2022-01-14
317501,JAKARTA TIMUR,MATRAMAN,14232,1,13950,279,2,3,2022-01-14
317106,JAKARTA PUSAT,MENTENG,6448,3,6315,119,11,14,2022-01-14
317205,JAKARTA UTARA,PADEMANGAN,12910,11,12728,163,8,19,2022-01-14
317307,JAKARTA BARAT,PALMERAH,15853,4,15517,329,3,7,2022-01-14
317408,JAKARTA SELATAN,PANCORAN,14353,2,14115,227,9,11,2022-01-14
317404,JAKARTA SELATAN,PASAR MINGGU,23858,4,23417,426,11,15,2022-01-14
317505,JAKARTA TIMUR,PASAR REBO,17656,0,17323,326,7,7,2022-01-14
317201,JAKARTA UTARA,PENJARINGAN,18683,4,18426,230,23,27,2022-01-14
317410,JAKARTA SELATAN,PESANGGRAHAN,16390,3,16132,252,3,6,2022-01-14
111111,PROSES UPDATE DATA,PROSES UPDATE DATA,55575,427,52430,662,2056,2483,2022-01-14
317502,JAKARTA TIMUR,PULO GADUNG,21824,5,21406,401,12,17,2022-01-14
317102,JAKARTA PUSAT,SAWAH BESAR,9182,4,8993,172,13,17,2022-01-14
317104,JAKARTA PUSAT,SENEN,9405,2,9226,168,9,11,2022-01-14
317402,JAKARTA SELATAN,SETIA BUDI,12014,3,11821,183,7,10,2022-01-14
317303,JAKARTA BARAT,TAMAN SARI,8871,16,8621,140,94,110,2022-01-14
317304,JAKARTA BARAT,TAMBORA,14172,16,13883,253,20,36,2022-01-14
317107,JAKARTA PUSAT,TANAH ABANG,11073,4,10832,223,14,18,2022-01-14
317202,JAKARTA UTARA,TANJUNG PRIOK,25820,13,25368,425,14,27,2022-01-14
317401,JAKARTA SELATAN,TEBET,16978,2,16684,280,12,14,2022-01-14
317506,JAKARTA TIMUR,CAKUNG,22690,9,22259,413,9,18,2022-01-15
317105,JAKARTA PUSAT,CEMPAKA PUTIH,10552,3,10372,168,9,12,2022-01-15
317301,JAKARTA BARAT,CENGKARENG,28756,6,28179,559,12,18,2022-01-15
317406,JAKARTA SELATAN,CILANDAK,17724,1,17448,261,14,15,2022-01-15
317204,JAKARTA UTARA,CILINCING,17456,1,17098,340,17,18,2022-01-15
317510,JAKARTA TIMUR,CIPAYUNG,25237,8,24940,268,21,29,2022-01-15
317509,JAKARTA TIMUR,CIRACAS,22553,3,22145,379,26,29,2022-01-15
317507,JAKARTA TIMUR,DUREN SAWIT,29520,17,28874,611,18,35,2022-01-15
317101,JAKARTA PUSAT,GAMBIR,8596,7,8434,134,21,28,2022-01-15
317302,JAKARTA BARAT,GROGOL PETAMBURAN,19133,11,18799,298,25,36,2022-01-15
317409,JAKARTA SELATAN,JAGAKARSA,26645,10,26217,406,12,22,2022-01-15
317503,JAKARTA TIMUR,JATINEGARA,19610,4,19209,383,14,18,2022-01-15
317108,JAKARTA PUSAT,JOHAR BARU,8701,1,8531,158,11,12,2022-01-15
317306,JAKARTA BARAT,KALI DERES,18078,7,17740,316,15,22,2022-01-15
317407,JAKARTA SELATAN,KEBAYORAN BARU,13914,5,13705,185,19,24,2022-01-15
317405,JAKARTA SELATAN,KEBAYORAN LAMA,20113,15,19708,363,27,42,2022-01-15
317305,JAKARTA BARAT,KEBON JERUK,22152,19,21745,375,13,32,2022-01-15
317206,JAKARTA UTARA,KELAPA GADING,12694,12,12464,193,25,37,2022-01-15
317103,JAKARTA PUSAT,KEMAYORAN,20006,13,19617,373,3,16,2022-01-15
317308,JAKARTA BARAT,KEMBANGAN,20303,9,19971,303,20,29,2022-01-15
310102,KAB.ADM.KEP.SERIBU,KEP. SERIBU SELATAN,704,0,694,10,0,0,2022-01-15
310101,KAB.ADM.KEP.SERIBU,KEP. SERIBU UTARA,640,0,634,6,0,0,2022-01-15
317203,JAKARTA UTARA,KOJA,17247,6,16901,339,1,7,2022-01-15
317504,JAKARTA TIMUR,KRAMAT JATI,21653,4,21235,402,12,16,2022-01-15
111111,LUAR DKI JAKARTA,LUAR DKI JAKARTA,90795,29,90114,613,39,68,2022-01-15
317508,JAKARTA TIMUR,MAKASAR,17497,9,17188,298,2,11,2022-01-15
317403,JAKARTA SELATAN,MAMPANG PRAPATAN,11534,4,11340,179,11,15,2022-01-15
317501,JAKARTA TIMUR,MATRAMAN,14235,2,13951,279,3,5,2022-01-15
317106,JAKARTA PUSAT,MENTENG,6455,5,6315,119,16,21,2022-01-15
317205,JAKARTA UTARA,PADEMANGAN,12916,8,12730,163,15,23,2022-01-15
317307,JAKARTA BARAT,PALMERAH,15852,1,15517,329,5,6,2022-01-15
317408,JAKARTA SELATAN,PANCORAN,14358,3,14115,227,13,16,2022-01-15
317404,JAKARTA SELATAN,PASAR MINGGU,23868,7,23417,426,18,25,2022-01-15
317505,JAKARTA TIMUR,PASAR REBO,17660,2,17323,326,9,11,2022-01-15
317201,JAKARTA UTARA,PENJARINGAN,18688,5,18425,230,28,33,2022-01-15
317410,JAKARTA SELATAN,PESANGGRAHAN,16395,6,16132,252,5,11,2022-01-15
111111,PROSES UPDATE DATA,PROSES UPDATE DATA,56034,444,52667,662,2261,2705,2022-01-15
317502,JAKARTA TIMUR,PULO GADUNG,21830,6,21406,401,17,23,2022-01-15
317102,JAKARTA PUSAT,SAWAH BESAR,9189,6,8993,172,18,24,2022-01-15
317104,JAKARTA PUSAT,SENEN,9408,1,9227,168,12,13,2022-01-15
317402,JAKARTA SELATAN,SETIA BUDI,12019,2,11822,183,12,14,2022-01-15
317303,JAKARTA BARAT,TAMAN SARI,8894,16,8626,140,112,128,2022-01-15
317304,JAKARTA BARAT,TAMBORA,14181,12,13888,253,28,40,2022-01-15
317107,JAKARTA PUSAT,TANAH ABANG,11075,4,10832,223,16,20,2022-01-15
317202,JAKARTA UTARA,TANJUNG PRIOK,25823,12,25371,425,15,27,2022-01-15
317401,JAKARTA SELATAN,TEBET,16980,3,16685,280,12,15,2022-01-15
317506,JAKARTA TIMUR,CAKUNG,22697,9,22261,413,14,23,2022-01-16
317105,JAKARTA PUSAT,CEMPAKA PUTIH,10552,2,10372,168,10,12,2022-01-16
317301,JAKARTA BARAT,CENGKARENG,28763,7,28179,559,18,25,2022-01-16
317406,JAKARTA SELATAN,CILANDAK,17731,2,17449,261,19,21,2022-01-16
317204,JAKARTA UTARA,CILINCING,17456,1,17110,340,5,6,2022-01-16
317510,JAKARTA TIMUR,CIPAYUNG,25246,8,24944,268,26,34,2022-01-16
317509,JAKARTA TIMUR,CIRACAS,22561,2,22150,379,30,32,2022-01-16
317507,JAKARTA TIMUR,DUREN SAWIT,29526,16,28875,611,24,40,2022-01-16
317101,JAKARTA PUSAT,GAMBIR,8596,6,8434,134,22,28,2022-01-16
317302,JAKARTA BARAT,GROGOL PETAMBURAN,19142,15,18799,298,30,45,2022-01-16
317409,JAKARTA SELATAN,JAGAKARSA,26652,15,26217,406,14,29,2022-01-16
317503,JAKARTA TIMUR,JATINEGARA,19612,3,19211,383,15,18,2022-01-16
317108,JAKARTA PUSAT,JOHAR BARU,8701,1,8531,158,11,12,2022-01-16
317306,JAKARTA BARAT,KALI DERES,18081,8,17740,316,17,25,2022-01-16
317407,JAKARTA SELATAN,KEBAYORAN BARU,13918,6,13706,185,21,27,2022-01-16
317405,JAKARTA SELATAN,KEBAYORAN LAMA,20114,11,19708,363,32,43,2022-01-16
317305,JAKARTA BARAT,KEBON JERUK,22165,20,21748,375,22,42,2022-01-16
317206,JAKARTA UTARA,KELAPA GADING,12697,12,12465,193,27,39,2022-01-16
317103,JAKARTA PUSAT,KEMAYORAN,20018,17,19617,373,11,28,2022-01-16
317308,JAKARTA BARAT,KEMBANGAN,20316,11,19972,303,30,41,2022-01-16
310102,KAB.ADM.KEP.SERIBU,KEP. SERIBU SELATAN,704,0,694,10,0,0,2022-01-16
310101,KAB.ADM.KEP.SERIBU,KEP. SERIBU UTARA,640,0,634,6,0,0,2022-01-16
317203,JAKARTA UTARA,KOJA,17250,8,16901,339,2,10,2022-01-16
317504,JAKARTA TIMUR,KRAMAT JATI,21657,3,21236,402,16,19,2022-01-16
111111,LUAR DKI JAKARTA,LUAR DKI JAKARTA,90805,33,90122,613,37,70,2022-01-16
317508,JAKARTA TIMUR,MAKASAR,17502,9,17189,298,6,15,2022-01-16
317403,JAKARTA SELATAN,MAMPANG PRAPATAN,11537,4,11340,179,14,18,2022-01-16
317501,JAKARTA TIMUR,MATRAMAN,14238,3,13952,279,4,7,2022-01-16
317106,JAKARTA PUSAT,MENTENG,6461,6,6315,119,21,27,2022-01-16
317205,JAKARTA UTARA,PADEMANGAN,12920,6,12732,163,19,25,2022-01-16
317307,JAKARTA BARAT,PALMERAH,15858,3,15517,329,9,12,2022-01-16
317408,JAKARTA SELATAN,PANCORAN,14365,4,14115,227,19,23,2022-01-16
317404,JAKARTA SELATAN,PASAR MINGGU,23870,7,23418,426,19,26,2022-01-16
317505,JAKARTA TIMUR,PASAR REBO,17663,4,17323,326,10,14,2022-01-16
317201,JAKARTA UTARA,PENJARINGAN,18696,7,18425,230,34,41,2022-01-16
317410,JAKARTA SELATAN,PESANGGRAHAN,16403,6,16132,252,13,19,2022-01-16
111111,PROSES UPDATE DATA,PROSES UPDATE DATA,56367,440,53101,662,2164,2604,2022-01-16
317502,JAKARTA TIMUR,PULO GADUNG,21841,7,21408,401,25,32,2022-01-16
317102,JAKARTA PUSAT,SAWAH BESAR,9188,8,8993,172,15,23,2022-01-16
317104,JAKARTA PUSAT,SENEN,9409,1,9228,168,12,13,2022-01-16
317402,JAKARTA SELATAN,SETIA BUDI,12022,1,11823,183,15,16,2022-01-16
317303,JAKARTA BARAT,TAMAN SARI,8904,20,8653,140,91,111,2022-01-16
317304,JAKARTA BARAT,TAMBORA,14193,9,13894,253,37,46,2022-01-16
317107,JAKARTA PUSAT,TANAH ABANG,11076,4,10832,223,17,21,2022-01-16
317202,JAKARTA UTARA,TANJUNG PRIOK,25828,14,25372,425,17,31,2022-01-16
317401,JAKARTA SELATAN,TEBET,16988,2,16685,280,21,23,2022-01-16
317506,JAKARTA TIMUR,CAKUNG,22698,10,22264,413,11,21,2022-01-17
317105,JAKARTA PUSAT,CEMPAKA PUTIH,10557,3,10373,168,13,16,2022-01-17
317301,JAKARTA BARAT,CENGKARENG,28771,7,28183,559,22,29,2022-01-17
317406,JAKARTA SELATAN,CILANDAK,17742,4,17449,261,28,32,2022-01-17
317204,JAKARTA UTARA,CILINCING,17458,2,17112,340,4,6,2022-01-17
317510,JAKARTA TIMUR,CIPAYUNG,25247,5,24948,268,26,31,2022-01-17
317509,JAKARTA TIMUR,CIRACAS,22570,2,22152,379,37,39,2022-01-17
317507,JAKARTA TIMUR,DUREN SAWIT,29537,17,28875,611,34,51,2022-01-17
317101,JAKARTA PUSAT,GAMBIR,8602,8,8439,134,21,29,2022-01-17
317302,JAKARTA BARAT,GROGOL PETAMBURAN,19149,18,18799,298,34,52,2022-01-17
317409,JAKARTA SELATAN,JAGAKARSA,26657,16,26219,406,16,32,2022-01-17
317503,JAKARTA TIMUR,JATINEGARA,19617,5,19211,383,18,23,2022-01-17
317108,JAKARTA PUSAT,JOHAR BARU,8702,0,8532,158,12,12,2022-01-17
317306,JAKARTA BARAT,KALI DERES,18087,9,17742,316,20,29,2022-01-17
317407,JAKARTA SELATAN,KEBAYORAN BARU,13933,7,13708,185,33,40,2022-01-17
317405,JAKARTA SELATAN,KEBAYORAN LAMA,20124,10,19709,363,42,52,2022-01-17
317305,JAKARTA BARAT,KEBON JERUK,22178,21,21750,375,32,53,2022-01-17
317206,JAKARTA UTARA,KELAPA GADING,12706,13,12471,193,29,42,2022-01-17
317103,JAKARTA PUSAT,KEMAYORAN,20029,22,19618,373,16,38,2022-01-17
317308,JAKARTA BARAT,KEMBANGAN,20320,10,19974,303,33,43,2022-01-17
310102,KAB.ADM.KEP.SERIBU,KEP. SERIBU SELATAN,704,0,694,10,0,0,2022-01-17
310101,KAB.ADM.KEP.SERIBU,KEP. SERIBU UTARA,640,0,634,6,0,0,2022-01-17
317203,JAKARTA UTARA,KOJA,17261,9,16902,339,11,20,2022-01-17
317504,JAKARTA TIMUR,KRAMAT JATI,21666,6,21236,402,22,28,2022-01-17
111111,LUAR DKI JAKARTA,LUAR DKI JAKARTA,90818,29,90127,613,49,78,2022-01-17
317508,JAKARTA TIMUR,MAKASAR,17507,11,17190,298,8,19,2022-01-17
317403,JAKARTA SELATAN,MAMPANG PRAPATAN,11545,6,11344,179,16,22,2022-01-17
317501,JAKARTA TIMUR,MATRAMAN,14245,8,13952,279,6,14,2022-01-17
317106,JAKARTA PUSAT,MENTENG,6466,7,6317,119,23,30,2022-01-17
317205,JAKARTA UTARA,PADEMANGAN,12923,8,12733,163,19,27,2022-01-17
317307,JAKARTA BARAT,PALMERAH,15866,8,15517,329,12,20,2022-01-17
317408,JAKARTA SELATAN,PANCORAN,14372,7,14115,227,23,30,2022-01-17
317404,JAKARTA SELATAN,PASAR MINGGU,23873,8,23419,426,20,28,2022-01-17
317505,JAKARTA TIMUR,PASAR REBO,17667,5,17323,326,13,18,2022-01-17
317201,JAKARTA UTARA,PENJARINGAN,18700,6,18427,230,37,43,2022-01-17
317410,JAKARTA SELATAN,PESANGGRAHAN,16405,7,16132,252,14,21,2022-01-17
111111,PROSES UPDATE DATA,PROSES UPDATE DATA,56522,397,53470,662,1993,2390,2022-01-17
317502,JAKARTA TIMUR,PULO GADUNG,21847,16,21409,401,21,37,2022-01-17
317102,JAKARTA PUSAT,SAWAH BESAR,9196,9,8995,172,20,29,2022-01-17
317104,JAKARTA PUSAT,SENEN,9410,1,9228,168,13,14,2022-01-17
317402,JAKARTA SELATAN,SETIA BUDI,12026,2,11824,183,17,19,2022-01-17
317303,JAKARTA BARAT,TAMAN SARI,8937,30,8682,140,85,115,2022-01-17
317304,JAKARTA BARAT,TAMBORA,14226,14,13897,253,62,76,2022-01-17
317107,JAKARTA PUSAT,TANAH ABANG,11079,4,10833,223,19,23,2022-01-17
317202,JAKARTA UTARA,TANJUNG PRIOK,25843,19,25374,425,25,44,2022-01-17
317401,JAKARTA SELATAN,TEBET,16994,3,16685,280,26,29,2022-01-17
317506,JAKARTA TIMUR,CAKUNG,22702,10,22264,413,15,25,2022-01-18
317105,JAKARTA PUSAT,CEMPAKA PUTIH,10565,5,10374,168,18,23,2022-01-18
317301,JAKARTA BARAT,CENGKARENG,28779,10,28184,559,26,36,2022-01-18
317406,JAKARTA SELATAN,CILANDAK,17754,5,17451,261,37,42,2022-01-18
317204,JAKARTA UTARA,CILINCING,17462,2,17112,340,8,10,2022-01-18
317510,JAKARTA TIMUR,CIPAYUNG,25251,8,24949,268,26,34,2022-01-18
317509,JAKARTA TIMUR,CIRACAS,22570,2,22154,379,35,37,2022-01-18
317507,JAKARTA TIMUR,DUREN SAWIT,29545,19,28875,611,40,59,2022-01-18
317101,JAKARTA PUSAT,GAMBIR,8607,8,8441,134,24,32,2022-01-18
317302,JAKARTA BARAT,GROGOL PETAMBURAN,19162,27,18801,298,36,63,2022-01-18
317409,JAKARTA SELATAN,JAGAKARSA,26667,19,26220,406,22,41,2022-01-18
317503,JAKARTA TIMUR,JATINEGARA,19621,8,19211,383,19,27,2022-01-18
317108,JAKARTA PUSAT,JOHAR BARU,8709,0,8533,158,18,18,2022-01-18
317306,JAKARTA BARAT,KALI DERES,18091,13,17742,316,20,33,2022-01-18
317407,JAKARTA SELATAN,KEBAYORAN BARU,13949,9,13708,185,47,56,2022-01-18
317405,JAKARTA SELATAN,KEBAYORAN LAMA,20135,13,19709,363,50,63,2022-01-18
317305,JAKARTA BARAT,KEBON JERUK,22191,26,21751,375,39,65,2022-01-18
317206,JAKARTA UTARA,KELAPA GADING,12709,11,12472,193,33,44,2022-01-18
317103,JAKARTA PUSAT,KEMAYORAN,20035,22,19620,373,20,42,2022-01-18
317308,JAKARTA BARAT,KEMBANGAN,20330,9,19977,303,41,50,2022-01-18
310102,KAB.ADM.KEP.SERIBU,KEP. SERIBU SELATAN,704,0,694,10,0,0,2022-01-18
310101,KAB.ADM.KEP.SERIBU,KEP. SERIBU UTARA,640,0,634,6,0,0,2022-01-18
317203,JAKARTA UTARA,KOJA,17265,10,16903,339,13,23,2022-01-18
317504,JAKARTA TIMUR,KRAMAT JATI,21668,7,21237,402,22,29,2022-01-18
111111,LUAR DKI JAKARTA,LUAR DKI JAKARTA,90835,35,90129,613,58,93,2022-01-18
317508,JAKARTA TIMUR,MAKASAR,17514,15,17190,298,11,26,2022-01-18
317403,JAKARTA SELATAN,MAMPANG PRAPATAN,11554,6,11344,179,25,31,2022-01-18
317501,JAKARTA TIMUR,MATRAMAN,14250,5,13952,279,14,19,2022-01-18
317106,JAKARTA PUSAT,MENTENG,6469,6,6318,119,26,32,2022-01-18
317205,JAKARTA UTARA,PADEMANGAN,12929,9,12735,163,22,31,2022-01-18
317307,JAKARTA BARAT,PALMERAH,15870,11,15517,329,13,24,2022-01-18
317408,JAKARTA SELATAN,PANCORAN,14373,8,14115,227,23,31,2022-01-18
317404,JAKARTA SELATAN,PASAR MINGGU,23885,9,23419,426,31,40,2022-01-18
317505,JAKARTA TIMUR,PASAR REBO,17665,5,17323,326,11,16,2022-01-18
317201,JAKARTA UTARA,PENJARINGAN,18708,8,18430,230,40,48,2022-01-18
317410,JAKARTA SELATAN,PESANGGRAHAN,16409,7,16132,252,18,25,2022-01-18
111111,PROSES UPDATE DATA,PROSES UPDATE DATA,56884,509,53641,662,2072,2581,2022-01-18
317502,JAKARTA TIMUR,PULO GADUNG,21853,17,21409,401,26,43,2022-01-18
317102,JAKARTA PUSAT,SAWAH BESAR,9210,9,8996,172,33,42,2022-01-18
317104,JAKARTA PUSAT,SENEN,9414,2,9229,168,15,17,2022-01-18
317402,JAKARTA SELATAN,SETIA BUDI,12028,4,11825,183,16,20,2022-01-18
317303,JAKARTA BARAT,TAMAN SARI,8950,29,8689,140,92,121,2022-01-18
317304,JAKARTA BARAT,TAMBORA,14241,16,13898,253,74,90,2022-01-18
317107,JAKARTA PUSAT,TANAH ABANG,11081,6,10835,223,17,23,2022-01-18
317202,JAKARTA UTARA,TANJUNG PRIOK,25859,20,25376,425,38,58,2022-01-18
317401,JAKARTA SELATAN,TEBET,17000,2,16686,280,32,34,2022-01-18
317506,JAKARTA TIMUR,CAKUNG,22711,11,22265,413,22,33,2022-01-19
317105,JAKARTA PUSAT,CEMPAKA PUTIH,10572,9,10374,168,21,30,2022-01-19
317301,JAKARTA BARAT,CENGKARENG,28802,15,28185,559,43,58,2022-01-19
317406,JAKARTA SELATAN,CILANDAK,17775,8,17451,261,55,63,2022-01-19
317204,JAKARTA UTARA,CILINCING,17468,6,17112,340,10,16,2022-01-19
317510,JAKARTA TIMUR,CIPAYUNG,25264,10,24949,268,37,47,2022-01-19
317509,JAKARTA TIMUR,CIRACAS,22580,3,22154,379,44,47,2022-01-19
317507,JAKARTA TIMUR,DUREN SAWIT,29555,22,28875,611,47,69,2022-01-19
317101,JAKARTA PUSAT,GAMBIR,8617,9,8441,134,33,42,2022-01-19
317302,JAKARTA BARAT,GROGOL PETAMBURAN,19178,34,18802,298,44,78,2022-01-19
317409,JAKARTA SELATAN,JAGAKARSA,26685,21,26221,406,37,58,2022-01-19
317503,JAKARTA TIMUR,JATINEGARA,19630,10,19211,383,26,36,2022-01-19
317108,JAKARTA PUSAT,JOHAR BARU,8715,1,8534,158,22,23,2022-01-19
317306,JAKARTA BARAT,KALI DERES,18102,13,17745,316,28,41,2022-01-19
317407,JAKARTA SELATAN,KEBAYORAN BARU,13968,14,13709,185,60,74,2022-01-19
317405,JAKARTA SELATAN,KEBAYORAN LAMA,20162,14,19712,363,73,87,2022-01-19
317305,JAKARTA BARAT,KEBON JERUK,22223,33,21752,375,63,96,2022-01-19
317206,JAKARTA UTARA,KELAPA GADING,12711,10,12473,193,35,45,2022-01-19
317103,JAKARTA PUSAT,KEMAYORAN,20046,27,19621,373,25,52,2022-01-19
317308,JAKARTA BARAT,KEMBANGAN,20353,13,19980,303,57,70,2022-01-19
310102,KAB.ADM.KEP.SERIBU,KEP. SERIBU SELATAN,704,0,694,10,0,0,2022-01-19
310101,KAB.ADM.KEP.SERIBU,KEP. SERIBU UTARA,640,0,634,6,0,0,2022-01-19
317203,JAKARTA UTARA,KOJA,17279,16,16903,339,21,37,2022-01-19
317504,JAKARTA TIMUR,KRAMAT JATI,21690,8,21237,402,43,51,2022-01-19
111111,LUAR DKI JAKARTA,LUAR DKI JAKARTA,90856,38,90135,613,70,108,2022-01-19
317508,JAKARTA TIMUR,MAKASAR,17541,27,17190,298,26,53,2022-01-19
317403,JAKARTA SELATAN,MAMPANG PRAPATAN,11567,14,11344,179,30,44,2022-01-19
317501,JAKARTA TIMUR,MATRAMAN,14254,5,13952,279,18,23,2022-01-19
317106,JAKARTA PUSAT,MENTENG,6474,8,6320,119,27,35,2022-01-19
317205,JAKARTA UTARA,PADEMANGAN,12934,10,12737,163,24,34,2022-01-19
317307,JAKARTA BARAT,PALMERAH,15884,14,15517,329,24,38,2022-01-19
317408,JAKARTA SELATAN,PANCORAN,14389,9,14115,227,38,47,2022-01-19
317404,JAKARTA SELATAN,PASAR MINGGU,23897,9,23420,426,42,51,2022-01-19
317505,JAKARTA TIMUR,PASAR REBO,17671,6,17323,326,16,22,2022-01-19
317201,JAKARTA UTARA,PENJARINGAN,18727,10,18432,230,55,65,2022-01-19
317410,JAKARTA SELATAN,PESANGGRAHAN,16437,12,16132,252,41,53,2022-01-19
111111,PROSES UPDATE DATA,PROSES UPDATE DATA,57285,528,53985,662,2110,2638,2022-01-19
317502,JAKARTA TIMUR,PULO GADUNG,21865,19,21409,401,36,55,2022-01-19
317102,JAKARTA PUSAT,SAWAH BESAR,9220,12,8997,172,39,51,2022-01-19
317104,JAKARTA PUSAT,SENEN,9422,3,9229,168,22,25,2022-01-19
317402,JAKARTA SELATAN,SETIA BUDI,12039,6,11825,183,25,31,2022-01-19
317303,JAKARTA BARAT,TAMAN SARI,8967,32,8697,140,98,130,2022-01-19
317304,JAKARTA BARAT,TAMBORA,14266,20,13898,253,95,115,2022-01-19
317107,JAKARTA PUSAT,TANAH ABANG,11093,11,10836,223,23,34,2022-01-19
317202,JAKARTA UTARA,TANJUNG PRIOK,25874,20,25376,425,53,73,2022-01-19
317401,JAKARTA SELATAN,TEBET,17012,5,16686,280,41,46,2022-01-19
317506,JAKARTA TIMUR,CAKUNG,22724,15,22266,413,30,45,2022-01-20
317105,JAKARTA PUSAT,CEMPAKA PUTIH,10579,11,10376,168,24,35,2022-01-20
317301,JAKARTA BARAT,CENGKARENG,28818,26,28188,559,45,71,2022-01-20
317406,JAKARTA SELATAN,CILANDAK,17795,15,17452,261,67,82,2022-01-20
317204,JAKARTA UTARA,CILINCING,17475,8,17112,340,15,23,2022-01-20
317510,JAKARTA TIMUR,CIPAYUNG,25269,12,24950,268,39,51,2022-01-20
317509,JAKARTA TIMUR,CIRACAS,22591,8,22157,379,47,55,2022-01-20
317507,JAKARTA TIMUR,DUREN SAWIT,29569,26,28877,611,55,81,2022-01-20
317101,JAKARTA PUSAT,GAMBIR,8635,9,8448,134,44,53,2022-01-20
317302,JAKARTA BARAT,GROGOL PETAMBURAN,19200,38,18810,298,54,92,2022-01-20
317409,JAKARTA SELATAN,JAGAKARSA,26703,23,26222,406,52,75,2022-01-20
317503,JAKARTA TIMUR,JATINEGARA,19640,10,19211,383,36,46,2022-01-20
317108,JAKARTA PUSAT,JOHAR BARU,8722,3,8536,158,25,28,2022-01-20
317306,JAKARTA BARAT,KALI DERES,18112,12,17746,316,38,50,2022-01-20
317407,JAKARTA SELATAN,KEBAYORAN BARU,13988,14,13710,185,79,93,2022-01-20
317405,JAKARTA SELATAN,KEBAYORAN LAMA,20191,18,19714,363,96,114,2022-01-20
317305,JAKARTA BARAT,KEBON JERUK,22258,40,21757,375,86,126,2022-01-20
317206,JAKARTA UTARA,KELAPA GADING,12720,9,12475,193,43,52,2022-01-20
317103,JAKARTA PUSAT,KEMAYORAN,20067,30,19623,373,41,71,2022-01-20
317308,JAKARTA BARAT,KEMBANGAN,20370,12,19984,303,71,83,2022-01-20
310102,KAB.ADM.KEP.SERIBU,KEP. SERIBU SELATAN,704,0,694,10,0,0,2022-01-20
310101,KAB.ADM.KEP.SERIBU,KEP. SERIBU UTARA,640,0,634,6,0,0,2022-01-20
317203,JAKARTA UTARA,KOJA,17286,19,16903,339,25,44,2022-01-20
317504,JAKARTA TIMUR,KRAMAT JATI,21693,8,21238,402,45,53,2022-01-20
111111,LUAR DKI JAKARTA,LUAR DKI JAKARTA,90890,50,90146,613,81,131,2022-01-20
317508,JAKARTA TIMUR,MAKASAR,17556,35,17190,298,33,68,2022-01-20
317403,JAKARTA SELATAN,MAMPANG PRAPATAN,11592,15,11345,179,53,68,2022-01-20
317501,JAKARTA TIMUR,MATRAMAN,14261,8,13952,279,22,30,2022-01-20
317106,JAKARTA PUSAT,MENTENG,6481,10,6321,119,31,41,2022-01-20
317205,JAKARTA UTARA,PADEMANGAN,12944,11,12737,163,33,44,2022-01-20
317307,JAKARTA BARAT,PALMERAH,15915,17,15517,329,52,69,2022-01-20
317408,JAKARTA SELATAN,PANCORAN,14402,9,14117,227,49,58,2022-01-20
317404,JAKARTA SELATAN,PASAR MINGGU,23932,17,23421,426,68,85,2022-01-20
317505,JAKARTA TIMUR,PASAR REBO,17681,7,17323,326,25,32,2022-01-20
317201,JAKARTA UTARA,PENJARINGAN,18759,18,18433,230,78,96,2022-01-20
317410,JAKARTA SELATAN,PESANGGRAHAN,16455,13,16133,252,57,70,2022-01-20
111111,PROSES UPDATE DATA,PROSES UPDATE DATA,57713,501,54300,662,2250,2751,2022-01-20
317502,JAKARTA TIMUR,PULO GADUNG,21885,23,21411,401,50,73,2022-01-20
317102,JAKARTA PUSAT,SAWAH BESAR,9252,13,9003,172,64,77,2022-01-20
317104,JAKARTA PUSAT,SENEN,9426,4,9235,168,19,23,2022-01-20
317402,JAKARTA SELATAN,SETIA BUDI,12044,6,11827,183,28,34,2022-01-20
317303,JAKARTA BARAT,TAMAN SARI,8986,36,8717,140,93,129,2022-01-20
317304,JAKARTA BARAT,TAMBORA,14296,22,13904,253,117,139,2022-01-20
317107,JAKARTA PUSAT,TANAH ABANG,11112,13,10845,223,31,44,2022-01-20
317202,JAKARTA UTARA,TANJUNG PRIOK,25895,21,25380,425,69,90,2022-01-20
317401,JAKARTA SELATAN,TEBET,17033,7,16686,280,60,67,2022-01-20
317506,JAKARTA TIMUR,CAKUNG,22734,18,22269,413,34,52,2022-01-21
317105,JAKARTA PUSAT,CEMPAKA PUTIH,10601,14,10377,168,42,56,2022-01-21
317301,JAKARTA BARAT,CENGKARENG,28842,35,28190,559,58,93,2022-01-21
317406,JAKARTA SELATAN,CILANDAK,17826,27,17454,261,84,111,2022-01-21
317204,JAKARTA UTARA,CILINCING,17486,9,17116,340,21,30,2022-01-21
317510,JAKARTA TIMUR,CIPAYUNG,25300,13,24959,268,60,73,2022-01-21
317509,JAKARTA TIMUR,CIRACAS,22603,8,22165,379,51,59,2022-01-21
317507,JAKARTA TIMUR,DUREN SAWIT,29615,33,28881,611,90,123,2022-01-21
317101,JAKARTA PUSAT,GAMBIR,8654,10,8452,134,58,68,2022-01-21
317302,JAKARTA BARAT,GROGOL PETAMBURAN,19238,43,18814,298,83,126,2022-01-21
317409,JAKARTA SELATAN,JAGAKARSA,26719,25,26226,406,62,87,2022-01-21
317503,JAKARTA TIMUR,JATINEGARA,19670,17,19211,383,59,76,2022-01-21
317108,JAKARTA PUSAT,JOHAR BARU,8739,8,8536,158,37,45,2022-01-21
317306,JAKARTA BARAT,KALI DERES,18138,24,17750,316,48,72,2022-01-21
317407,JAKARTA SELATAN,KEBAYORAN BARU,14000,20,13719,185,76,96,2022-01-21
317405,JAKARTA SELATAN,KEBAYORAN LAMA,20218,24,19719,363,112,136,2022-01-21
317305,JAKARTA BARAT,KEBON JERUK,22310,54,21758,375,123,177,2022-01-21
317206,JAKARTA UTARA,KELAPA GADING,12737,6,12481,193,57,63,2022-01-21
317103,JAKARTA PUSAT,KEMAYORAN,20105,34,19627,373,71,105,2022-01-21
317308,JAKARTA BARAT,KEMBANGAN,20409,15,19996,303,95,110,2022-01-21
310102,KAB.ADM.KEP.SERIBU,KEP. SERIBU SELATAN,704,0,694,10,0,0,2022-01-21
310101,KAB.ADM.KEP.SERIBU,KEP. SERIBU UTARA,640,0,634,6,0,0,2022-01-21
317203,JAKARTA UTARA,KOJA,17293,22,16903,339,29,51,2022-01-21
317504,JAKARTA TIMUR,KRAMAT JATI,21703,11,21242,402,48,59,2022-01-21
111111,LUAR DKI JAKARTA,LUAR DKI JAKARTA,90930,52,90167,613,98,150,2022-01-21
317508,JAKARTA TIMUR,MAKASAR,17566,36,17191,298,41,77,2022-01-21
317403,JAKARTA SELATAN,MAMPANG PRAPATAN,11607,15,11346,179,67,82,2022-01-21
317501,JAKARTA TIMUR,MATRAMAN,14276,13,13952,279,32,45,2022-01-21
317106,JAKARTA PUSAT,MENTENG,6492,12,6323,119,38,50,2022-01-21
317205,JAKARTA UTARA,PADEMANGAN,12972,15,12739,163,55,70,2022-01-21
317307,JAKARTA BARAT,PALMERAH,15940,22,15517,329,72,94,2022-01-21
317408,JAKARTA SELATAN,PANCORAN,14420,11,14122,227,60,71,2022-01-21
317404,JAKARTA SELATAN,PASAR MINGGU,23965,23,23426,426,90,113,2022-01-21
317505,JAKARTA TIMUR,PASAR REBO,17692,9,17323,326,34,43,2022-01-21
317201,JAKARTA UTARA,PENJARINGAN,18809,25,18445,230,109,134,2022-01-21
317410,JAKARTA SELATAN,PESANGGRAHAN,16488,16,16135,252,85,101,2022-01-21
111111,PROSES UPDATE DATA,PROSES UPDATE DATA,58142,539,54760,662,2181,2720,2022-01-21
317502,JAKARTA TIMUR,PULO GADUNG,21887,18,21416,401,52,70,2022-01-21
317102,JAKARTA PUSAT,SAWAH BESAR,9270,22,9005,172,71,93,2022-01-21
317104,JAKARTA PUSAT,SENEN,9451,9,9237,168,37,46,2022-01-21
317402,JAKARTA SELATAN,SETIA BUDI,12063,11,11831,183,38,49,2022-01-21
317303,JAKARTA BARAT,TAMAN SARI,9009,43,8742,140,84,127,2022-01-21
317304,JAKARTA BARAT,TAMBORA,14348,26,13904,253,165,191,2022-01-21
317107,JAKARTA PUSAT,TANAH ABANG,11130,14,10848,223,45,59,2022-01-21
317202,JAKARTA UTARA,TANJUNG PRIOK,25926,28,25382,425,91,119,2022-01-21
317401,JAKARTA SELATAN,TEBET,17076,16,16692,280,88,104,2022-01-21
317506,JAKARTA TIMUR,CAKUNG,22756,20,22270,413,53,73,2022-01-22
317105,JAKARTA PUSAT,CEMPAKA PUTIH,10602,13,10378,168,43,56,2022-01-22
317301,JAKARTA BARAT,CENGKARENG,28881,42,28195,559,85,127,2022-01-22
317406,JAKARTA SELATAN,CILANDAK,17865,36,17458,261,110,146,2022-01-22
317204,JAKARTA UTARA,CILINCING,17497,14,17116,340,27,41,2022-01-22
317510,JAKARTA TIMUR,CIPAYUNG,25307,14,24963,268,62,76,2022-01-22
317509,JAKARTA TIMUR,CIRACAS,22634,13,22172,379,70,83,2022-01-22
317507,JAKARTA TIMUR,DUREN SAWIT,29647,33,28891,611,112,145,2022-01-22
317101,JAKARTA PUSAT,GAMBIR,8672,16,8455,134,67,83,2022-01-22
317302,JAKARTA BARAT,GROGOL PETAMBURAN,19285,66,18824,298,97,163,2022-01-22
317409,JAKARTA SELATAN,JAGAKARSA,26747,29,26231,406,81,110,2022-01-22
317503,JAKARTA TIMUR,JATINEGARA,19698,21,19216,383,78,99,2022-01-22
317108,JAKARTA PUSAT,JOHAR BARU,8743,9,8540,158,36,45,2022-01-22
317306,JAKARTA BARAT,KALI DERES,18160,29,17754,316,61,90,2022-01-22
317407,JAKARTA SELATAN,KEBAYORAN BARU,14030,16,13721,185,108,124,2022-01-22
317405,JAKARTA SELATAN,KEBAYORAN LAMA,20253,32,19733,363,125,157,2022-01-22
317305,JAKARTA BARAT,KEBON JERUK,22380,54,21769,375,182,236,2022-01-22
317206,JAKARTA UTARA,KELAPA GADING,12762,10,12489,193,70,80,2022-01-22
317103,JAKARTA PUSAT,KEMAYORAN,20125,33,19630,373,89,122,2022-01-22
317308,JAKARTA BARAT,KEMBANGAN,20449,21,20000,303,125,146,2022-01-22
310102,KAB.ADM.KEP.SERIBU,KEP. SERIBU SELATAN,704,0,694,10,0,0,2022-01-22
310101,KAB.ADM.KEP.SERIBU,KEP. SERIBU UTARA,640,0,634,6,0,0,2022-01-22
317203,JAKARTA UTARA,KOJA,17312,27,16903,339,43,70,2022-01-22
317504,JAKARTA TIMUR,KRAMAT JATI,21722,12,21245,402,63,75,2022-01-22
111111,LUAR DKI JAKARTA,LUAR DKI JAKARTA,90958,47,90190,613,108,155,2022-01-22
317508,JAKARTA TIMUR,MAKASAR,17574,37,17193,298,46,83,2022-01-22
317403,JAKARTA SELATAN,MAMPANG PRAPATAN,11629,19,11348,179,83,102,2022-01-22
317501,JAKARTA TIMUR,MATRAMAN,14301,22,13953,279,47,69,2022-01-22
317106,JAKARTA PUSAT,MENTENG,6504,16,6323,119,46,62,2022-01-22
317205,JAKARTA UTARA,PADEMANGAN,13008,20,12744,163,81,101,2022-01-22
317307,JAKARTA BARAT,PALMERAH,15964,26,15519,329,90,116,2022-01-22
317408,JAKARTA SELATAN,PANCORAN,14446,13,14126,227,80,93,2022-01-22
317404,JAKARTA SELATAN,PASAR MINGGU,24009,29,23428,426,126,155,2022-01-22
317505,JAKARTA TIMUR,PASAR REBO,17709,17,17327,326,39,56,2022-01-22
317201,JAKARTA UTARA,PENJARINGAN,18861,31,18453,230,147,178,2022-01-22
317410,JAKARTA SELATAN,PESANGGRAHAN,16512,20,16136,252,104,124,2022-01-22
111111,PROSES UPDATE DATA,PROSES UPDATE DATA,58756,602,54994,662,2498,3100,2022-01-22
317502,JAKARTA TIMUR,PULO GADUNG,21925,30,21424,401,70,100,2022-01-22
317102,JAKARTA PUSAT,SAWAH BESAR,9301,29,9006,172,94,123,2022-01-22
317104,JAKARTA PUSAT,SENEN,9471,14,9238,168,51,65,2022-01-22
317402,JAKARTA SELATAN,SETIA BUDI,12085,15,11833,183,54,69,2022-01-22
317303,JAKARTA BARAT,TAMAN SARI,9057,54,8765,140,98,152,2022-01-22
317304,JAKARTA BARAT,TAMBORA,14414,40,13919,253,202,242,2022-01-22
317107,JAKARTA PUSAT,TANAH ABANG,11150,14,10849,223,64,78,2022-01-22
317202,JAKARTA UTARA,TANJUNG PRIOK,25958,34,25392,425,107,141,2022-01-22
317401,JAKARTA SELATAN,TEBET,17105,21,16696,280,108,129,2022-01-22
317506,JAKARTA TIMUR,CAKUNG,22786,27,22274,413,72,99,2022-01-23
317105,JAKARTA PUSAT,CEMPAKA PUTIH,10620,25,10380,168,47,72,2022-01-23
317301,JAKARTA BARAT,CENGKARENG,28909,47,28199,559,104,151,2022-01-23
317406,JAKARTA SELATAN,CILANDAK,17895,45,17463,261,126,171,2022-01-23
317204,JAKARTA UTARA,CILINCING,17516,23,17116,340,37,60,2022-01-23
317510,JAKARTA TIMUR,CIPAYUNG,25333,15,24971,268,79,94,2022-01-23
317509,JAKARTA TIMUR,CIRACAS,22646,16,22172,379,79,95,2022-01-23
317507,JAKARTA TIMUR,DUREN SAWIT,29688,44,28899,611,134,178,2022-01-23
317101,JAKARTA PUSAT,GAMBIR,8693,18,8458,134,83,101,2022-01-23
317302,JAKARTA BARAT,GROGOL PETAMBURAN,19350,77,18834,298,141,218,2022-01-23
317409,JAKARTA SELATAN,JAGAKARSA,26781,23,26239,406,113,136,2022-01-23
317503,JAKARTA TIMUR,JATINEGARA,19712,22,19221,383,86,108,2022-01-23
317108,JAKARTA PUSAT,JOHAR BARU,8778,30,8541,158,49,79,2022-01-23
317306,JAKARTA BARAT,KALI DERES,18191,34,17764,316,77,111,2022-01-23
317407,JAKARTA SELATAN,KEBAYORAN BARU,14061,21,13725,185,130,151,2022-01-23
317405,JAKARTA SELATAN,KEBAYORAN LAMA,20301,36,19740,363,162,198,2022-01-23
317305,JAKARTA BARAT,KEBON JERUK,22439,71,21772,375,221,292,2022-01-23
317206,JAKARTA UTARA,KELAPA GADING,12789,13,12493,193,90,103,2022-01-23
317103,JAKARTA PUSAT,KEMAYORAN,20152,39,19634,375,104,143,2022-01-23
317308,JAKARTA BARAT,KEMBANGAN,20489,24,20008,303,154,178,2022-01-23
310102,KAB.ADM.KEP.SERIBU,KEP. SERIBU SELATAN,704,0,694,10,0,0,2022-01-23
310101,KAB.ADM.KEP.SERIBU,KEP. SERIBU UTARA,640,0,634,6,0,0,2022-01-23
317203,JAKARTA UTARA,KOJA,17333,29,16907,339,58,87,2022-01-23
317504,JAKARTA TIMUR,KRAMAT JATI,21735,15,21248,402,70,85,2022-01-23
111111,LUAR DKI JAKARTA,LUAR DKI JAKARTA,90986,49,90204,613,120,169,2022-01-23
317508,JAKARTA TIMUR,MAKASAR,17594,39,17196,298,61,100,2022-01-23
317403,JAKARTA SELATAN,MAMPANG PRAPATAN,11639,20,11351,179,89,109,2022-01-23
317501,JAKARTA TIMUR,MATRAMAN,14316,25,13956,279,56,81,2022-01-23
317106,JAKARTA PUSAT,MENTENG,6514,18,6330,119,47,65,2022-01-23
317205,JAKARTA UTARA,PADEMANGAN,13026,22,12751,163,90,112,2022-01-23
317307,JAKARTA BARAT,PALMERAH,16009,31,15522,329,127,158,2022-01-23
317408,JAKARTA SELATAN,PANCORAN,14463,13,14131,227,92,105,2022-01-23
317404,JAKARTA SELATAN,PASAR MINGGU,24026,34,23431,426,135,169,2022-01-23
317505,JAKARTA TIMUR,PASAR REBO,17720,16,17331,326,47,63,2022-01-23
317201,JAKARTA UTARA,PENJARINGAN,18917,43,18458,230,186,229,2022-01-23
317410,JAKARTA SELATAN,PESANGGRAHAN,16532,19,16140,253,120,139,2022-01-23
111111,PROSES UPDATE DATA,PROSES UPDATE DATA,59243,671,55307,663,2602,3273,2022-01-23
317502,JAKARTA TIMUR,PULO GADUNG,21968,34,21427,401,106,140,2022-01-23
317102,JAKARTA PUSAT,SAWAH BESAR,9357,53,9009,172,123,176,2022-01-23
317104,JAKARTA PUSAT,SENEN,9484,17,9239,169,59,76,2022-01-23
317402,JAKARTA SELATAN,SETIA BUDI,12098,16,11834,184,64,80,2022-01-23
317303,JAKARTA BARAT,TAMAN SARI,9099,67,8774,140,118,185,2022-01-23
317304,JAKARTA BARAT,TAMBORA,14480,51,13927,253,249,300,2022-01-23
317107,JAKARTA PUSAT,TANAH ABANG,11172,17,10851,223,81,98,2022-01-23
317202,JAKARTA UTARA,TANJUNG PRIOK,25997,42,25402,425,128,170,2022-01-23
317401,JAKARTA SELATAN,TEBET,17126,20,16696,280,130,150,2022-01-23
317506,JAKARTA TIMUR,CAKUNG,22811,27,22277,413,94,121,2022-01-24
317105,JAKARTA PUSAT,CEMPAKA PUTIH,10640,32,10380,168,60,92,2022-01-24
317301,JAKARTA BARAT,CENGKARENG,28968,60,28198,559,151,211,2022-01-24
317406,JAKARTA SELATAN,CILANDAK,17904,34,17466,261,143,177,2022-01-24
317204,JAKARTA UTARA,CILINCING,17524,26,17116,340,42,68,2022-01-24
317510,JAKARTA TIMUR,CIPAYUNG,25364,31,24976,268,89,120,2022-01-24
317509,JAKARTA TIMUR,CIRACAS,22666,21,22181,379,85,106,2022-01-24
317507,JAKARTA TIMUR,DUREN SAWIT,29725,44,28912,611,158,202,2022-01-24
317101,JAKARTA PUSAT,GAMBIR,8720,19,8462,134,105,124,2022-01-24
317302,JAKARTA BARAT,GROGOL PETAMBURAN,19427,89,18836,298,204,293,2022-01-24
317409,JAKARTA SELATAN,JAGAKARSA,26808,21,26243,406,138,159,2022-01-24
317503,JAKARTA TIMUR,JATINEGARA,19726,24,19225,383,94,118,2022-01-24
317108,JAKARTA PUSAT,JOHAR BARU,8792,33,8543,158,58,91,2022-01-24
317306,JAKARTA BARAT,KALI DERES,18215,45,17765,316,89,134,2022-01-24
317407,JAKARTA SELATAN,KEBAYORAN BARU,14096,26,13728,185,157,183,2022-01-24
317405,JAKARTA SELATAN,KEBAYORAN LAMA,20340,40,19748,363,189,229,2022-01-24
317305,JAKARTA BARAT,KEBON JERUK,22486,77,21782,375,252,329,2022-01-24
317206,JAKARTA UTARA,KELAPA GADING,12825,17,12499,193,116,133,2022-01-24
317103,JAKARTA PUSAT,KEMAYORAN,20193,40,19640,375,138,178,2022-01-24
317308,JAKARTA BARAT,KEMBANGAN,20532,27,20010,303,192,219,2022-01-24
310102,KAB.ADM.KEP.SERIBU,KEP. SERIBU SELATAN,704,0,694,10,0,0,2022-01-24
310101,KAB.ADM.KEP.SERIBU,KEP. SERIBU UTARA,640,0,634,6,0,0,2022-01-24
317203,JAKARTA UTARA,KOJA,17345,33,16909,339,64,97,2022-01-24
317504,JAKARTA TIMUR,KRAMAT JATI,21759,15,21253,402,89,104,2022-01-24
111111,LUAR DKI JAKARTA,LUAR DKI JAKARTA,91042,48,90227,613,154,202,2022-01-24
317508,JAKARTA TIMUR,MAKASAR,17600,41,17202,298,59,100,2022-01-24
317403,JAKARTA SELATAN,MAMPANG PRAPATAN,11660,17,11358,179,106,123,2022-01-24
317501,JAKARTA TIMUR,MATRAMAN,14334,30,13959,279,66,96,2022-01-24
317106,JAKARTA PUSAT,MENTENG,6525,17,6336,119,53,70,2022-01-24
317205,JAKARTA UTARA,PADEMANGAN,13048,25,12753,163,107,132,2022-01-24
317307,JAKARTA BARAT,PALMERAH,16035,39,15523,329,144,183,2022-01-24
317408,JAKARTA SELATAN,PANCORAN,14494,13,14141,227,113,126,2022-01-24
317404,JAKARTA SELATAN,PASAR MINGGU,24064,36,23436,426,166,202,2022-01-24
317505,JAKARTA TIMUR,PASAR REBO,17738,16,17332,326,64,80,2022-01-24
317201,JAKARTA UTARA,PENJARINGAN,18966,48,18459,230,229,277,2022-01-24
317410,JAKARTA SELATAN,PESANGGRAHAN,16570,18,16145,253,154,172,2022-01-24
111111,PROSES UPDATE DATA,PROSES UPDATE DATA,59931,749,55677,663,2842,3591,2022-01-24
317502,JAKARTA TIMUR,PULO GADUNG,22001,35,21427,401,138,173,2022-01-24
317102,JAKARTA PUSAT,SAWAH BESAR,9401,65,9014,172,150,215,2022-01-24
317104,JAKARTA PUSAT,SENEN,9500,22,9239,169,70,92,2022-01-24
317402,JAKARTA SELATAN,SETIA BUDI,12109,19,11837,184,69,88,2022-01-24
317303,JAKARTA BARAT,TAMAN SARI,9138,73,8778,140,147,220,2022-01-24
317304,JAKARTA BARAT,TAMBORA,14535,64,13938,253,280,344,2022-01-24
317107,JAKARTA PUSAT,TANAH ABANG,11198,20,10852,223,103,123,2022-01-24
317202,JAKARTA UTARA,TANJUNG PRIOK,26033,42,25406,425,160,202,2022-01-24
317401,JAKARTA SELATAN,TEBET,17168,24,16699,280,165,189,2022-01-24
317506,JAKARTA TIMUR,CAKUNG,22847,35,22284,414,114,149,2022-01-25
317105,JAKARTA PUSAT,CEMPAKA PUTIH,10668,37,10382,168,81,118,2022-01-25
317301,JAKARTA BARAT,CENGKARENG,29026,78,28202,562,184,262,2022-01-25
317406,JAKARTA SELATAN,CILANDAK,17960,48,17469,261,182,230,2022-01-25
317204,JAKARTA UTARA,CILINCING,17534,27,17118,341,48,75,2022-01-25
317510,JAKARTA TIMUR,CIPAYUNG,25390,40,24981,268,101,141,2022-01-25
317509,JAKARTA TIMUR,CIRACAS,22689,30,22187,379,93,123,2022-01-25
317507,JAKARTA TIMUR,DUREN SAWIT,29782,61,28917,611,193,254,2022-01-25
317101,JAKARTA PUSAT,GAMBIR,8749,23,8464,134,128,151,2022-01-25
317302,JAKARTA BARAT,GROGOL PETAMBURAN,19503,97,18849,298,259,356,2022-01-25
317409,JAKARTA SELATAN,JAGAKARSA,26852,31,26246,406,169,200,2022-01-25
317503,JAKARTA TIMUR,JATINEGARA,19767,25,19233,383,126,151,2022-01-25
317108,JAKARTA PUSAT,JOHAR BARU,8815,44,8543,158,70,114,2022-01-25
317306,JAKARTA BARAT,KALI DERES,18251,61,17769,317,104,165,2022-01-25
317407,JAKARTA SELATAN,KEBAYORAN BARU,14134,36,13731,185,182,218,2022-01-25
317405,JAKARTA SELATAN,KEBAYORAN LAMA,20411,56,19752,363,240,296,2022-01-25
317305,JAKARTA BARAT,KEBON JERUK,22570,101,21794,375,300,401,2022-01-25
317206,JAKARTA UTARA,KELAPA GADING,12872,28,12500,193,151,179,2022-01-25
317103,JAKARTA PUSAT,KEMAYORAN,20241,57,19650,375,159,216,2022-01-25
317308,JAKARTA BARAT,KEMBANGAN,20581,35,20023,303,220,255,2022-01-25
310102,KAB.ADM.KEP.SERIBU,KEP. SERIBU SELATAN,704,0,694,10,0,0,2022-01-25
310101,KAB.ADM.KEP.SERIBU,KEP. SERIBU UTARA,640,0,634,6,0,0,2022-01-25
317203,JAKARTA UTARA,KOJA,17361,34,16919,339,69,103,2022-01-25
317504,JAKARTA TIMUR,KRAMAT JATI,21784,25,21255,402,102,127,2022-01-25
111111,LUAR DKI JAKARTA,LUAR DKI JAKARTA,91079,44,90253,614,168,212,2022-01-25
317508,JAKARTA TIMUR,MAKASAR,17626,56,17204,298,68,124,2022-01-25
317403,JAKARTA SELATAN,MAMPANG PRAPATAN,11690,25,11361,179,125,150,2022-01-25
317501,JAKARTA TIMUR,MATRAMAN,14357,36,13962,279,80,116,2022-01-25
317106,JAKARTA PUSAT,MENTENG,6547,26,6339,119,63,89,2022-01-25
317205,JAKARTA UTARA,PADEMANGAN,13101,47,12758,163,133,180,2022-01-25
317307,JAKARTA BARAT,PALMERAH,16069,50,15529,329,161,211,2022-01-25
317408,JAKARTA SELATAN,PANCORAN,14517,20,14141,227,129,149,2022-01-25
317404,JAKARTA SELATAN,PASAR MINGGU,24119,46,23440,427,206,252,2022-01-25
317505,JAKARTA TIMUR,PASAR REBO,17767,28,17333,326,80,108,2022-01-25
317201,JAKARTA UTARA,PENJARINGAN,19046,78,18468,230,270,348,2022-01-25
317410,JAKARTA SELATAN,PESANGGRAHAN,16608,30,16151,253,174,204,2022-01-25
111111,PROSES UPDATE DATA,PROSES UPDATE DATA,60306,733,55904,664,3005,3738,2022-01-25
317502,JAKARTA TIMUR,PULO GADUNG,22061,47,21434,402,178,225,2022-01-25
317102,JAKARTA PUSAT,SAWAH BESAR,9445,81,9017,172,175,256,2022-01-25
317104,JAKARTA PUSAT,SENEN,9530,39,9239,169,83,122,2022-01-25
317402,JAKARTA SELATAN,SETIA BUDI,12127,27,11839,183,78,105,2022-01-25
317303,JAKARTA BARAT,TAMAN SARI,9206,91,8795,140,180,271,2022-01-25
317304,JAKARTA BARAT,TAMBORA,14622,88,13954,253,327,415,2022-01-25
317107,JAKARTA PUSAT,TANAH ABANG,11242,34,10852,223,133,167,2022-01-25
317202,JAKARTA UTARA,TANJUNG PRIOK,26085,56,25413,425,191,247,2022-01-25
317401,JAKARTA SELATAN,TEBET,17209,30,16706,280,193,223,2022-01-25
317506,JAKARTA TIMUR,CAKUNG,22904,53,22296,414,141,194,2022-01-26
317105,JAKARTA PUSAT,CEMPAKA PUTIH,10698,39,10397,168,94,133,2022-01-26
317301,JAKARTA BARAT,CENGKARENG,29147,106,28221,562,258,364,2022-01-26
317406,JAKARTA SELATAN,CILANDAK,18053,70,17503,261,219,289,2022-01-26
317204,JAKARTA UTARA,CILINCING,17587,32,17123,341,91,123,2022-01-26
317510,JAKARTA TIMUR,CIPAYUNG,25426,50,24991,268,117,167,2022-01-26
317509,JAKARTA TIMUR,CIRACAS,22736,42,22200,379,115,157,2022-01-26
317507,JAKARTA TIMUR,DUREN SAWIT,29893,71,28941,611,270,341,2022-01-26
317101,JAKARTA PUSAT,GAMBIR,8817,29,8481,134,173,202,2022-01-26
317302,JAKARTA BARAT,GROGOL PETAMBURAN,19617,115,18875,298,329,444,2022-01-26
317409,JAKARTA SELATAN,JAGAKARSA,26950,40,26274,406,230,270,2022-01-26
317503,JAKARTA TIMUR,JATINEGARA,19830,31,19246,383,170,201,2022-01-26
317108,JAKARTA PUSAT,JOHAR BARU,8877,53,8556,158,110,163,2022-01-26
317306,JAKARTA BARAT,KALI DERES,18324,76,17779,317,152,228,2022-01-26
317407,JAKARTA SELATAN,KEBAYORAN BARU,14208,49,13772,185,202,251,2022-01-26
317405,JAKARTA SELATAN,KEBAYORAN LAMA,20499,68,19781,363,287,355,2022-01-26
317305,JAKARTA BARAT,KEBON JERUK,22725,144,21831,376,374,518,2022-01-26
317206,JAKARTA UTARA,KELAPA GADING,12936,37,12515,193,191,228,2022-01-26
317103,JAKARTA PUSAT,KEMAYORAN,20351,71,19680,375,225,296,2022-01-26
317308,JAKARTA BARAT,KEMBANGAN,20647,47,20048,303,249,296,2022-01-26
310102,KAB.ADM.KEP.SERIBU,KEP. SERIBU SELATAN,704,0,694,10,0,0,2022-01-26
310101,KAB.ADM.KEP.SERIBU,KEP. SERIBU UTARA,640,0,634,6,0,0,2022-01-26
317203,JAKARTA UTARA,KOJA,17413,50,16938,339,86,136,2022-01-26
317504,JAKARTA TIMUR,KRAMAT JATI,21847,32,21274,402,139,171,2022-01-26
111111,LUAR DKI JAKARTA,LUAR DKI JAKARTA,91114,34,90314,614,152,186,2022-01-26
317508,JAKARTA TIMUR,MAKASAR,17685,68,17228,298,91,159,2022-01-26
317403,JAKARTA SELATAN,MAMPANG PRAPATAN,11724,24,11377,179,144,168,2022-01-26
317501,JAKARTA TIMUR,MATRAMAN,14407,55,13974,279,99,154,2022-01-26
317106,JAKARTA PUSAT,MENTENG,6575,30,6350,119,76,106,2022-01-26
317205,JAKARTA UTARA,PADEMANGAN,13161,61,12767,163,170,231,2022-01-26
317307,JAKARTA BARAT,PALMERAH,16181,67,15545,329,240,307,2022-01-26
317408,JAKARTA SELATAN,PANCORAN,14591,22,14157,227,185,207,2022-01-26
317404,JAKARTA SELATAN,PASAR MINGGU,24193,51,23460,427,255,306,2022-01-26
317505,JAKARTA TIMUR,PASAR REBO,17830,33,17340,326,131,164,2022-01-26
317201,JAKARTA UTARA,PENJARINGAN,19183,107,18496,230,350,457,2022-01-26
317410,JAKARTA SELATAN,PESANGGRAHAN,16662,34,16177,253,198,232,2022-01-26
111111,PROSES UPDATE DATA,PROSES UPDATE DATA,60560,707,56612,667,2574,3281,2022-01-26
317502,JAKARTA TIMUR,PULO GADUNG,22158,64,21446,402,246,310,2022-01-26
317102,JAKARTA PUSAT,SAWAH BESAR,9533,107,9051,173,202,309,2022-01-26
317104,JAKARTA PUSAT,SENEN,9585,56,9248,169,112,168,2022-01-26
317402,JAKARTA SELATAN,SETIA BUDI,12186,35,11849,183,119,154,2022-01-26
317303,JAKARTA BARAT,TAMAN SARI,9278,97,8831,140,210,307,2022-01-26
317304,JAKARTA BARAT,TAMBORA,14763,115,13999,254,395,510,2022-01-26
317107,JAKARTA PUSAT,TANAH ABANG,11308,49,10862,223,174,223,2022-01-26
317202,JAKARTA UTARA,TANJUNG PRIOK,26188,62,25450,425,251,313,2022-01-26
317401,JAKARTA SELATAN,TEBET,17305,49,16722,280,254,303,2022-01-26
317506,JAKARTA TIMUR,CAKUNG,22971,72,22306,414,179,251,2022-01-27
317105,JAKARTA PUSAT,CEMPAKA PUTIH,10739,40,10406,168,125,165,2022-01-27
317301,JAKARTA BARAT,CENGKARENG,29293,139,28250,562,342,481,2022-01-27
317406,JAKARTA SELATAN,CILANDAK,18160,88,17517,261,294,382,2022-01-27
317204,JAKARTA UTARA,CILINCING,17624,44,17128,341,111,155,2022-01-27
317510,JAKARTA TIMUR,CIPAYUNG,25487,59,25007,268,153,212,2022-01-27
317509,JAKARTA TIMUR,CIRACAS,22827,63,22218,379,167,230,2022-01-27
317507,JAKARTA TIMUR,DUREN SAWIT,29985,96,28959,611,319,415,2022-01-27
317101,JAKARTA PUSAT,GAMBIR,8881,38,8492,134,217,255,2022-01-27
317302,JAKARTA BARAT,GROGOL PETAMBURAN,19765,169,18898,298,400,569,2022-01-27
317409,JAKARTA SELATAN,JAGAKARSA,27019,46,26298,406,269,315,2022-01-27
317503,JAKARTA TIMUR,JATINEGARA,19893,43,19266,383,201,244,2022-01-27
317108,JAKARTA PUSAT,JOHAR BARU,8923,40,8560,158,165,205,2022-01-27
317306,JAKARTA BARAT,KALI DERES,18400,103,17790,317,190,293,2022-01-27
317407,JAKARTA SELATAN,KEBAYORAN BARU,14302,74,13790,185,253,327,2022-01-27
317405,JAKARTA SELATAN,KEBAYORAN LAMA,20617,85,19815,363,354,439,2022-01-27
317305,JAKARTA BARAT,KEBON JERUK,22889,201,21871,376,441,642,2022-01-27
317206,JAKARTA UTARA,KELAPA GADING,13019,59,12521,193,246,305,2022-01-27
317103,JAKARTA PUSAT,KEMAYORAN,20451,101,19704,375,271,372,2022-01-27
317308,JAKARTA BARAT,KEMBANGAN,20744,63,20066,303,312,375,2022-01-27
310102,KAB.ADM.KEP.SERIBU,KEP. SERIBU SELATAN,704,0,694,10,0,0,2022-01-27
310101,KAB.ADM.KEP.SERIBU,KEP. SERIBU UTARA,640,0,634,6,0,0,2022-01-27
317203,JAKARTA UTARA,KOJA,17452,64,16943,339,106,170,2022-01-27
317504,JAKARTA TIMUR,KRAMAT JATI,21922,54,21288,402,178,232,2022-01-27
111111,LUAR DKI JAKARTA,LUAR DKI JAKARTA,95252,356,93086,622,1188,1544,2022-01-27
317508,JAKARTA TIMUR,MAKASAR,17750,78,17244,298,130,208,2022-01-27
317403,JAKARTA SELATAN,MAMPANG PRAPATAN,11777,30,11402,179,166,196,2022-01-27
317501,JAKARTA TIMUR,MATRAMAN,14441,59,13981,279,122,181,2022-01-27
317106,JAKARTA PUSAT,MENTENG,6609,29,6358,119,103,132,2022-01-27
317205,JAKARTA UTARA,PADEMANGAN,13221,82,12777,163,199,281,2022-01-27
317307,JAKARTA BARAT,PALMERAH,16272,92,15577,329,274,366,2022-01-27
317408,JAKARTA SELATAN,PANCORAN,14653,33,14171,227,222,255,2022-01-27
317404,JAKARTA SELATAN,PASAR MINGGU,24273,58,23481,427,307,365,2022-01-27
317505,JAKARTA TIMUR,PASAR REBO,17867,48,17347,326,146,194,2022-01-27
317201,JAKARTA UTARA,PENJARINGAN,19335,158,18524,230,423,581,2022-01-27
317410,JAKARTA SELATAN,PESANGGRAHAN,16747,49,16211,253,234,283,2022-01-27
111111,PROSES UPDATE DATA,PROSES UPDATE DATA,57203,341,54999,662,1201,1542,2022-01-27
317502,JAKARTA TIMUR,PULO GADUNG,22233,86,21461,402,284,370,2022-01-27
317102,JAKARTA PUSAT,SAWAH BESAR,9619,139,9067,173,240,379,2022-01-27
317104,JAKARTA PUSAT,SENEN,9624,68,9256,169,131,199,2022-01-27
317402,JAKARTA SELATAN,SETIA BUDI,12229,41,11857,183,148,189,2022-01-27
317303,JAKARTA BARAT,TAMAN SARI,9368,116,8853,140,259,375,2022-01-27
317304,JAKARTA BARAT,TAMBORA,14900,155,14033,254,458,613,2022-01-27
317107,JAKARTA PUSAT,TANAH ABANG,11369,60,10882,223,204,264,2022-01-27
317202,JAKARTA UTARA,TANJUNG PRIOK,26311,101,25467,425,318,419,2022-01-27
317401,JAKARTA SELATAN,TEBET,17388,69,16748,280,291,360,2022-01-27
317506,JAKARTA TIMUR,CAKUNG,23045,85,22330,414,216,301,2022-01-28
317105,JAKARTA PUSAT,CEMPAKA PUTIH,10788,60,10417,168,143,203,2022-01-28
317301,JAKARTA BARAT,CENGKARENG,29453,163,28275,563,452,615,2022-01-28
317406,JAKARTA SELATAN,CILANDAK,18288,111,17536,261,380,491,2022-01-28
317204,JAKARTA UTARA,CILINCING,17690,59,17135,341,155,214,2022-01-28
317510,JAKARTA TIMUR,CIPAYUNG,25575,65,25029,268,213,278,2022-01-28
317509,JAKARTA TIMUR,CIRACAS,22906,67,22237,379,223,290,2022-01-28
317507,JAKARTA TIMUR,DUREN SAWIT,30122,127,29001,611,383,510,2022-01-28
317101,JAKARTA PUSAT,GAMBIR,8954,53,8512,134,255,308,2022-01-28
317302,JAKARTA BARAT,GROGOL PETAMBURAN,19940,200,18931,298,511,711,2022-01-28
317409,JAKARTA SELATAN,JAGAKARSA,27138,53,26321,406,358,411,2022-01-28
317503,JAKARTA TIMUR,JATINEGARA,19963,54,19287,383,239,293,2022-01-28
317108,JAKARTA PUSAT,JOHAR BARU,8977,50,8573,158,196,246,2022-01-28
317306,JAKARTA BARAT,KALI DERES,18504,130,17813,317,244,374,2022-01-28
317407,JAKARTA SELATAN,KEBAYORAN BARU,14423,99,13806,185,333,432,2022-01-28
317405,JAKARTA SELATAN,KEBAYORAN LAMA,20741,114,19842,363,422,536,2022-01-28
317305,JAKARTA BARAT,KEBON JERUK,23047,230,21919,377,521,751,2022-01-28
317206,JAKARTA UTARA,KELAPA GADING,13145,86,12538,193,328,414,2022-01-28
317103,JAKARTA PUSAT,KEMAYORAN,20553,130,19720,375,328,458,2022-01-28
317308,JAKARTA BARAT,KEMBANGAN,20844,75,20105,303,361,436,2022-01-28
310102,KAB.ADM.KEP.SERIBU,KEP. SERIBU SELATAN,704,0,694,10,0,0,2022-01-28
310101,KAB.ADM.KEP.SERIBU,KEP. SERIBU UTARA,640,0,634,6,0,0,2022-01-28
317203,JAKARTA UTARA,KOJA,17558,86,16949,339,184,270,2022-01-28
317504,JAKARTA TIMUR,KRAMAT JATI,21997,68,21303,402,224,292,2022-01-28
111111,LUAR DKI JAKARTA,LUAR DKI JAKARTA,95258,309,93328,622,999,1308,2022-01-28
317508,JAKARTA TIMUR,MAKASAR,17821,99,17255,298,169,268,2022-01-28
317403,JAKARTA SELATAN,MAMPANG PRAPATAN,11886,37,11426,179,244,281,2022-01-28
317501,JAKARTA TIMUR,MATRAMAN,14529,72,13999,279,179,251,2022-01-28
317106,JAKARTA PUSAT,MENTENG,6650,39,6364,119,128,167,2022-01-28
317205,JAKARTA UTARA,PADEMANGAN,13290,100,12806,163,221,321,2022-01-28
317307,JAKARTA BARAT,PALMERAH,16365,113,15610,329,313,426,2022-01-28
317408,JAKARTA SELATAN,PANCORAN,14738,43,14190,227,278,321,2022-01-28
317404,JAKARTA SELATAN,PASAR MINGGU,24382,62,23517,427,376,438,2022-01-28
317505,JAKARTA TIMUR,PASAR REBO,17911,60,17363,326,162,222,2022-01-28
317201,JAKARTA UTARA,PENJARINGAN,19496,185,18573,230,508,693,2022-01-28
317410,JAKARTA SELATAN,PESANGGRAHAN,16842,56,16235,253,298,354,2022-01-28
111111,PROSES UPDATE DATA,PROSES UPDATE DATA,57508,331,55246,662,1269,1600,2022-01-28
317502,JAKARTA TIMUR,PULO GADUNG,22328,101,21476,402,349,450,2022-01-28
317102,JAKARTA PUSAT,SAWAH BESAR,9766,168,9098,173,327,495,2022-01-28
317104,JAKARTA PUSAT,SENEN,9680,84,9265,169,162,246,2022-01-28
317402,JAKARTA SELATAN,SETIA BUDI,12295,56,11866,183,190,246,2022-01-28
317303,JAKARTA BARAT,TAMAN SARI,9466,137,8883,140,306,443,2022-01-28
317304,JAKARTA BARAT,TAMBORA,15061,176,14096,254,535,711,2022-01-28
317107,JAKARTA PUSAT,TANAH ABANG,11479,102,10898,223,256,358,2022-01-28
317202,JAKARTA UTARA,TANJUNG PRIOK,26436,132,25497,425,382,514,2022-01-28
317401,JAKARTA SELATAN,TEBET,17524,82,16772,280,390,472,2022-01-28
317506,JAKARTA TIMUR,CAKUNG,23154,106,22347,414,287,393,2022-01-29
317105,JAKARTA PUSAT,CEMPAKA PUTIH,10863,78,10434,168,183,261,2022-01-29
317301,JAKARTA BARAT,CENGKARENG,29721,226,28317,563,615,841,2022-01-29
317406,JAKARTA SELATAN,CILANDAK,18407,133,17573,261,440,573,2022-01-29
317204,JAKARTA UTARA,CILINCING,17742,75,17151,341,175,250,2022-01-29
317510,JAKARTA TIMUR,CIPAYUNG,25668,75,25043,268,282,357,2022-01-29
317509,JAKARTA TIMUR,CIRACAS,23018,82,22255,379,302,384,2022-01-29
317507,JAKARTA TIMUR,DUREN SAWIT,30279,143,29034,614,488,631,2022-01-29
317101,JAKARTA PUSAT,GAMBIR,9001,66,8536,134,265,331,2022-01-29
317302,JAKARTA BARAT,GROGOL PETAMBURAN,20102,229,18972,298,603,832,2022-01-29
317409,JAKARTA SELATAN,JAGAKARSA,27272,69,26351,406,446,515,2022-01-29
317503,JAKARTA TIMUR,JATINEGARA,20048,69,19301,383,295,364,2022-01-29
317108,JAKARTA PUSAT,JOHAR BARU,9094,82,8584,158,270,352,2022-01-29
317306,JAKARTA BARAT,KALI DERES,18660,161,17839,317,343,504,2022-01-29
317407,JAKARTA SELATAN,KEBAYORAN BARU,14523,116,13824,185,398,514,2022-01-29
317405,JAKARTA SELATAN,KEBAYORAN LAMA,20874,124,19889,363,498,622,2022-01-29
317305,JAKARTA BARAT,KEBON JERUK,23266,273,21991,377,625,898,2022-01-29
317206,JAKARTA UTARA,KELAPA GADING,13292,101,12561,193,437,538,2022-01-29
317103,JAKARTA PUSAT,KEMAYORAN,20682,161,19749,376,396,557,2022-01-29
317308,JAKARTA BARAT,KEMBANGAN,21017,95,20144,303,475,570,2022-01-29
310102,KAB.ADM.KEP.SERIBU,KEP. SERIBU SELATAN,704,0,694,10,0,0,2022-01-29
310101,KAB.ADM.KEP.SERIBU,KEP. SERIBU UTARA,641,0,634,6,1,1,2022-01-29
317203,JAKARTA UTARA,KOJA,17615,102,16975,339,199,301,2022-01-29
317504,JAKARTA TIMUR,KRAMAT JATI,22092,79,21312,402,299,378,2022-01-29
111111,LUAR DKI JAKARTA,LUAR DKI JAKARTA,95268,228,93622,622,796,1024,2022-01-29
317508,JAKARTA TIMUR,MAKASAR,17919,128,17273,298,220,348,2022-01-29
317403,JAKARTA SELATAN,MAMPANG PRAPATAN,11996,55,11444,179,318,373,2022-01-29
317501,JAKARTA TIMUR,MATRAMAN,14606,88,14016,279,223,311,2022-01-29
317106,JAKARTA PUSAT,MENTENG,6736,63,6374,121,178,241,2022-01-29
317205,JAKARTA UTARA,PADEMANGAN,13385,121,12838,164,262,383,2022-01-29
317307,JAKARTA BARAT,PALMERAH,16509,139,15657,329,384,523,2022-01-29
317408,JAKARTA SELATAN,PANCORAN,14844,60,14213,227,344,404,2022-01-29
317404,JAKARTA SELATAN,PASAR MINGGU,24542,74,23543,427,498,572,2022-01-29
317505,JAKARTA TIMUR,PASAR REBO,17979,69,17376,326,208,277,2022-01-29
317201,JAKARTA UTARA,PENJARINGAN,19744,227,18622,231,664,891,2022-01-29
317410,JAKARTA SELATAN,PESANGGRAHAN,16944,70,16256,254,364,434,2022-01-29
111111,PROSES UPDATE DATA,PROSES UPDATE DATA,58042,350,55522,663,1507,1857,2022-01-29
317502,JAKARTA TIMUR,PULO GADUNG,22480,130,21519,402,429,559,2022-01-29
317102,JAKARTA PUSAT,SAWAH BESAR,9887,184,9138,173,392,576,2022-01-29
317104,JAKARTA PUSAT,SENEN,9754,99,9289,169,197,296,2022-01-29
317402,JAKARTA SELATAN,SETIA BUDI,12374,69,11892,183,230,299,2022-01-29
317303,JAKARTA BARAT,TAMAN SARI,9570,153,8925,140,352,505,2022-01-29
317304,JAKARTA BARAT,TAMBORA,15253,210,14148,254,641,851,2022-01-29
317107,JAKARTA PUSAT,TANAH ABANG,11606,119,10930,223,334,453,2022-01-29
317202,JAKARTA UTARA,TANJUNG PRIOK,26617,161,25536,425,495,656,2022-01-29
317401,JAKARTA SELATAN,TEBET,17681,103,16804,280,494,597,2022-01-29
317506,JAKARTA TIMUR,CAKUNG,23287,119,22381,414,373,492,2022-01-30
317105,JAKARTA PUSAT,CEMPAKA PUTIH,10932,91,10448,168,225,316,2022-01-30
317301,JAKARTA BARAT,CENGKARENG,29935,280,28350,563,742,1022,2022-01-30
317406,JAKARTA SELATAN,CILANDAK,18550,157,17617,261,515,672,2022-01-30
317204,JAKARTA UTARA,CILINCING,17839,89,17164,341,245,334,2022-01-30
317510,JAKARTA TIMUR,CIPAYUNG,25808,88,25074,268,378,466,2022-01-30
317509,JAKARTA TIMUR,CIRACAS,23173,87,22271,380,435,522,2022-01-30
317507,JAKARTA TIMUR,DUREN SAWIT,30539,177,29071,614,677,854,2022-01-30
317101,JAKARTA PUSAT,GAMBIR,9084,83,8569,134,298,381,2022-01-30
317302,JAKARTA BARAT,GROGOL PETAMBURAN,20327,260,19048,298,721,981,2022-01-30
317409,JAKARTA SELATAN,JAGAKARSA,27404,86,26377,406,535,621,2022-01-30
317503,JAKARTA TIMUR,JATINEGARA,20190,81,19335,383,391,472,2022-01-30
317108,JAKARTA PUSAT,JOHAR BARU,9194,99,8617,158,320,419,2022-01-30
317306,JAKARTA BARAT,KALI DERES,18777,191,17863,317,406,597,2022-01-30
317407,JAKARTA SELATAN,KEBAYORAN BARU,14595,123,13864,186,422,545,2022-01-30
317405,JAKARTA SELATAN,KEBAYORAN LAMA,21019,136,19928,363,592,728,2022-01-30
317305,JAKARTA BARAT,KEBON JERUK,23515,323,22058,378,756,1079,2022-01-30
317206,JAKARTA UTARA,KELAPA GADING,13440,116,12585,193,546,662,2022-01-30
317103,JAKARTA PUSAT,KEMAYORAN,20859,193,19793,376,497,690,2022-01-30
317308,JAKARTA BARAT,KEMBANGAN,21180,110,20173,304,593,703,2022-01-30
310102,KAB.ADM.KEP.SERIBU,KEP. SERIBU SELATAN,705,1,694,10,0,1,2022-01-30
310101,KAB.ADM.KEP.SERIBU,KEP. SERIBU UTARA,642,0,634,6,2,2,2022-01-30
317203,JAKARTA UTARA,KOJA,17749,125,16994,339,291,416,2022-01-30
317504,JAKARTA TIMUR,KRAMAT JATI,22265,90,21340,402,433,523,2022-01-30
111111,LUAR DKI JAKARTA,LUAR DKI JAKARTA,95288,140,93959,624,565,705,2022-01-30
317508,JAKARTA TIMUR,MAKASAR,18046,145,17282,299,320,465,2022-01-30
317403,JAKARTA SELATAN,MAMPANG PRAPATAN,12115,69,11460,179,407,476,2022-01-30
317501,JAKARTA TIMUR,MATRAMAN,14751,109,14047,279,316,425,2022-01-30
317106,JAKARTA PUSAT,MENTENG,6823,75,6397,121,230,305,2022-01-30
317205,JAKARTA UTARA,PADEMANGAN,13512,147,12866,164,335,482,2022-01-30
317307,JAKARTA BARAT,PALMERAH,16618,159,15682,329,448,607,2022-01-30
317408,JAKARTA SELATAN,PANCORAN,14984,74,14238,227,445,519,2022-01-30
317404,JAKARTA SELATAN,PASAR MINGGU,24698,86,23578,427,607,693,2022-01-30
317505,JAKARTA TIMUR,PASAR REBO,18054,76,17399,327,252,328,2022-01-30
317201,JAKARTA UTARA,PENJARINGAN,20042,291,18679,231,841,1132,2022-01-30
317410,JAKARTA SELATAN,PESANGGRAHAN,17113,85,16283,254,491,576,2022-01-30
111111,PROSES UPDATE DATA,PROSES UPDATE DATA,58525,369,55820,667,1669,2038,2022-01-30
317502,JAKARTA TIMUR,PULO GADUNG,22634,139,21571,402,522,661,2022-01-30
317102,JAKARTA PUSAT,SAWAH BESAR,10019,218,9178,173,450,668,2022-01-30
317104,JAKARTA PUSAT,SENEN,9843,109,9317,169,248,357,2022-01-30
317402,JAKARTA SELATAN,SETIA BUDI,12494,91,11903,183,317,408,2022-01-30
317303,JAKARTA BARAT,TAMAN SARI,9718,165,8977,140,436,601,2022-01-30
317304,JAKARTA BARAT,TAMBORA,15440,237,14216,254,733,970,2022-01-30
317107,JAKARTA PUSAT,TANAH ABANG,11735,142,10970,223,400,542,2022-01-30
317202,JAKARTA UTARA,TANJUNG PRIOK,26789,188,25570,425,606,794,2022-01-30
317401,JAKARTA SELATAN,TEBET,17844,129,16837,280,598,727,2022-01-30
317506,JAKARTA TIMUR,CAKUNG,23401,134,22399,414,454,588,2022-01-31
317105,JAKARTA PUSAT,CEMPAKA PUTIH,10986,98,10462,168,258,356,2022-01-31
317301,JAKARTA BARAT,CENGKARENG,30092,310,28394,561,827,1137,2022-01-31
317406,JAKARTA SELATAN,CILANDAK,18674,164,17641,261,608,772,2022-01-31
317204,JAKARTA UTARA,CILINCING,17899,97,17180,341,281,378,2022-01-31
317510,JAKARTA TIMUR,CIPAYUNG,25890,87,25098,268,437,524,2022-01-31
317509,JAKARTA TIMUR,CIRACAS,23300,89,22283,380,548,637,2022-01-31
317507,JAKARTA TIMUR,DUREN SAWIT,30736,176,29115,614,831,1007,2022-01-31
317101,JAKARTA PUSAT,GAMBIR,9180,102,8583,135,360,462,2022-01-31
317302,JAKARTA BARAT,GROGOL PETAMBURAN,20593,280,19129,298,886,1166,2022-01-31
317409,JAKARTA SELATAN,JAGAKARSA,27521,99,26401,406,615,714,2022-01-31
317503,JAKARTA TIMUR,JATINEGARA,20309,85,19351,383,490,575,2022-01-31
317108,JAKARTA PUSAT,JOHAR BARU,9248,104,8629,158,357,461,2022-01-31
317306,JAKARTA BARAT,KALI DERES,18887,214,17894,317,462,676,2022-01-31
317407,JAKARTA SELATAN,KEBAYORAN BARU,14686,123,13879,186,498,621,2022-01-31
317405,JAKARTA SELATAN,KEBAYORAN LAMA,21175,156,19958,363,698,854,2022-01-31
317305,JAKARTA BARAT,KEBON JERUK,23737,348,22109,379,901,1249,2022-01-31
317206,JAKARTA UTARA,KELAPA GADING,13600,124,12619,193,664,788,2022-01-31
317103,JAKARTA PUSAT,KEMAYORAN,20995,224,19813,376,582,806,2022-01-31
317308,JAKARTA BARAT,KEMBANGAN,21344,128,20216,304,696,824,2022-01-31
310102,KAB.ADM.KEP.SERIBU,KEP. SERIBU SELATAN,705,1,694,10,0,1,2022-01-31
310101,KAB.ADM.KEP.SERIBU,KEP. SERIBU UTARA,641,0,634,6,1,1,2022-01-31
317203,JAKARTA UTARA,KOJA,17851,143,17011,339,358,501,2022-01-31
317504,JAKARTA TIMUR,KRAMAT JATI,22397,92,21351,402,552,644,2022-01-31
111111,LUAR DKI JAKARTA,LUAR DKI JAKARTA,91258,35,90515,615,93,128,2022-01-31
317508,JAKARTA TIMUR,MAKASAR,18107,157,17293,300,357,514,2022-01-31
317403,JAKARTA SELATAN,MAMPANG PRAPATAN,12201,72,11478,179,472,544,2022-01-31
317501,JAKARTA TIMUR,MATRAMAN,14812,109,14058,279,366,475,2022-01-31
317106,JAKARTA PUSAT,MENTENG,6861,77,6409,121,254,331,2022-01-31
317205,JAKARTA UTARA,PADEMANGAN,13650,173,12894,164,419,592,2022-01-31
317307,JAKARTA BARAT,PALMERAH,16739,174,15693,331,541,715,2022-01-31
317408,JAKARTA SELATAN,PANCORAN,15079,84,14252,227,516,600,2022-01-31
317404,JAKARTA SELATAN,PASAR MINGGU,24850,96,23599,427,728,824,2022-01-31
317505,JAKARTA TIMUR,PASAR REBO,18098,79,17408,327,284,363,2022-01-31
317201,JAKARTA UTARA,PENJARINGAN,20342,329,18732,232,1049,1378,2022-01-31
317410,JAKARTA SELATAN,PESANGGRAHAN,17250,104,16304,254,588,692,2022-01-31
111111,PROSES UPDATE DATA,PROSES UPDATE DATA,62529,408,59242,698,2181,2589,2022-01-31
317502,JAKARTA TIMUR,PULO GADUNG,22771,155,21591,402,623,778,2022-01-31
317102,JAKARTA PUSAT,SAWAH BESAR,10136,222,9225,173,516,738,2022-01-31
317104,JAKARTA PUSAT,SENEN,9910,111,9331,169,299,410,2022-01-31
317402,JAKARTA SELATAN,SETIA BUDI,12566,93,11913,183,377,470,2022-01-31
317303,JAKARTA BARAT,TAMAN SARI,9831,171,9005,140,515,686,2022-01-31
317304,JAKARTA BARAT,TAMBORA,15658,243,14274,254,887,1130,2022-01-31
317107,JAKARTA PUSAT,TANAH ABANG,11867,158,10992,223,494,652,2022-01-31
317202,JAKARTA UTARA,TANJUNG PRIOK,27015,234,25599,425,757,991,2022-01-31
317401,JAKARTA SELATAN,TEBET,17978,147,16869,281,681,828,2022-01-31
317506,JAKARTA TIMUR,CAKUNG,23545,170,22415,414,546,716,2022-02-01
317105,JAKARTA PUSAT,CEMPAKA PUTIH,11060,116,10483,168,293,409,2022-02-01
317301,JAKARTA BARAT,CENGKARENG,30301,381,28443,561,916,1297,2022-02-01
317406,JAKARTA SELATAN,CILANDAK,18798,182,17681,261,674,856,2022-02-01
317204,JAKARTA UTARA,CILINCING,17972,110,17188,341,333,443,2022-02-01
317510,JAKARTA TIMUR,CIPAYUNG,25991,125,25107,268,491,616,2022-02-01
317509,JAKARTA TIMUR,CIRACAS,23400,123,22301,380,596,719,2022-02-01
317507,JAKARTA TIMUR,DUREN SAWIT,30949,198,29158,614,979,1177,2022-02-01
317101,JAKARTA PUSAT,GAMBIR,9223,110,8603,135,375,485,2022-02-01
317302,JAKARTA BARAT,GROGOL PETAMBURAN,20806,332,19183,298,993,1325,2022-02-01
317409,JAKARTA SELATAN,JAGAKARSA,27694,130,26425,407,732,862,2022-02-01
317503,JAKARTA TIMUR,JATINEGARA,20440,115,19372,383,570,685,2022-02-01
317108,JAKARTA PUSAT,JOHAR BARU,9302,116,8639,158,389,505,2022-02-01
317306,JAKARTA BARAT,KALI DERES,19027,248,17923,317,539,787,2022-02-01
317407,JAKARTA SELATAN,KEBAYORAN BARU,14845,144,13913,187,601,745,2022-02-01
317405,JAKARTA SELATAN,KEBAYORAN LAMA,21384,182,20011,363,828,1010,2022-02-01
317305,JAKARTA BARAT,KEBON JERUK,24042,416,22163,379,1084,1500,2022-02-01
317206,JAKARTA UTARA,KELAPA GADING,13748,138,12664,193,753,891,2022-02-01
317103,JAKARTA PUSAT,KEMAYORAN,21183,252,19842,376,713,965,2022-02-01
317308,JAKARTA BARAT,KEMBANGAN,21528,173,20248,304,803,976,2022-02-01
310102,KAB.ADM.KEP.SERIBU,KEP. SERIBU SELATAN,705,1,694,10,0,1,2022-02-01
310101,KAB.ADM.KEP.SERIBU,KEP. SERIBU UTARA,642,0,634,6,2,2,2022-02-01
317203,JAKARTA UTARA,KOJA,17944,159,17018,339,428,587,2022-02-01
317504,JAKARTA TIMUR,KRAMAT JATI,22531,130,21365,402,634,764,2022-02-01
111111,LUAR DKI JAKARTA,LUAR DKI JAKARTA,91273,32,90545,615,81,113,2022-02-01
317508,JAKARTA TIMUR,MAKASAR,18245,201,17302,300,442,643,2022-02-01
317403,JAKARTA SELATAN,MAMPANG PRAPATAN,12299,89,11495,179,536,625,2022-02-01
317501,JAKARTA TIMUR,MATRAMAN,14868,128,14073,279,388,516,2022-02-01
317106,JAKARTA PUSAT,MENTENG,6919,93,6418,121,287,380,2022-02-01
317205,JAKARTA UTARA,PADEMANGAN,13747,195,12926,164,462,657,2022-02-01
317307,JAKARTA BARAT,PALMERAH,16893,192,15713,331,657,849,2022-02-01
317408,JAKARTA SELATAN,PANCORAN,15194,94,14276,227,597,691,2022-02-01
317404,JAKARTA SELATAN,PASAR MINGGU,25061,117,23653,427,864,981,2022-02-01
317505,JAKARTA TIMUR,PASAR REBO,18221,104,17429,327,361,465,2022-02-01
317201,JAKARTA UTARA,PENJARINGAN,20581,376,18788,233,1184,1560,2022-02-01
317410,JAKARTA SELATAN,PESANGGRAHAN,17376,122,16337,254,663,785,2022-02-01
111111,PROSES UPDATE DATA,PROSES UPDATE DATA,63058,429,59679,703,2247,2676,2022-02-01
317502,JAKARTA TIMUR,PULO GADUNG,22947,205,21626,402,714,919,2022-02-01
317102,JAKARTA PUSAT,SAWAH BESAR,10237,242,9261,173,561,803,2022-02-01
317104,JAKARTA PUSAT,SENEN,9981,132,9345,170,334,466,2022-02-01
317402,JAKARTA SELATAN,SETIA BUDI,12656,112,11923,183,438,550,2022-02-01
317303,JAKARTA BARAT,TAMAN SARI,9924,194,9041,140,549,743,2022-02-01
317304,JAKARTA BARAT,TAMBORA,15879,269,14329,256,1025,1294,2022-02-01
317107,JAKARTA PUSAT,TANAH ABANG,11934,174,11014,224,522,696,2022-02-01
317202,JAKARTA UTARA,TANJUNG PRIOK,27216,293,25635,425,863,1156,2022-02-01
317401,JAKARTA SELATAN,TEBET,18174,174,16903,281,816,990,2022-02-01
317506,JAKARTA TIMUR,CAKUNG,23726,178,22488,414,646,824,2022-02-02
317105,JAKARTA PUSAT,CEMPAKA PUTIH,11198,128,10519,168,383,511,2022-02-02
317301,JAKARTA BARAT,CENGKARENG,30652,399,28579,562,1112,1511,2022-02-02
317406,JAKARTA SELATAN,CILANDAK,18980,201,17767,262,750,951,2022-02-02
317204,JAKARTA UTARA,CILINCING,18098,148,17251,341,358,506,2022-02-02
317510,JAKARTA TIMUR,CIPAYUNG,26167,147,25179,268,573,720,2022-02-02
317509,JAKARTA TIMUR,CIRACAS,23599,136,22372,380,711,847,2022-02-02
317507,JAKARTA TIMUR,DUREN SAWIT,31218,252,29257,615,1094,1346,2022-02-02
317101,JAKARTA PUSAT,GAMBIR,9359,111,8683,135,430,541,2022-02-02
317302,JAKARTA BARAT,GROGOL PETAMBURAN,21087,351,19302,298,1136,1487,2022-02-02
317409,JAKARTA SELATAN,JAGAKARSA,27904,141,26537,408,818,959,2022-02-02
317503,JAKARTA TIMUR,JATINEGARA,20661,130,19442,383,706,836,2022-02-02
317108,JAKARTA PUSAT,JOHAR BARU,9456,126,8718,158,454,580,2022-02-02
317306,JAKARTA BARAT,KALI DERES,19204,253,17994,317,640,893,2022-02-02
317407,JAKARTA SELATAN,KEBAYORAN BARU,14995,155,13980,188,672,827,2022-02-02
317405,JAKARTA SELATAN,KEBAYORAN LAMA,21634,204,20102,363,965,1169,2022-02-02
317305,JAKARTA BARAT,KEBON JERUK,24389,433,22307,380,1269,1702,2022-02-02
317206,JAKARTA UTARA,KELAPA GADING,13998,157,12728,193,920,1077,2022-02-02
317103,JAKARTA PUSAT,KEMAYORAN,21452,259,19992,376,825,1084,2022-02-02
317308,JAKARTA BARAT,KEMBANGAN,21796,181,20329,304,982,1163,2022-02-02
310102,KAB.ADM.KEP.SERIBU,KEP. SERIBU SELATAN,705,1,694,10,0,1,2022-02-02
310101,KAB.ADM.KEP.SERIBU,KEP. SERIBU UTARA,643,0,634,6,3,3,2022-02-02
317203,JAKARTA UTARA,KOJA,18099,176,17109,339,475,651,2022-02-02
317504,JAKARTA TIMUR,KRAMAT JATI,22704,148,21428,403,725,873,2022-02-02
111111,LUAR DKI JAKARTA,LUAR DKI JAKARTA,91315,23,90589,614,89,112,2022-02-02
317508,JAKARTA TIMUR,MAKASAR,18429,223,17359,300,547,770,2022-02-02
317403,JAKARTA SELATAN,MAMPANG PRAPATAN,12398,98,11584,179,537,635,2022-02-02
317501,JAKARTA TIMUR,MATRAMAN,15102,127,14136,279,560,687,2022-02-02
317106,JAKARTA PUSAT,MENTENG,6998,104,6462,121,311,415,2022-02-02
317205,JAKARTA UTARA,PADEMANGAN,13923,203,12997,164,559,762,2022-02-02
317307,JAKARTA BARAT,PALMERAH,17099,204,15816,333,746,950,2022-02-02
317408,JAKARTA SELATAN,PANCORAN,15327,102,14357,227,641,743,2022-02-02
317404,JAKARTA SELATAN,PASAR MINGGU,25298,128,23766,427,977,1105,2022-02-02
317505,JAKARTA TIMUR,PASAR REBO,18335,110,17490,327,408,518,2022-02-02
317201,JAKARTA UTARA,PENJARINGAN,20959,411,18943,232,1373,1784,2022-02-02
317410,JAKARTA SELATAN,PESANGGRAHAN,17520,119,16423,254,724,843,2022-02-02
111111,PROSES UPDATE DATA,PROSES UPDATE DATA,63689,421,59934,705,2629,3050,2022-02-02
317502,JAKARTA TIMUR,PULO GADUNG,23305,234,21723,402,946,1180,2022-02-02
317102,JAKARTA PUSAT,SAWAH BESAR,10372,237,9370,174,591,828,2022-02-02
317104,JAKARTA PUSAT,SENEN,10175,144,9395,169,467,611,2022-02-02
317402,JAKARTA SELATAN,SETIA BUDI,12740,107,11974,184,475,582,2022-02-02
317303,JAKARTA BARAT,TAMAN SARI,10058,202,9137,140,579,781,2022-02-02
317304,JAKARTA BARAT,TAMBORA,16122,261,14474,256,1131,1392,2022-02-02
317107,JAKARTA PUSAT,TANAH ABANG,12098,188,11086,224,600,788,2022-02-02
317202,JAKARTA UTARA,TANJUNG PRIOK,27526,344,25786,426,970,1314,2022-02-02
317401,JAKARTA SELATAN,TEBET,18363,185,17020,281,877,1062,2022-02-02
317506,JAKARTA TIMUR,CAKUNG,23956,200,22575,415,766,966,2022-02-03
317105,JAKARTA PUSAT,CEMPAKA PUTIH,11361,156,10561,168,476,632,2022-02-03
317301,JAKARTA BARAT,CENGKARENG,30897,442,28708,562,1185,1627,2022-02-03
317406,JAKARTA SELATAN,CILANDAK,19302,231,17884,262,925,1156,2022-02-03
317204,JAKARTA UTARA,CILINCING,18239,186,17306,341,406,592,2022-02-03
317510,JAKARTA TIMUR,CIPAYUNG,26310,167,25238,268,637,804,2022-02-03
317509,JAKARTA TIMUR,CIRACAS,23805,148,22450,380,827,975,2022-02-03
317507,JAKARTA TIMUR,DUREN SAWIT,31622,290,29389,616,1327,1617,2022-02-03
317101,JAKARTA PUSAT,GAMBIR,9490,119,8766,135,470,589,2022-02-03
317302,JAKARTA BARAT,GROGOL PETAMBURAN,21392,375,19468,298,1251,1626,2022-02-03
317409,JAKARTA SELATAN,JAGAKARSA,28183,166,26650,408,959,1125,2022-02-03
317503,JAKARTA TIMUR,JATINEGARA,20924,157,19520,384,863,1020,2022-02-03
317108,JAKARTA PUSAT,JOHAR BARU,9577,139,8782,158,498,637,2022-02-03
317306,JAKARTA BARAT,KALI DERES,19417,290,18079,317,731,1021,2022-02-03
317407,JAKARTA SELATAN,KEBAYORAN BARU,15237,159,14046,188,844,1003,2022-02-03
317405,JAKARTA SELATAN,KEBAYORAN LAMA,21958,231,20216,363,1148,1379,2022-02-03
317305,JAKARTA BARAT,KEBON JERUK,24745,473,22481,380,1411,1884,2022-02-03
317206,JAKARTA UTARA,KELAPA GADING,14195,182,12813,193,1007,1189,2022-02-03
317103,JAKARTA PUSAT,KEMAYORAN,21675,278,20132,376,889,1167,2022-02-03
317308,JAKARTA BARAT,KEMBANGAN,22067,208,20441,304,1114,1322,2022-02-03
310102,KAB.ADM.KEP.SERIBU,KEP. SERIBU SELATAN,705,1,694,10,0,1,2022-02-03
310101,KAB.ADM.KEP.SERIBU,KEP. SERIBU UTARA,643,0,634,6,3,3,2022-02-03
317203,JAKARTA UTARA,KOJA,18265,226,17173,339,527,753,2022-02-03
317504,JAKARTA TIMUR,KRAMAT JATI,23002,165,21518,403,916,1081,2022-02-03
111111,LUAR DKI JAKARTA,LUAR DKI JAKARTA,91321,19,90616,614,72,91,2022-02-03
317508,JAKARTA TIMUR,MAKASAR,18625,272,17437,300,616,888,2022-02-03
317403,JAKARTA SELATAN,MAMPANG PRAPATAN,12662,103,11678,179,702,805,2022-02-03
317501,JAKARTA TIMUR,MATRAMAN,15299,133,14213,279,674,807,2022-02-03
317106,JAKARTA PUSAT,MENTENG,7104,111,6505,122,366,477,2022-02-03
317205,JAKARTA UTARA,PADEMANGAN,14058,230,13076,164,588,818,2022-02-03
317307,JAKARTA BARAT,PALMERAH,17306,198,15921,334,853,1051,2022-02-03
317408,JAKARTA SELATAN,PANCORAN,15574,130,14428,227,789,919,2022-02-03
317404,JAKARTA SELATAN,PASAR MINGGU,25605,171,23862,427,1145,1316,2022-02-03
317505,JAKARTA TIMUR,PASAR REBO,18485,123,17546,327,489,612,2022-02-03
317201,JAKARTA UTARA,PENJARINGAN,21268,431,19097,232,1508,1939,2022-02-03
317410,JAKARTA SELATAN,PESANGGRAHAN,17695,130,16548,254,763,893,2022-02-03
111111,PROSES UPDATE DATA,PROSES UPDATE DATA,64497,485,60204,722,3086,3571,2022-02-03
317502,JAKARTA TIMUR,PULO GADUNG,23659,278,21824,402,1155,1433,2022-02-03
317102,JAKARTA PUSAT,SAWAH BESAR,10582,276,9466,174,666,942,2022-02-03
317104,JAKARTA PUSAT,SENEN,10290,159,9451,169,511,670,2022-02-03
317402,JAKARTA SELATAN,SETIA BUDI,12915,128,12031,184,572,700,2022-02-03
317303,JAKARTA BARAT,TAMAN SARI,10221,217,9260,140,604,821,2022-02-03
317304,JAKARTA BARAT,TAMBORA,16384,269,14654,256,1205,1474,2022-02-03
317107,JAKARTA PUSAT,TANAH ABANG,12255,179,11180,224,672,851,2022-02-03
317202,JAKARTA UTARA,TANJUNG PRIOK,27783,419,25918,426,1020,1439,2022-02-03
317401,JAKARTA SELATAN,TEBET,18637,202,17140,283,1012,1214,2022-02-03
317506,JAKARTA TIMUR,CAKUNG,24226,255,22676,415,880,1135,2022-02-04
317105,JAKARTA PUSAT,CEMPAKA PUTIH,11565,170,10617,169,609,779,2022-02-04
317301,JAKARTA BARAT,CENGKARENG,31354,504,28951,562,1337,1841,2022-02-04
317406,JAKARTA SELATAN,CILANDAK,19588,247,18037,263,1041,1288,2022-02-04
317204,JAKARTA UTARA,CILINCING,18513,257,17372,342,542,799,2022-02-04
317510,JAKARTA TIMUR,CIPAYUNG,26517,217,25324,268,708,925,2022-02-04
317509,JAKARTA TIMUR,CIRACAS,23987,180,22574,381,852,1032,2022-02-04
317507,JAKARTA TIMUR,DUREN SAWIT,32089,367,29550,616,1556,1923,2022-02-04
317101,JAKARTA PUSAT,GAMBIR,9721,140,8830,135,616,756,2022-02-04
317302,JAKARTA BARAT,GROGOL PETAMBURAN,21769,451,19678,298,1342,1793,2022-02-04
317409,JAKARTA SELATAN,JAGAKARSA,28446,207,26784,408,1047,1254,2022-02-04
317503,JAKARTA TIMUR,JATINEGARA,21245,213,19622,385,1025,1238,2022-02-04
317108,JAKARTA PUSAT,JOHAR BARU,9795,157,8879,158,601,758,2022-02-04
317306,JAKARTA BARAT,KALI DERES,19815,345,18199,317,954,1299,2022-02-04
317407,JAKARTA SELATAN,KEBAYORAN BARU,15449,194,14163,189,903,1097,2022-02-04
317405,JAKARTA SELATAN,KEBAYORAN LAMA,22313,267,20378,363,1305,1572,2022-02-04
317305,JAKARTA BARAT,KEBON JERUK,25310,515,22751,381,1663,2178,2022-02-04
317206,JAKARTA UTARA,KELAPA GADING,14495,215,12954,193,1133,1348,2022-02-04
317103,JAKARTA PUSAT,KEMAYORAN,22061,326,20293,378,1064,1390,2022-02-04
317308,JAKARTA BARAT,KEMBANGAN,22552,269,20575,304,1404,1673,2022-02-04
310102,KAB.ADM.KEP.SERIBU,KEP. SERIBU SELATAN,705,1,694,10,0,1,2022-02-04
310101,KAB.ADM.KEP.SERIBU,KEP. SERIBU UTARA,648,2,634,6,6,8,2022-02-04
317203,JAKARTA UTARA,KOJA,18503,290,17289,341,583,873,2022-02-04
317504,JAKARTA TIMUR,KRAMAT JATI,23310,193,21643,403,1071,1264,2022-02-04
111111,LUAR DKI JAKARTA,LUAR DKI JAKARTA,91370,17,90650,614,89,106,2022-02-04
317508,JAKARTA TIMUR,MAKASAR,18957,348,17545,300,764,1112,2022-02-04
317403,JAKARTA SELATAN,MAMPANG PRAPATAN,12790,122,11792,179,697,819,2022-02-04
317501,JAKARTA TIMUR,MATRAMAN,15575,181,14286,279,829,1010,2022-02-04
317106,JAKARTA PUSAT,MENTENG,7258,134,6551,122,451,585,2022-02-04
317205,JAKARTA UTARA,PADEMANGAN,14284,269,13219,165,631,900,2022-02-04
317307,JAKARTA BARAT,PALMERAH,17617,244,16039,334,1000,1244,2022-02-04
317408,JAKARTA SELATAN,PANCORAN,15809,163,14547,227,872,1035,2022-02-04
317404,JAKARTA SELATAN,PASAR MINGGU,25952,208,23992,427,1325,1533,2022-02-04
317505,JAKARTA TIMUR,PASAR REBO,18701,168,17606,327,600,768,2022-02-04
317201,JAKARTA UTARA,PENJARINGAN,21679,492,19312,234,1641,2133,2022-02-04
317410,JAKARTA SELATAN,PESANGGRAHAN,17946,157,16664,254,871,1028,2022-02-04
111111,PROSES UPDATE DATA,PROSES UPDATE DATA,65182,584,60641,728,3229,3813,2022-02-04
317502,JAKARTA TIMUR,PULO GADUNG,24063,360,21947,403,1353,1713,2022-02-04
317102,JAKARTA PUSAT,SAWAH BESAR,10791,281,9590,175,745,1026,2022-02-04
317104,JAKARTA PUSAT,SENEN,10519,191,9528,169,631,822,2022-02-04
317402,JAKARTA SELATAN,SETIA BUDI,13075,156,12097,184,638,794,2022-02-04
317303,JAKARTA BARAT,TAMAN SARI,10415,247,9375,140,653,900,2022-02-04
317304,JAKARTA BARAT,TAMBORA,16732,314,14861,257,1300,1614,2022-02-04
317107,JAKARTA PUSAT,TANAH ABANG,12561,188,11293,224,856,1044,2022-02-04
317202,JAKARTA UTARA,TANJUNG PRIOK,28230,495,26094,426,1215,1710,2022-02-04
317401,JAKARTA SELATAN,TEBET,18889,233,17281,285,1090,1323,2022-02-04
317506,JAKARTA TIMUR,CAKUNG,24656,298,22831,415,1112,1410,2022-02-05
317105,JAKARTA PUSAT,CEMPAKA PUTIH,11731,246,10711,170,604,850,2022-02-05
317301,JAKARTA BARAT,CENGKARENG,31796,572,29295,562,1367,1939,2022-02-05
317406,JAKARTA SELATAN,CILANDAK,19857,283,18192,263,1119,1402,2022-02-05
317204,JAKARTA UTARA,CILINCING,18863,296,17464,342,761,1057,2022-02-05
317510,JAKARTA TIMUR,CIPAYUNG,26738,243,25457,268,770,1013,2022-02-05
317509,JAKARTA TIMUR,CIRACAS,24255,196,22701,382,976,1172,2022-02-05
317507,JAKARTA TIMUR,DUREN SAWIT,32533,424,29785,616,1708,2132,2022-02-05
317101,JAKARTA PUSAT,GAMBIR,9868,162,8953,135,618,780,2022-02-05
317302,JAKARTA BARAT,GROGOL PETAMBURAN,22184,504,20026,300,1354,1858,2022-02-05
317409,JAKARTA SELATAN,JAGAKARSA,28860,237,26972,409,1242,1479,2022-02-05
317503,JAKARTA TIMUR,JATINEGARA,21518,273,19766,385,1094,1367,2022-02-05
317108,JAKARTA PUSAT,JOHAR BARU,10006,179,8998,158,671,850,2022-02-05
317306,JAKARTA BARAT,KALI DERES,20050,392,18443,318,897,1289,2022-02-05
317407,JAKARTA SELATAN,KEBAYORAN BARU,15742,207,14336,189,1010,1217,2022-02-05
317405,JAKARTA SELATAN,KEBAYORAN LAMA,22723,297,20587,363,1476,1773,2022-02-05
317305,JAKARTA BARAT,KEBON JERUK,25812,589,23103,381,1739,2328,2022-02-05
317206,JAKARTA UTARA,KELAPA GADING,14805,229,13165,194,1217,1446,2022-02-05
317103,JAKARTA PUSAT,KEMAYORAN,22367,372,20479,379,1137,1509,2022-02-05
317308,JAKARTA BARAT,KEMBANGAN,22857,313,20863,304,1377,1690,2022-02-05
310102,KAB.ADM.KEP.SERIBU,KEP. SERIBU SELATAN,705,1,694,10,0,1,2022-02-05
310101,KAB.ADM.KEP.SERIBU,KEP. SERIBU UTARA,652,2,634,6,10,12,2022-02-05
317203,JAKARTA UTARA,KOJA,18900,334,17419,341,806,1140,2022-02-05
317504,JAKARTA TIMUR,KRAMAT JATI,23604,219,21768,403,1214,1433,2022-02-05
111111,LUAR DKI JAKARTA,LUAR DKI JAKARTA,91391,17,90671,614,89,106,2022-02-05
317508,JAKARTA TIMUR,MAKASAR,19179,379,17647,302,851,1230,2022-02-05
317403,JAKARTA SELATAN,MAMPANG PRAPATAN,13049,132,11941,179,797,929,2022-02-05
317501,JAKARTA TIMUR,MATRAMAN,15867,218,14392,279,978,1196,2022-02-05
317106,JAKARTA PUSAT,MENTENG,7432,209,6638,122,463,672,2022-02-05
317205,JAKARTA UTARA,PADEMANGAN,14448,302,13381,165,600,902,2022-02-05
317307,JAKARTA BARAT,PALMERAH,17917,290,16239,335,1053,1343,2022-02-05
317408,JAKARTA SELATAN,PANCORAN,16077,179,14711,228,959,1138,2022-02-05
317404,JAKARTA SELATAN,PASAR MINGGU,26376,239,24197,427,1513,1752,2022-02-05
317505,JAKARTA TIMUR,PASAR REBO,18941,196,17694,327,724,920,2022-02-05
317201,JAKARTA UTARA,PENJARINGAN,22061,573,19659,234,1595,2168,2022-02-05
317410,JAKARTA SELATAN,PESANGGRAHAN,18180,186,16802,254,938,1124,2022-02-05
111111,PROSES UPDATE DATA,PROSES UPDATE DATA,65596,589,61184,742,3081,3670,2022-02-05
317502,JAKARTA TIMUR,PULO GADUNG,24397,399,22128,404,1466,1865,2022-02-05
317102,JAKARTA PUSAT,SAWAH BESAR,11001,348,9765,175,713,1061,2022-02-05
317104,JAKARTA PUSAT,SENEN,10675,218,9625,169,663,881,2022-02-05
317402,JAKARTA SELATAN,SETIA BUDI,13241,184,12206,184,667,851,2022-02-05
317303,JAKARTA BARAT,TAMAN SARI,10539,262,9558,140,579,841,2022-02-05
317304,JAKARTA BARAT,TAMBORA,16988,357,15165,258,1208,1565,2022-02-05
317107,JAKARTA PUSAT,TANAH ABANG,12768,211,11477,225,855,1066,2022-02-05
317202,JAKARTA UTARA,TANJUNG PRIOK,28720,565,26397,426,1332,1897,2022-02-05
317401,JAKARTA SELATAN,TEBET,19220,277,17452,285,1206,1483,2022-02-05
317506,JAKARTA TIMUR,CAKUNG,25025,339,22952,415,1319,1658,2022-02-06
317105,JAKARTA PUSAT,CEMPAKA PUTIH,11933,258,10782,170,723,981,2022-02-06
317301,JAKARTA BARAT,CENGKARENG,32434,664,29575,562,1633,2297,2022-02-06
317406,JAKARTA SELATAN,CILANDAK,20235,341,18353,263,1278,1619,2022-02-06
317204,JAKARTA UTARA,CILINCING,19094,357,17566,343,828,1185,2022-02-06
317510,JAKARTA TIMUR,CIPAYUNG,27118,254,25599,269,996,1250,2022-02-06
317509,JAKARTA TIMUR,CIRACAS,24526,207,22881,382,1056,1263,2022-02-06
317507,JAKARTA TIMUR,DUREN SAWIT,33078,485,30061,616,1916,2401,2022-02-06
317101,JAKARTA PUSAT,GAMBIR,10037,169,9057,136,675,844,2022-02-06
317302,JAKARTA BARAT,GROGOL PETAMBURAN,22818,622,20356,301,1539,2161,2022-02-06
317409,JAKARTA SELATAN,JAGAKARSA,29341,254,27157,409,1521,1775,2022-02-06
317503,JAKARTA TIMUR,JATINEGARA,21948,311,19934,385,1318,1629,2022-02-06
317108,JAKARTA PUSAT,JOHAR BARU,10284,186,9103,158,837,1023,2022-02-06
317306,JAKARTA BARAT,KALI DERES,20360,439,18631,318,972,1411,2022-02-06
317407,JAKARTA SELATAN,KEBAYORAN BARU,16093,240,14493,189,1171,1411,2022-02-06
317405,JAKARTA SELATAN,KEBAYORAN LAMA,23187,342,20805,363,1677,2019,2022-02-06
317305,JAKARTA BARAT,KEBON JERUK,26373,651,23435,381,1906,2557,2022-02-06
317206,JAKARTA UTARA,KELAPA GADING,15124,273,13360,194,1297,1570,2022-02-06
317103,JAKARTA PUSAT,KEMAYORAN,22754,404,20731,379,1240,1644,2022-02-06
317308,JAKARTA BARAT,KEMBANGAN,23321,362,21102,306,1551,1913,2022-02-06
310102,KAB.ADM.KEP.SERIBU,KEP. SERIBU SELATAN,705,0,695,10,0,0,2022-02-06
310101,KAB.ADM.KEP.SERIBU,KEP. SERIBU UTARA,648,1,635,6,6,7,2022-02-06
317203,JAKARTA UTARA,KOJA,19132,362,17533,341,896,1258,2022-02-06
317504,JAKARTA TIMUR,KRAMAT JATI,23967,246,21925,404,1392,1638,2022-02-06
111111,LUAR DKI JAKARTA,LUAR DKI JAKARTA,91429,15,90730,614,70,85,2022-02-06
317508,JAKARTA TIMUR,MAKASAR,19387,402,17781,302,902,1304,2022-02-06
317403,JAKARTA SELATAN,MAMPANG PRAPATAN,13460,145,12120,179,1016,1161,2022-02-06
317501,JAKARTA TIMUR,MATRAMAN,16168,240,14543,279,1106,1346,2022-02-06
317106,JAKARTA PUSAT,MENTENG,7616,226,6734,123,533,759,2022-02-06
317205,JAKARTA UTARA,PADEMANGAN,14659,343,13535,165,616,959,2022-02-06
317307,JAKARTA BARAT,PALMERAH,18282,300,16467,336,1179,1479,2022-02-06
317408,JAKARTA SELATAN,PANCORAN,16544,203,14904,229,1208,1411,2022-02-06
317404,JAKARTA SELATAN,PASAR MINGGU,26951,269,24479,428,1775,2044,2022-02-06
317505,JAKARTA TIMUR,PASAR REBO,19178,205,17799,328,846,1051,2022-02-06
317201,JAKARTA UTARA,PENJARINGAN,22582,623,19977,234,1748,2371,2022-02-06
317410,JAKARTA SELATAN,PESANGGRAHAN,18668,195,16989,254,1230,1425,2022-02-06
111111,PROSES UPDATE DATA,PROSES UPDATE DATA,65839,549,61584,755,2951,3500,2022-02-06
317502,JAKARTA TIMUR,PULO GADUNG,24871,438,22355,405,1673,2111,2022-02-06
317102,JAKARTA PUSAT,SAWAH BESAR,11197,376,9944,175,702,1078,2022-02-06
317104,JAKARTA PUSAT,SENEN,10855,243,9742,169,701,944,2022-02-06
317402,JAKARTA SELATAN,SETIA BUDI,13628,204,12386,184,854,1058,2022-02-06
317303,JAKARTA BARAT,TAMAN SARI,10880,292,9750,140,698,990,2022-02-06
317304,JAKARTA BARAT,TAMBORA,17354,378,15427,258,1291,1669,2022-02-06
317107,JAKARTA PUSAT,TANAH ABANG,12999,227,11684,225,863,1090,2022-02-06
317202,JAKARTA UTARA,TANJUNG PRIOK,29244,669,26652,426,1497,2166,2022-02-06
317401,JAKARTA SELATAN,TEBET,19644,316,17654,286,1388,1704,2022-02-06
317506,JAKARTA TIMUR,CAKUNG,25397,372,23061,415,1549,1921,2022-02-07
317105,JAKARTA PUSAT,CEMPAKA PUTIH,12059,269,10844,171,775,1044,2022-02-07
317301,JAKARTA BARAT,CENGKARENG,32976,725,29746,563,1942,2667,2022-02-07
317406,JAKARTA SELATAN,CILANDAK,20561,357,18468,264,1472,1829,2022-02-07
317204,JAKARTA UTARA,CILINCING,19361,382,17630,344,1005,1387,2022-02-07
317510,JAKARTA TIMUR,CIPAYUNG,27367,264,25663,269,1171,1435,2022-02-07
317509,JAKARTA TIMUR,CIRACAS,24801,227,22939,382,1253,1480,2022-02-07
317507,JAKARTA TIMUR,DUREN SAWIT,33536,529,30252,618,2137,2666,2022-02-07
317101,JAKARTA PUSAT,GAMBIR,10196,162,9122,136,776,938,2022-02-07
317302,JAKARTA BARAT,GROGOL PETAMBURAN,23279,636,20596,301,1746,2382,2022-02-07
317409,JAKARTA SELATAN,JAGAKARSA,29702,251,27268,412,1771,2022,2022-02-07
317503,JAKARTA TIMUR,JATINEGARA,22271,366,20017,387,1501,1867,2022-02-07
317108,JAKARTA PUSAT,JOHAR BARU,10400,206,9167,158,869,1075,2022-02-07
317306,JAKARTA BARAT,KALI DERES,20831,507,18737,318,1269,1776,2022-02-07
317407,JAKARTA SELATAN,KEBAYORAN BARU,16315,256,14583,189,1287,1543,2022-02-07
317405,JAKARTA SELATAN,KEBAYORAN LAMA,23507,368,20969,364,1806,2174,2022-02-07
317305,JAKARTA BARAT,KEBON JERUK,26791,651,23705,382,2053,2704,2022-02-07
317206,JAKARTA UTARA,KELAPA GADING,15476,311,13539,194,1432,1743,2022-02-07
317103,JAKARTA PUSAT,KEMAYORAN,23010,444,20855,379,1332,1776,2022-02-07
317308,JAKARTA BARAT,KEMBANGAN,23644,386,21261,307,1690,2076,2022-02-07
310102,KAB.ADM.KEP.SERIBU,KEP. SERIBU SELATAN,709,0,695,10,4,4,2022-02-07
310101,KAB.ADM.KEP.SERIBU,KEP. SERIBU UTARA,648,1,635,6,6,7,2022-02-07
317203,JAKARTA UTARA,KOJA,19472,378,17625,342,1127,1505,2022-02-07
317504,JAKARTA TIMUR,KRAMAT JATI,24222,263,22009,405,1545,1808,2022-02-07
111111,LUAR DKI JAKARTA,LUAR DKI JAKARTA,91448,11,90766,614,57,68,2022-02-07
317508,JAKARTA TIMUR,MAKASAR,19553,422,17854,302,975,1397,2022-02-07
317403,JAKARTA SELATAN,MAMPANG PRAPATAN,13698,143,12181,179,1195,1338,2022-02-07
317501,JAKARTA TIMUR,MATRAMAN,16481,262,14607,279,1333,1595,2022-02-07
317106,JAKARTA PUSAT,MENTENG,7716,236,6784,124,572,808,2022-02-07
317205,JAKARTA UTARA,PADEMANGAN,14881,347,13630,165,739,1086,2022-02-07
317307,JAKARTA BARAT,PALMERAH,18484,305,16575,336,1268,1573,2022-02-07
317408,JAKARTA SELATAN,PANCORAN,16804,218,14970,230,1386,1604,2022-02-07
317404,JAKARTA SELATAN,PASAR MINGGU,27315,293,24590,428,2004,2297,2022-02-07
317505,JAKARTA TIMUR,PASAR REBO,19318,218,17851,328,921,1139,2022-02-07
317201,JAKARTA UTARA,PENJARINGAN,23036,658,20261,235,1882,2540,2022-02-07
317410,JAKARTA SELATAN,PESANGGRAHAN,18859,197,17122,254,1286,1483,2022-02-07
111111,PROSES UPDATE DATA,PROSES UPDATE DATA,66495,545,62041,768,3141,3686,2022-02-07
317502,JAKARTA TIMUR,PULO GADUNG,25280,491,22480,408,1901,2392,2022-02-07
317102,JAKARTA PUSAT,SAWAH BESAR,11336,371,10034,175,756,1127,2022-02-07
317104,JAKARTA PUSAT,SENEN,10978,267,9802,170,739,1006,2022-02-07
317402,JAKARTA SELATAN,SETIA BUDI,13865,235,12466,184,980,1215,2022-02-07
317303,JAKARTA BARAT,TAMAN SARI,11017,309,9837,140,731,1040,2022-02-07
317304,JAKARTA BARAT,TAMBORA,17675,394,15622,259,1400,1794,2022-02-07
317107,JAKARTA PUSAT,TANAH ABANG,13188,236,11797,225,930,1166,2022-02-07
317202,JAKARTA UTARA,TANJUNG PRIOK,29781,724,26838,427,1792,2516,2022-02-07
317401,JAKARTA SELATAN,TEBET,19913,319,17791,286,1517,1836,2022-02-07
317506,JAKARTA TIMUR,CAKUNG,25646,405,23153,416,1672,2077,2022-02-08
317105,JAKARTA PUSAT,CEMPAKA PUTIH,12178,299,10903,172,804,1103,2022-02-08
317301,JAKARTA BARAT,CENGKARENG,33410,789,29948,563,2110,2899,2022-02-08
317406,JAKARTA SELATAN,CILANDAK,20862,421,18601,265,1575,1996,2022-02-08
317204,JAKARTA UTARA,CILINCING,19621,449,17692,344,1136,1585,2022-02-08
317510,JAKARTA TIMUR,CIPAYUNG,27542,314,25723,270,1235,1549,2022-02-08
317509,JAKARTA TIMUR,CIRACAS,24991,261,23016,383,1331,1592,2022-02-08
317507,JAKARTA TIMUR,DUREN SAWIT,34038,605,30386,619,2428,3033,2022-02-08
317101,JAKARTA PUSAT,GAMBIR,10288,187,9179,136,786,973,2022-02-08
317302,JAKARTA BARAT,GROGOL PETAMBURAN,23587,713,20782,302,1790,2503,2022-02-08
317409,JAKARTA SELATAN,JAGAKARSA,30020,286,27388,412,1934,2220,2022-02-08
317503,JAKARTA TIMUR,JATINEGARA,22658,403,20115,389,1751,2154,2022-02-08
317108,JAKARTA PUSAT,JOHAR BARU,10489,232,9207,159,891,1123,2022-02-08
317306,JAKARTA BARAT,KALI DERES,21132,581,18846,318,1387,1968,2022-02-08
317407,JAKARTA SELATAN,KEBAYORAN BARU,16464,264,14684,189,1327,1591,2022-02-08
317405,JAKARTA SELATAN,KEBAYORAN LAMA,23894,419,21150,365,1960,2379,2022-02-08
317305,JAKARTA BARAT,KEBON JERUK,27116,705,23915,384,2112,2817,2022-02-08
317206,JAKARTA UTARA,KELAPA GADING,15728,341,13679,194,1514,1855,2022-02-08
317103,JAKARTA PUSAT,KEMAYORAN,23171,462,20977,380,1352,1814,2022-02-08
317308,JAKARTA BARAT,KEMBANGAN,23951,420,21431,308,1792,2212,2022-02-08
310102,KAB.ADM.KEP.SERIBU,KEP. SERIBU SELATAN,707,1,695,10,1,2,2022-02-08
310101,KAB.ADM.KEP.SERIBU,KEP. SERIBU UTARA,652,2,636,6,8,10,2022-02-08
317203,JAKARTA UTARA,KOJA,19699,414,17692,342,1251,1665,2022-02-08
317504,JAKARTA TIMUR,KRAMAT JATI,24531,316,22115,406,1694,2010,2022-02-08
111111,LUAR DKI JAKARTA,LUAR DKI JAKARTA,91493,13,90795,614,71,84,2022-02-08
317508,JAKARTA TIMUR,MAKASAR,19865,501,17925,302,1137,1638,2022-02-08
317403,JAKARTA SELATAN,MAMPANG PRAPATAN,13828,146,12256,179,1247,1393,2022-02-08
317501,JAKARTA TIMUR,MATRAMAN,16628,291,14655,280,1402,1693,2022-02-08
317106,JAKARTA PUSAT,MENTENG,7819,251,6828,124,616,867,2022-02-08
317205,JAKARTA UTARA,PADEMANGAN,15073,373,13711,168,821,1194,2022-02-08
317307,JAKARTA BARAT,PALMERAH,18664,346,16668,336,1314,1660,2022-02-08
317408,JAKARTA SELATAN,PANCORAN,17061,229,15062,230,1540,1769,2022-02-08
317404,JAKARTA SELATAN,PASAR MINGGU,27694,335,24769,429,2161,2496,2022-02-08
317505,JAKARTA TIMUR,PASAR REBO,19483,250,17910,329,994,1244,2022-02-08
317201,JAKARTA UTARA,PENJARINGAN,23380,705,20516,236,1923,2628,2022-02-08
317410,JAKARTA SELATAN,PESANGGRAHAN,19087,207,17212,255,1413,1620,2022-02-08
111111,PROSES UPDATE DATA,PROSES UPDATE DATA,66857,547,62478,780,3052,3599,2022-02-08
317502,JAKARTA TIMUR,PULO GADUNG,25732,554,22643,409,2126,2680,2022-02-08
317102,JAKARTA PUSAT,SAWAH BESAR,11522,451,10115,177,779,1230,2022-02-08
317104,JAKARTA PUSAT,SENEN,11090,286,9863,170,771,1057,2022-02-08
317402,JAKARTA SELATAN,SETIA BUDI,14068,277,12543,184,1064,1341,2022-02-08
317303,JAKARTA BARAT,TAMAN SARI,11158,328,9920,140,770,1098,2022-02-08
317304,JAKARTA BARAT,TAMBORA,17854,430,15829,259,1336,1766,2022-02-08
317107,JAKARTA PUSAT,TANAH ABANG,13345,266,11879,226,974,1240,2022-02-08
317202,JAKARTA UTARA,TANJUNG PRIOK,30119,781,27009,427,1902,2683,2022-02-08
317401,JAKARTA SELATAN,TEBET,20274,365,17936,286,1687,2052,2022-02-08
317506,JAKARTA TIMUR,CAKUNG,26189,456,23461,416,1856,2312,2022-02-09
317105,JAKARTA PUSAT,CEMPAKA PUTIH,12378,304,11070,172,832,1136,2022-02-09
317301,JAKARTA BARAT,CENGKARENG,33983,858,30416,563,2146,3004,2022-02-09
317406,JAKARTA SELATAN,CILANDAK,21221,484,18833,265,1639,2123,2022-02-09
317204,JAKARTA UTARA,CILINCING,19772,462,17940,344,1026,1488,2022-02-09
317510,JAKARTA TIMUR,CIPAYUNG,27920,315,25960,271,1374,1689,2022-02-09
317509,JAKARTA TIMUR,CIRACAS,25368,272,23325,383,1388,1660,2022-02-09
317507,JAKARTA TIMUR,DUREN SAWIT,34615,656,30827,619,2513,3169,2022-02-09
317101,JAKARTA PUSAT,GAMBIR,10509,211,9382,136,780,991,2022-02-09
317302,JAKARTA BARAT,GROGOL PETAMBURAN,23971,751,21155,302,1763,2514,2022-02-09
317409,JAKARTA SELATAN,JAGAKARSA,30335,304,27754,413,1864,2168,2022-02-09
317503,JAKARTA TIMUR,JATINEGARA,23139,464,20426,389,1860,2324,2022-02-09
317108,JAKARTA PUSAT,JOHAR BARU,10696,226,9390,159,921,1147,2022-02-09
317306,JAKARTA BARAT,KALI DERES,21489,614,19103,319,1453,2067,2022-02-09
317407,JAKARTA SELATAN,KEBAYORAN BARU,16647,257,14938,189,1263,1520,2022-02-09
317405,JAKARTA SELATAN,KEBAYORAN LAMA,24248,428,21521,366,1933,2361,2022-02-09
317305,JAKARTA BARAT,KEBON JERUK,27787,746,24354,384,2303,3049,2022-02-09
317206,JAKARTA UTARA,KELAPA GADING,16010,352,13973,194,1491,1843,2022-02-09
317103,JAKARTA PUSAT,KEMAYORAN,23536,492,21271,380,1393,1885,2022-02-09
317308,JAKARTA BARAT,KEMBANGAN,24392,480,21780,308,1824,2304,2022-02-09
310102,KAB.ADM.KEP.SERIBU,KEP. SERIBU SELATAN,709,0,695,10,4,4,2022-02-09
310101,KAB.ADM.KEP.SERIBU,KEP. SERIBU UTARA,656,1,638,6,11,12,2022-02-09
317203,JAKARTA UTARA,KOJA,19915,437,17962,342,1174,1611,2022-02-09
317504,JAKARTA TIMUR,KRAMAT JATI,24823,333,22441,406,1643,1976,2022-02-09
111111,LUAR DKI JAKARTA,LUAR DKI JAKARTA,91572,19,90857,614,82,101,2022-02-09
317508,JAKARTA TIMUR,MAKASAR,20281,574,18149,302,1256,1830,2022-02-09
317403,JAKARTA SELATAN,MAMPANG PRAPATAN,14073,151,12493,180,1249,1400,2022-02-09
317501,JAKARTA TIMUR,MATRAMAN,16996,321,14953,280,1442,1763,2022-02-09
317106,JAKARTA PUSAT,MENTENG,7986,259,6978,124,625,884,2022-02-09
317205,JAKARTA UTARA,PADEMANGAN,15275,383,13967,168,757,1140,2022-02-09
317307,JAKARTA BARAT,PALMERAH,19026,376,16984,337,1329,1705,2022-02-09
317408,JAKARTA SELATAN,PANCORAN,17335,239,15345,231,1520,1759,2022-02-09
317404,JAKARTA SELATAN,PASAR MINGGU,28112,332,25129,429,2222,2554,2022-02-09
317505,JAKARTA TIMUR,PASAR REBO,19758,257,18079,330,1092,1349,2022-02-09
317201,JAKARTA UTARA,PENJARINGAN,23865,720,20990,236,1919,2639,2022-02-09
317410,JAKARTA SELATAN,PESANGGRAHAN,19322,221,17494,255,1352,1573,2022-02-09
111111,PROSES UPDATE DATA,PROSES UPDATE DATA,67219,481,63216,784,2738,3219,2022-02-09
317502,JAKARTA TIMUR,PULO GADUNG,26214,597,23067,410,2140,2737,2022-02-09
317102,JAKARTA PUSAT,SAWAH BESAR,11719,447,10367,177,728,1175,2022-02-09
317104,JAKARTA PUSAT,SENEN,11320,311,10049,171,789,1100,2022-02-09
317402,JAKARTA SELATAN,SETIA BUDI,14261,319,12726,184,1032,1351,2022-02-09
317303,JAKARTA BARAT,TAMAN SARI,11303,339,10151,140,673,1012,2022-02-09
317304,JAKARTA BARAT,TAMBORA,18101,439,16182,261,1219,1658,2022-02-09
317107,JAKARTA PUSAT,TANAH ABANG,13593,275,12090,227,1001,1276,2022-02-09
317202,JAKARTA UTARA,TANJUNG PRIOK,30562,790,27516,427,1829,2619,2022-02-09
317401,JAKARTA SELATAN,TEBET,20621,397,18255,286,1683,2080,2022-02-09
317506,JAKARTA TIMUR,CAKUNG,26471,486,23560,416,2009,2495,2022-02-10
317105,JAKARTA PUSAT,CEMPAKA PUTIH,12538,331,11149,172,886,1217,2022-02-10
317301,JAKARTA BARAT,CENGKARENG,34460,970,30526,564,2400,3370,2022-02-10
317406,JAKARTA SELATAN,CILANDAK,21454,523,19040,265,1626,2149,2022-02-10
317204,JAKARTA UTARA,CILINCING,19995,485,18020,344,1146,1631,2022-02-10
317510,JAKARTA TIMUR,CIPAYUNG,28251,357,26039,271,1584,1941,2022-02-10
317509,JAKARTA TIMUR,CIRACAS,25609,299,23434,384,1492,1791,2022-02-10
317507,JAKARTA TIMUR,DUREN SAWIT,35108,698,31048,619,2743,3441,2022-02-10
317101,JAKARTA PUSAT,GAMBIR,10604,217,9423,137,827,1044,2022-02-10
317302,JAKARTA BARAT,GROGOL PETAMBURAN,24200,779,21266,303,1852,2631,2022-02-10
317409,JAKARTA SELATAN,JAGAKARSA,30605,323,27939,414,1929,2252,2022-02-10
317503,JAKARTA TIMUR,JATINEGARA,23458,497,20578,390,1993,2490,2022-02-10
317108,JAKARTA PUSAT,JOHAR BARU,10809,229,9471,159,950,1179,2022-02-10
317306,JAKARTA BARAT,KALI DERES,21752,649,19210,319,1574,2223,2022-02-10
317407,JAKARTA SELATAN,KEBAYORAN BARU,16730,270,15025,189,1246,1516,2022-02-10
317405,JAKARTA SELATAN,KEBAYORAN LAMA,24599,468,21692,370,2069,2537,2022-02-10
317305,JAKARTA BARAT,KEBON JERUK,28211,769,24566,385,2491,3260,2022-02-10
317206,JAKARTA UTARA,KELAPA GADING,16257,371,14084,194,1608,1979,2022-02-10
317103,JAKARTA PUSAT,KEMAYORAN,23779,532,21390,381,1476,2008,2022-02-10
317308,JAKARTA BARAT,KEMBANGAN,24689,518,21888,309,1974,2492,2022-02-10
310102,KAB.ADM.KEP.SERIBU,KEP. SERIBU SELATAN,713,0,695,10,8,8,2022-02-10
310101,KAB.ADM.KEP.SERIBU,KEP. SERIBU UTARA,663,2,638,6,17,19,2022-02-10
317203,JAKARTA UTARA,KOJA,20160,486,18035,342,1297,1783,2022-02-10
317504,JAKARTA TIMUR,KRAMAT JATI,25111,368,22589,406,1748,2116,2022-02-10
111111,LUAR DKI JAKARTA,LUAR DKI JAKARTA,91635,19,90918,614,84,103,2022-02-10
317508,JAKARTA TIMUR,MAKASAR,20553,597,18272,302,1382,1979,2022-02-10
317403,JAKARTA SELATAN,MAMPANG PRAPATAN,14222,167,12622,180,1253,1420,2022-02-10
317501,JAKARTA TIMUR,MATRAMAN,17233,370,15034,281,1548,1918,2022-02-10
317106,JAKARTA PUSAT,MENTENG,8093,280,7026,124,663,943,2022-02-10
317205,JAKARTA UTARA,PADEMANGAN,15482,402,14018,169,893,1295,2022-02-10
317307,JAKARTA BARAT,PALMERAH,19261,408,17062,338,1453,1861,2022-02-10
317408,JAKARTA SELATAN,PANCORAN,17579,251,15480,231,1617,1868,2022-02-10
317404,JAKARTA SELATAN,PASAR MINGGU,28462,351,25336,429,2346,2697,2022-02-10
317505,JAKARTA TIMUR,PASAR REBO,19919,286,18155,330,1148,1434,2022-02-10
317201,JAKARTA UTARA,PENJARINGAN,24171,747,21150,236,2038,2785,2022-02-10
317410,JAKARTA SELATAN,PESANGGRAHAN,19604,242,17583,255,1524,1766,2022-02-10
111111,PROSES UPDATE DATA,PROSES UPDATE DATA,67727,535,63808,788,2596,3131,2022-02-10
317502,JAKARTA TIMUR,PULO GADUNG,26627,645,23286,410,2286,2931,2022-02-10
317102,JAKARTA PUSAT,SAWAH BESAR,11852,463,10438,178,773,1236,2022-02-10
317104,JAKARTA PUSAT,SENEN,11481,336,10107,171,867,1203,2022-02-10
317402,JAKARTA SELATAN,SETIA BUDI,14442,342,12810,184,1106,1448,2022-02-10
317303,JAKARTA BARAT,TAMAN SARI,11429,341,10200,140,748,1089,2022-02-10
317304,JAKARTA BARAT,TAMBORA,18277,461,16282,262,1272,1733,2022-02-10
317107,JAKARTA PUSAT,TANAH ABANG,13760,298,12159,227,1076,1374,2022-02-10
317202,JAKARTA UTARA,TANJUNG PRIOK,30957,847,27643,427,2040,2887,2022-02-10
317401,JAKARTA SELATAN,TEBET,20920,430,18406,286,1798,2228,2022-02-10
317506,JAKARTA TIMUR,CAKUNG,26789,545,23964,417,1863,2408,2022-02-11
317105,JAKARTA PUSAT,CEMPAKA PUTIH,12669,321,11353,175,820,1141,2022-02-11
317301,JAKARTA BARAT,CENGKARENG,34839,1005,31091,565,2178,3183,2022-02-11
317406,JAKARTA SELATAN,CILANDAK,21783,537,19444,265,1537,2074,2022-02-11
317204,JAKARTA UTARA,CILINCING,20172,476,18354,345,997,1473,2022-02-11
317510,JAKARTA TIMUR,CIPAYUNG,28506,360,26326,271,1549,1909,2022-02-11
317509,JAKARTA TIMUR,CIRACAS,25817,305,23766,385,1361,1666,2022-02-11
317507,JAKARTA TIMUR,DUREN SAWIT,35526,700,31585,621,2620,3320,2022-02-11
317101,JAKARTA PUSAT,GAMBIR,10687,205,9632,137,713,918,2022-02-11
317302,JAKARTA BARAT,GROGOL PETAMBURAN,24546,859,21763,304,1620,2479,2022-02-11
317409,JAKARTA SELATAN,JAGAKARSA,30902,317,28338,414,1833,2150,2022-02-11
317503,JAKARTA TIMUR,JATINEGARA,23781,522,21034,391,1834,2356,2022-02-11
317108,JAKARTA PUSAT,JOHAR BARU,10904,215,9710,159,820,1035,2022-02-11
317306,JAKARTA BARAT,KALI DERES,22043,696,19571,320,1456,2152,2022-02-11
317407,JAKARTA SELATAN,KEBAYORAN BARU,16905,269,15273,189,1174,1443,2022-02-11
317405,JAKARTA SELATAN,KEBAYORAN LAMA,24950,496,22146,371,1937,2433,2022-02-11
317305,JAKARTA BARAT,KEBON JERUK,28650,881,25116,385,2268,3149,2022-02-11
317206,JAKARTA UTARA,KELAPA GADING,16521,372,14417,194,1538,1910,2022-02-11
317103,JAKARTA PUSAT,KEMAYORAN,24141,552,21792,381,1416,1968,2022-02-11
317308,JAKARTA BARAT,KEMBANGAN,25006,539,22332,309,1826,2365,2022-02-11
310102,KAB.ADM.KEP.SERIBU,KEP. SERIBU SELATAN,716,2,695,10,9,11,2022-02-11
310101,KAB.ADM.KEP.SERIBU,KEP. SERIBU UTARA,659,1,640,6,12,13,2022-02-11
317203,JAKARTA UTARA,KOJA,20367,472,18402,342,1151,1623,2022-02-11
317504,JAKARTA TIMUR,KRAMAT JATI,25385,375,22984,406,1620,1995,2022-02-11
111111,LUAR DKI JAKARTA,LUAR DKI JAKARTA,91661,10,90981,614,56,66,2022-02-11
317508,JAKARTA TIMUR,MAKASAR,20860,640,18616,302,1302,1942,2022-02-11
317403,JAKARTA SELATAN,MAMPANG PRAPATAN,14368,178,12873,180,1137,1315,2022-02-11
317501,JAKARTA TIMUR,MATRAMAN,17437,394,15447,281,1315,1709,2022-02-11
317106,JAKARTA PUSAT,MENTENG,8206,273,7207,124,602,875,2022-02-11
317205,JAKARTA UTARA,PADEMANGAN,15633,403,14279,171,780,1183,2022-02-11
317307,JAKARTA BARAT,PALMERAH,19466,404,17394,340,1328,1732,2022-02-11
317408,JAKARTA SELATAN,PANCORAN,17761,248,15834,231,1448,1696,2022-02-11
317404,JAKARTA SELATAN,PASAR MINGGU,28794,349,25786,429,2230,2579,2022-02-11
317505,JAKARTA TIMUR,PASAR REBO,20104,291,18398,331,1084,1375,2022-02-11
317201,JAKARTA UTARA,PENJARINGAN,24480,759,21623,236,1862,2621,2022-02-11
317410,JAKARTA SELATAN,PESANGGRAHAN,19815,240,17946,255,1374,1614,2022-02-11
111111,PROSES UPDATE DATA,PROSES UPDATE DATA,68141,522,64635,807,2177,2699,2022-02-11
317502,JAKARTA TIMUR,PULO GADUNG,26984,663,23768,410,2143,2806,2022-02-11
317102,JAKARTA PUSAT,SAWAH BESAR,11986,469,10642,179,696,1165,2022-02-11
317104,JAKARTA PUSAT,SENEN,11582,317,10324,171,770,1087,2022-02-11
317402,JAKARTA SELATAN,SETIA BUDI,14643,344,13073,184,1042,1386,2022-02-11
317303,JAKARTA BARAT,TAMAN SARI,11528,344,10429,140,615,959,2022-02-11
317304,JAKARTA BARAT,TAMBORA,18438,465,16668,262,1043,1508,2022-02-11
317107,JAKARTA PUSAT,TANAH ABANG,13893,298,12406,227,962,1260,2022-02-11
317202,JAKARTA UTARA,TANJUNG PRIOK,31359,860,28181,428,1890,2750,2022-02-11
317401,JAKARTA SELATAN,TEBET,21216,432,18841,286,1657,2089,2022-02-11
317506,JAKARTA TIMUR,CAKUNG,27244,552,24396,418,1878,2430,2022-02-12
317105,JAKARTA PUSAT,CEMPAKA PUTIH,12842,270,11561,175,836,1106,2022-02-12
317301,JAKARTA BARAT,CENGKARENG,35343,960,31655,566,2162,3122,2022-02-12
317406,JAKARTA SELATAN,CILANDAK,22078,537,19789,266,1486,2023,2022-02-12
317204,JAKARTA UTARA,CILINCING,20475,474,18649,345,1007,1481,2022-02-12
317510,JAKARTA TIMUR,CIPAYUNG,28871,366,26640,271,1594,1960,2022-02-12
317509,JAKARTA TIMUR,CIRACAS,26119,301,24019,385,1414,1715,2022-02-12
317507,JAKARTA TIMUR,DUREN SAWIT,36074,697,32285,621,2471,3168,2022-02-12
317101,JAKARTA PUSAT,GAMBIR,10814,187,9843,140,644,831,2022-02-12
317302,JAKARTA BARAT,GROGOL PETAMBURAN,24925,845,22279,305,1496,2341,2022-02-12
317409,JAKARTA SELATAN,JAGAKARSA,31361,307,28771,414,1869,2176,2022-02-12
317503,JAKARTA TIMUR,JATINEGARA,24123,503,21484,392,1744,2247,2022-02-12
317108,JAKARTA PUSAT,JOHAR BARU,11055,206,9936,159,754,960,2022-02-12
317306,JAKARTA BARAT,KALI DERES,22430,670,19928,321,1511,2181,2022-02-12
317407,JAKARTA SELATAN,KEBAYORAN BARU,17140,275,15549,190,1126,1401,2022-02-12
317405,JAKARTA SELATAN,KEBAYORAN LAMA,25359,503,22589,372,1895,2398,2022-02-12
317305,JAKARTA BARAT,KEBON JERUK,29028,826,25693,387,2122,2948,2022-02-12
317206,JAKARTA UTARA,KELAPA GADING,16772,351,14768,194,1459,1810,2022-02-12
317103,JAKARTA PUSAT,KEMAYORAN,24406,538,22128,381,1359,1897,2022-02-12
317308,JAKARTA BARAT,KEMBANGAN,25399,539,22784,310,1766,2305,2022-02-12
310102,KAB.ADM.KEP.SERIBU,KEP. SERIBU SELATAN,729,2,695,10,22,24,2022-02-12
310101,KAB.ADM.KEP.SERIBU,KEP. SERIBU UTARA,666,0,640,6,20,20,2022-02-12
317203,JAKARTA UTARA,KOJA,20640,458,18802,345,1035,1493,2022-02-12
317504,JAKARTA TIMUR,KRAMAT JATI,25706,366,23351,406,1583,1949,2022-02-12
111111,LUAR DKI JAKARTA,LUAR DKI JAKARTA,91666,13,90988,614,51,64,2022-02-12
317508,JAKARTA TIMUR,MAKASAR,21089,592,18902,304,1291,1883,2022-02-12
317403,JAKARTA SELATAN,MAMPANG PRAPATAN,14618,180,13133,180,1125,1305,2022-02-12
317501,JAKARTA TIMUR,MATRAMAN,17659,369,15803,282,1205,1574,2022-02-12
317106,JAKARTA PUSAT,MENTENG,8303,218,7381,124,580,798,2022-02-12
317205,JAKARTA UTARA,PADEMANGAN,15795,370,14527,171,727,1097,2022-02-12
317307,JAKARTA BARAT,PALMERAH,19688,382,17744,341,1221,1603,2022-02-12
317408,JAKARTA SELATAN,PANCORAN,17987,257,16177,232,1321,1578,2022-02-12
317404,JAKARTA SELATAN,PASAR MINGGU,29205,349,26286,429,2141,2490,2022-02-12
317505,JAKARTA TIMUR,PASAR REBO,20339,290,18659,331,1059,1349,2022-02-12
317201,JAKARTA UTARA,PENJARINGAN,24811,713,22102,237,1759,2472,2022-02-12
317410,JAKARTA SELATAN,PESANGGRAHAN,20111,232,18295,256,1328,1560,2022-02-12
111111,PROSES UPDATE DATA,PROSES UPDATE DATA,68449,509,65220,819,1901,2410,2022-02-12
317502,JAKARTA TIMUR,PULO GADUNG,27409,631,24257,410,2111,2742,2022-02-12
317102,JAKARTA PUSAT,SAWAH BESAR,12108,417,10870,179,642,1059,2022-02-12
317104,JAKARTA PUSAT,SENEN,11736,302,10522,171,741,1043,2022-02-12
317402,JAKARTA SELATAN,SETIA BUDI,14851,329,13348,184,990,1319,2022-02-12
317303,JAKARTA BARAT,TAMAN SARI,11683,340,10621,142,580,920,2022-02-12
317304,JAKARTA BARAT,TAMBORA,18640,430,16985,263,962,1392,2022-02-12
317107,JAKARTA PUSAT,TANAH ABANG,14072,280,12662,227,903,1183,2022-02-12
317202,JAKARTA UTARA,TANJUNG PRIOK,31708,833,28717,428,1730,2563,2022-02-12
317401,JAKARTA SELATAN,TEBET,21510,429,19191,286,1604,2033,2022-02-12
317506,JAKARTA TIMUR,CAKUNG,27620,568,24892,419,1741,2309,2022-02-13
317105,JAKARTA PUSAT,CEMPAKA PUTIH,12960,258,11779,175,748,1006,2022-02-13
317301,JAKARTA BARAT,CENGKARENG,35756,912,32260,566,2018,2930,2022-02-13
317406,JAKARTA SELATAN,CILANDAK,22356,509,20153,268,1426,1935,2022-02-13
317204,JAKARTA UTARA,CILINCING,20665,496,18947,345,877,1373,2022-02-13
317510,JAKARTA TIMUR,CIPAYUNG,29038,356,27018,271,1393,1749,2022-02-13
317509,JAKARTA TIMUR,CIRACAS,26299,303,24393,386,1217,1520,2022-02-13
317507,JAKARTA TIMUR,DUREN SAWIT,36522,691,32867,621,2343,3034,2022-02-13
317101,JAKARTA PUSAT,GAMBIR,10939,182,10003,140,614,796,2022-02-13
317302,JAKARTA BARAT,GROGOL PETAMBURAN,25241,820,22795,307,1319,2139,2022-02-13
317409,JAKARTA SELATAN,JAGAKARSA,31641,296,29201,414,1730,2026,2022-02-13
317503,JAKARTA TIMUR,JATINEGARA,24414,489,21918,394,1613,2102,2022-02-13
317108,JAKARTA PUSAT,JOHAR BARU,11141,203,10139,160,639,842,2022-02-13
317306,JAKARTA BARAT,KALI DERES,22677,664,20319,324,1370,2034,2022-02-13
317407,JAKARTA SELATAN,KEBAYORAN BARU,17299,252,15830,191,1026,1278,2022-02-13
317405,JAKARTA SELATAN,KEBAYORAN LAMA,25669,504,22946,372,1847,2351,2022-02-13
317305,JAKARTA BARAT,KEBON JERUK,29453,860,26259,387,1947,2807,2022-02-13
317206,JAKARTA UTARA,KELAPA GADING,16992,337,15133,194,1328,1665,2022-02-13
317103,JAKARTA PUSAT,KEMAYORAN,24659,525,22493,381,1260,1785,2022-02-13
317308,JAKARTA BARAT,KEMBANGAN,25779,540,23191,312,1736,2276,2022-02-13
310102,KAB.ADM.KEP.SERIBU,KEP. SERIBU SELATAN,727,0,695,10,22,22,2022-02-13
310101,KAB.ADM.KEP.SERIBU,KEP. SERIBU UTARA,664,0,641,6,17,17,2022-02-13
317203,JAKARTA UTARA,KOJA,20783,442,19111,345,885,1327,2022-02-13
317504,JAKARTA TIMUR,KRAMAT JATI,25919,385,23731,407,1396,1781,2022-02-13
111111,LUAR DKI JAKARTA,LUAR DKI JAKARTA,91673,12,91001,614,46,58,2022-02-13
317508,JAKARTA TIMUR,MAKASAR,21319,619,19212,304,1184,1803,2022-02-13
317403,JAKARTA SELATAN,MAMPANG PRAPATAN,14742,165,13416,180,981,1146,2022-02-13
317501,JAKARTA TIMUR,MATRAMAN,17803,355,16089,282,1077,1432,2022-02-13
317106,JAKARTA PUSAT,MENTENG,8446,210,7533,124,579,789,2022-02-13
317205,JAKARTA UTARA,PADEMANGAN,15909,358,14760,171,620,978,2022-02-13
317307,JAKARTA BARAT,PALMERAH,19865,386,18066,342,1071,1457,2022-02-13
317408,JAKARTA SELATAN,PANCORAN,18198,246,16525,233,1194,1440,2022-02-13
317404,JAKARTA SELATAN,PASAR MINGGU,29585,339,26747,430,2069,2408,2022-02-13
317505,JAKARTA TIMUR,PASAR REBO,20479,278,18938,331,932,1210,2022-02-13
317201,JAKARTA UTARA,PENJARINGAN,25132,685,22639,237,1571,2256,2022-02-13
317410,JAKARTA SELATAN,PESANGGRAHAN,20309,225,18564,259,1261,1486,2022-02-13
111111,PROSES UPDATE DATA,PROSES UPDATE DATA,69073,554,65574,834,2111,2665,2022-02-13
317502,JAKARTA TIMUR,PULO GADUNG,27753,635,24692,412,2014,2649,2022-02-13
317102,JAKARTA PUSAT,SAWAH BESAR,12231,395,11070,179,587,982,2022-02-13
317104,JAKARTA PUSAT,SENEN,11857,307,10705,171,674,981,2022-02-13
317402,JAKARTA SELATAN,SETIA BUDI,15011,306,13584,184,937,1243,2022-02-13
317303,JAKARTA BARAT,TAMAN SARI,11785,317,10813,143,512,829,2022-02-13
317304,JAKARTA BARAT,TAMBORA,18819,407,17312,263,837,1244,2022-02-13
317107,JAKARTA PUSAT,TANAH ABANG,14198,276,12891,228,803,1079,2022-02-13
317202,JAKARTA UTARA,TANJUNG PRIOK,32046,808,29230,429,1579,2387,2022-02-13
317401,JAKARTA SELATAN,TEBET,21762,425,19599,287,1451,1876,2022-02-13
317506,JAKARTA TIMUR,CAKUNG,27836,601,24891,421,1923,2524,2022-02-14
317105,JAKARTA PUSAT,CEMPAKA PUTIH,13112,289,11780,175,868,1157,2022-02-14
317301,JAKARTA BARAT,CENGKARENG,36052,1006,32260,566,2220,3226,2022-02-14
317406,JAKARTA SELATAN,CILANDAK,22611,572,20153,270,1616,2188,2022-02-14
317204,JAKARTA UTARA,CILINCING,20848,543,18947,345,1013,1556,2022-02-14
317510,JAKARTA TIMUR,CIPAYUNG,29469,403,27022,274,1770,2173,2022-02-14
317509,JAKARTA TIMUR,CIRACAS,26633,340,24393,386,1514,1854,2022-02-14
317507,JAKARTA TIMUR,DUREN SAWIT,36906,746,32868,622,2670,3416,2022-02-14
317101,JAKARTA PUSAT,GAMBIR,11014,202,10003,140,669,871,2022-02-14
317302,JAKARTA BARAT,GROGOL PETAMBURAN,25569,893,22791,310,1575,2468,2022-02-14
317409,JAKARTA SELATAN,JAGAKARSA,32177,334,29204,414,2225,2559,2022-02-14
317503,JAKARTA TIMUR,JATINEGARA,24634,527,21921,395,1791,2318,2022-02-14
317108,JAKARTA PUSAT,JOHAR BARU,11298,226,10139,162,771,997,2022-02-14
317306,JAKARTA BARAT,KALI DERES,23111,756,20326,324,1705,2461,2022-02-14
317407,JAKARTA SELATAN,KEBAYORAN BARU,17441,270,15808,193,1170,1440,2022-02-14
317405,JAKARTA SELATAN,KEBAYORAN LAMA,25993,564,22947,375,2107,2671,2022-02-14
317305,JAKARTA BARAT,KEBON JERUK,29741,951,26266,390,2134,3085,2022-02-14
317206,JAKARTA UTARA,KELAPA GADING,17250,373,15133,195,1549,1922,2022-02-14
317103,JAKARTA PUSAT,KEMAYORAN,24839,582,22494,384,1379,1961,2022-02-14
317308,JAKARTA BARAT,KEMBANGAN,26047,593,23211,312,1931,2524,2022-02-14
310102,KAB.ADM.KEP.SERIBU,KEP. SERIBU SELATAN,729,0,695,10,24,24,2022-02-14
310101,KAB.ADM.KEP.SERIBU,KEP. SERIBU UTARA,677,1,641,6,29,30,2022-02-14
317203,JAKARTA UTARA,KOJA,21027,480,19110,346,1091,1571,2022-02-14
317504,JAKARTA TIMUR,KRAMAT JATI,26160,423,23732,407,1598,2021,2022-02-14
111111,LUAR DKI JAKARTA,LUAR DKI JAKARTA,91730,15,91039,614,62,77,2022-02-14
317508,JAKARTA TIMUR,MAKASAR,21573,662,19212,304,1395,2057,2022-02-14
317403,JAKARTA SELATAN,MAMPANG PRAPATAN,14861,194,13417,180,1070,1264,2022-02-14
317501,JAKARTA TIMUR,MATRAMAN,17917,377,16092,282,1166,1543,2022-02-14
317106,JAKARTA PUSAT,MENTENG,8522,235,7533,124,630,865,2022-02-14
317205,JAKARTA UTARA,PADEMANGAN,15991,384,14757,172,678,1062,2022-02-14
317307,JAKARTA BARAT,PALMERAH,19999,424,18043,343,1189,1613,2022-02-14
317408,JAKARTA SELATAN,PANCORAN,18395,270,16525,233,1367,1637,2022-02-14
317404,JAKARTA SELATAN,PASAR MINGGU,29933,394,26747,431,2361,2755,2022-02-14
317505,JAKARTA TIMUR,PASAR REBO,20623,308,18939,331,1045,1353,2022-02-14
317201,JAKARTA UTARA,PENJARINGAN,25396,757,22636,239,1764,2521,2022-02-14
317410,JAKARTA SELATAN,PESANGGRAHAN,20463,256,18564,262,1381,1637,2022-02-14
111111,PROSES UPDATE DATA,PROSES UPDATE DATA,69553,661,65615,843,2434,3095,2022-02-14
317502,JAKARTA TIMUR,PULO GADUNG,28148,680,24706,413,2349,3029,2022-02-14
317102,JAKARTA PUSAT,SAWAH BESAR,12366,417,11070,180,699,1116,2022-02-14
317104,JAKARTA PUSAT,SENEN,11966,333,10706,171,756,1089,2022-02-14
317402,JAKARTA SELATAN,SETIA BUDI,15181,332,13584,186,1079,1411,2022-02-14
317303,JAKARTA BARAT,TAMAN SARI,11912,341,10814,144,613,954,2022-02-14
317304,JAKARTA BARAT,TAMBORA,18963,455,17311,264,933,1388,2022-02-14
317107,JAKARTA PUSAT,TANAH ABANG,14378,303,12892,228,955,1258,2022-02-14
317202,JAKARTA UTARA,TANJUNG PRIOK,32439,928,29234,431,1846,2774,2022-02-14
317401,JAKARTA SELATAN,TEBET,22000,472,19599,288,1641,2113,2022-02-14
317506,JAKARTA TIMUR,CAKUNG,28113,622,25105,422,1964,2586,2022-02-15
317105,JAKARTA PUSAT,CEMPAKA PUTIH,13202,299,11898,175,830,1129,2022-02-15
317301,JAKARTA BARAT,CENGKARENG,36503,1011,32584,570,2338,3349,2022-02-15
317406,JAKARTA SELATAN,CILANDAK,22886,564,20407,270,1645,2209,2022-02-15
317204,JAKARTA UTARA,CILINCING,21196,554,19116,346,1180,1734,2022-02-15
317510,JAKARTA TIMUR,CIPAYUNG,29635,430,27170,274,1761,2191,2022-02-15
317509,JAKARTA TIMUR,CIRACAS,26791,337,24542,387,1525,1862,2022-02-15
317507,JAKARTA TIMUR,DUREN SAWIT,37301,742,33222,624,2713,3455,2022-02-15
317101,JAKARTA PUSAT,GAMBIR,11089,206,10090,141,652,858,2022-02-15
317302,JAKARTA BARAT,GROGOL PETAMBURAN,25838,870,23087,311,1570,2440,2022-02-15
317409,JAKARTA SELATAN,JAGAKARSA,32445,350,29433,418,2244,2594,2022-02-15
317503,JAKARTA TIMUR,JATINEGARA,24854,526,22156,397,1775,2301,2022-02-15
317108,JAKARTA PUSAT,JOHAR BARU,11360,211,10269,164,716,927,2022-02-15
317306,JAKARTA BARAT,KALI DERES,23420,783,20609,324,1704,2487,2022-02-15
317407,JAKARTA SELATAN,KEBAYORAN BARU,17608,280,15963,193,1172,1452,2022-02-15
317405,JAKARTA SELATAN,KEBAYORAN LAMA,26249,527,23235,376,2111,2638,2022-02-15
317305,JAKARTA BARAT,KEBON JERUK,30028,936,26653,392,2047,2983,2022-02-15
317206,JAKARTA UTARA,KELAPA GADING,17566,363,15401,195,1607,1970,2022-02-15
317103,JAKARTA PUSAT,KEMAYORAN,25036,566,22673,385,1412,1978,2022-02-15
317308,JAKARTA BARAT,KEMBANGAN,26316,578,23502,314,1922,2500,2022-02-15
310102,KAB.ADM.KEP.SERIBU,KEP. SERIBU SELATAN,729,0,696,10,23,23,2022-02-15
310101,KAB.ADM.KEP.SERIBU,KEP. SERIBU UTARA,682,1,642,6,33,34,2022-02-15
317203,JAKARTA UTARA,KOJA,21245,486,19287,346,1126,1612,2022-02-15
317504,JAKARTA TIMUR,KRAMAT JATI,26349,424,23907,407,1611,2035,2022-02-15
111111,LUAR DKI JAKARTA,LUAR DKI JAKARTA,91767,17,91058,614,78,95,2022-02-15
317508,JAKARTA TIMUR,MAKASAR,21773,684,19383,305,1401,2085,2022-02-15
317403,JAKARTA SELATAN,MAMPANG PRAPATAN,14981,201,13541,182,1057,1258,2022-02-15
317501,JAKARTA TIMUR,MATRAMAN,18076,379,16241,285,1171,1550,2022-02-15
317106,JAKARTA PUSAT,MENTENG,8571,219,7623,124,605,824,2022-02-15
317205,JAKARTA UTARA,PADEMANGAN,16130,372,14870,172,716,1088,2022-02-15
317307,JAKARTA BARAT,PALMERAH,20157,417,18185,343,1212,1629,2022-02-15
317408,JAKARTA SELATAN,PANCORAN,18575,270,16745,233,1327,1597,2022-02-15
317404,JAKARTA SELATAN,PASAR MINGGU,30209,376,27041,433,2359,2735,2022-02-15
317505,JAKARTA TIMUR,PASAR REBO,20774,335,19059,332,1048,1383,2022-02-15
317201,JAKARTA UTARA,PENJARINGAN,25692,746,22953,240,1753,2499,2022-02-15
317410,JAKARTA SELATAN,PESANGGRAHAN,20642,268,18722,262,1390,1658,2022-02-15
111111,PROSES UPDATE DATA,PROSES UPDATE DATA,70158,698,66070,853,2537,3235,2022-02-15
317502,JAKARTA TIMUR,PULO GADUNG,28456,657,25155,415,2229,2886,2022-02-15
317102,JAKARTA PUSAT,SAWAH BESAR,12446,383,11200,180,683,1066,2022-02-15
317104,JAKARTA PUSAT,SENEN,12082,343,10799,171,769,1112,2022-02-15
317402,JAKARTA SELATAN,SETIA BUDI,15338,326,13756,186,1070,1396,2022-02-15
317303,JAKARTA BARAT,TAMAN SARI,11996,299,10928,144,625,924,2022-02-15
317304,JAKARTA BARAT,TAMBORA,19118,445,17501,264,908,1353,2022-02-15
317107,JAKARTA PUSAT,TANAH ABANG,14477,278,13013,229,957,1235,2022-02-15
317202,JAKARTA UTARA,TANJUNG PRIOK,32873,911,29558,432,1972,2883,2022-02-15
317401,JAKARTA SELATAN,TEBET,22233,458,19813,289,1673,2131,2022-02-15
317506,JAKARTA TIMUR,CAKUNG,28474,675,25249,422,2128,2803,2022-02-16
317105,JAKARTA PUSAT,CEMPAKA PUTIH,13386,332,11974,176,904,1236,2022-02-16
317301,JAKARTA BARAT,CENGKARENG,36945,1044,32934,571,2396,3440,2022-02-16
317406,JAKARTA SELATAN,CILANDAK,23168,578,20646,273,1671,2249,2022-02-16
317204,JAKARTA UTARA,CILINCING,21569,565,19239,347,1418,1983,2022-02-16
317510,JAKARTA TIMUR,CIPAYUNG,29991,477,27277,277,1960,2437,2022-02-16
317509,JAKARTA TIMUR,CIRACAS,27206,378,24639,389,1800,2178,2022-02-16
317507,JAKARTA TIMUR,DUREN SAWIT,37799,798,33514,625,2862,3660,2022-02-16
317101,JAKARTA PUSAT,GAMBIR,11200,196,10179,141,684,880,2022-02-16
317302,JAKARTA BARAT,GROGOL PETAMBURAN,26146,845,23355,311,1635,2480,2022-02-16
317409,JAKARTA SELATAN,JAGAKARSA,32703,370,29631,420,2282,2652,2022-02-16
317503,JAKARTA TIMUR,JATINEGARA,25167,559,22351,398,1859,2418,2022-02-16
317108,JAKARTA PUSAT,JOHAR BARU,11492,214,10333,165,780,994,2022-02-16
317306,JAKARTA BARAT,KALI DERES,23722,806,20847,326,1743,2549,2022-02-16
317407,JAKARTA SELATAN,KEBAYORAN BARU,17791,272,16108,193,1218,1490,2022-02-16
317405,JAKARTA SELATAN,KEBAYORAN LAMA,26536,533,23474,377,2152,2685,2022-02-16
317305,JAKARTA BARAT,KEBON JERUK,30513,957,26873,396,2287,3244,2022-02-16
317206,JAKARTA UTARA,KELAPA GADING,17879,381,15609,195,1694,2075,2022-02-16
317103,JAKARTA PUSAT,KEMAYORAN,25322,575,22845,385,1517,2092,2022-02-16
317308,JAKARTA BARAT,KEMBANGAN,26658,606,23695,314,2043,2649,2022-02-16
310102,KAB.ADM.KEP.SERIBU,KEP. SERIBU SELATAN,730,1,696,10,23,24,2022-02-16
310101,KAB.ADM.KEP.SERIBU,KEP. SERIBU UTARA,686,2,644,6,34,36,2022-02-16
317203,JAKARTA UTARA,KOJA,21471,501,19401,346,1223,1724,2022-02-16
317504,JAKARTA TIMUR,KRAMAT JATI,26665,446,24078,409,1732,2178,2022-02-16
111111,LUAR DKI JAKARTA,LUAR DKI JAKARTA,91792,18,91087,615,72,90,2022-02-16
317508,JAKARTA TIMUR,MAKASAR,22142,758,19539,306,1539,2297,2022-02-16
317403,JAKARTA SELATAN,MAMPANG PRAPATAN,15170,211,13650,183,1126,1337,2022-02-16
317501,JAKARTA TIMUR,MATRAMAN,18263,400,16361,287,1215,1615,2022-02-16
317106,JAKARTA PUSAT,MENTENG,8667,213,7697,124,633,846,2022-02-16
317205,JAKARTA UTARA,PADEMANGAN,16295,382,14990,173,750,1132,2022-02-16
317307,JAKARTA BARAT,PALMERAH,20398,445,18319,344,1290,1735,2022-02-16
317408,JAKARTA SELATAN,PANCORAN,18768,289,16893,233,1353,1642,2022-02-16
317404,JAKARTA SELATAN,PASAR MINGGU,30557,413,27318,433,2393,2806,2022-02-16
317505,JAKARTA TIMUR,PASAR REBO,21083,379,19150,332,1222,1601,2022-02-16
317201,JAKARTA UTARA,PENJARINGAN,26017,768,23252,241,1756,2524,2022-02-16
317410,JAKARTA SELATAN,PESANGGRAHAN,20865,289,18870,263,1443,1732,2022-02-16
111111,PROSES UPDATE DATA,PROSES UPDATE DATA,70949,826,66369,869,2885,3711,2022-02-16
317502,JAKARTA TIMUR,PULO GADUNG,28869,691,25403,415,2360,3051,2022-02-16
317102,JAKARTA PUSAT,SAWAH BESAR,12578,372,11325,180,701,1073,2022-02-16
317104,JAKARTA PUSAT,SENEN,12246,355,10887,172,832,1187,2022-02-16
317402,JAKARTA SELATAN,SETIA BUDI,15555,364,13903,187,1101,1465,2022-02-16
317303,JAKARTA BARAT,TAMAN SARI,12100,302,11014,145,639,941,2022-02-16
317304,JAKARTA BARAT,TAMBORA,19351,438,17656,267,990,1428,2022-02-16
317107,JAKARTA PUSAT,TANAH ABANG,14633,291,13133,229,980,1271,2022-02-16
317202,JAKARTA UTARA,TANJUNG PRIOK,33322,940,29812,432,2138,3078,2022-02-16
317401,JAKARTA SELATAN,TEBET,22514,462,19994,289,1769,2231,2022-02-16
317506,JAKARTA TIMUR,CAKUNG,28745,615,25840,424,1866,2481,2022-02-17
317105,JAKARTA PUSAT,CEMPAKA PUTIH,13502,314,12198,177,813,1127,2022-02-17
317301,JAKARTA BARAT,CENGKARENG,37280,953,33577,574,2176,3129,2022-02-17
317406,JAKARTA SELATAN,CILANDAK,23422,510,21034,274,1604,2114,2022-02-17
317204,JAKARTA UTARA,CILINCING,21727,525,19593,348,1261,1786,2022-02-17
317510,JAKARTA TIMUR,CIPAYUNG,30138,445,27775,281,1637,2082,2022-02-17
317509,JAKARTA TIMUR,CIRACAS,27371,358,25094,390,1529,1887,2022-02-17
317507,JAKARTA TIMUR,DUREN SAWIT,38205,697,34182,628,2698,3395,2022-02-17
317101,JAKARTA PUSAT,GAMBIR,11284,185,10375,143,581,766,2022-02-17
317302,JAKARTA BARAT,GROGOL PETAMBURAN,26370,768,23779,312,1511,2279,2022-02-17
317409,JAKARTA SELATAN,JAGAKARSA,32978,353,30039,421,2165,2518,2022-02-17
317503,JAKARTA TIMUR,JATINEGARA,25399,484,22852,401,1662,2146,2022-02-17
317108,JAKARTA PUSAT,JOHAR BARU,11537,196,10534,166,641,837,2022-02-17
317306,JAKARTA BARAT,KALI DERES,24006,784,21305,327,1590,2374,2022-02-17
317407,JAKARTA SELATAN,KEBAYORAN BARU,17946,267,16347,194,1138,1405,2022-02-17
317405,JAKARTA SELATAN,KEBAYORAN LAMA,26770,482,23988,379,1921,2403,2022-02-17
317305,JAKARTA BARAT,KEBON JERUK,30835,888,27465,396,2086,2974,2022-02-17
317206,JAKARTA UTARA,KELAPA GADING,18127,357,15960,199,1611,1968,2022-02-17
317103,JAKARTA PUSAT,KEMAYORAN,25477,557,23177,388,1355,1912,2022-02-17
317308,JAKARTA BARAT,KEMBANGAN,26918,542,24135,315,1926,2468,2022-02-17
310102,KAB.ADM.KEP.SERIBU,KEP. SERIBU SELATAN,732,1,703,10,18,19,2022-02-17
310101,KAB.ADM.KEP.SERIBU,KEP. SERIBU UTARA,687,2,647,6,32,34,2022-02-17
317203,JAKARTA UTARA,KOJA,21598,446,19752,348,1052,1498,2022-02-17
317504,JAKARTA TIMUR,KRAMAT JATI,26879,407,24510,410,1552,1959,2022-02-17
111111,LUAR DKI JAKARTA,LUAR DKI JAKARTA,91828,22,91113,615,78,100,2022-02-17
317508,JAKARTA TIMUR,MAKASAR,22352,735,19998,308,1311,2046,2022-02-17
317403,JAKARTA SELATAN,MAMPANG PRAPATAN,15266,195,13931,183,957,1152,2022-02-17
317501,JAKARTA TIMUR,MATRAMAN,18386,368,16777,290,951,1319,2022-02-17
317106,JAKARTA PUSAT,MENTENG,8723,184,7884,125,530,714,2022-02-17
317205,JAKARTA UTARA,PADEMANGAN,16402,348,15237,174,643,991,2022-02-17
317307,JAKARTA BARAT,PALMERAH,20512,404,18702,347,1059,1463,2022-02-17
317408,JAKARTA SELATAN,PANCORAN,18959,268,17251,233,1207,1475,2022-02-17
317404,JAKARTA SELATAN,PASAR MINGGU,30842,408,27818,434,2182,2590,2022-02-17
317505,JAKARTA TIMUR,PASAR REBO,21284,374,19463,334,1113,1487,2022-02-17
317201,JAKARTA UTARA,PENJARINGAN,26273,715,23724,243,1591,2306,2022-02-17
317410,JAKARTA SELATAN,PESANGGRAHAN,21030,265,19218,264,1283,1548,2022-02-17
111111,PROSES UPDATE DATA,PROSES UPDATE DATA,71534,951,66721,869,2993,3944,2022-02-17
317502,JAKARTA TIMUR,PULO GADUNG,29137,641,25960,419,2117,2758,2022-02-17
317102,JAKARTA PUSAT,SAWAH BESAR,12681,332,11547,180,622,954,2022-02-17
317104,JAKARTA PUSAT,SENEN,12304,302,11161,172,669,971,2022-02-17
317402,JAKARTA SELATAN,SETIA BUDI,15667,303,14156,187,1021,1324,2022-02-17
317303,JAKARTA BARAT,TAMAN SARI,12169,265,11185,145,574,839,2022-02-17
317304,JAKARTA BARAT,TAMBORA,19488,403,17897,269,919,1322,2022-02-17
317107,JAKARTA PUSAT,TANAH ABANG,14761,247,13428,230,856,1103,2022-02-17
317202,JAKARTA UTARA,TANJUNG PRIOK,33583,856,30454,433,1840,2696,2022-02-17
317401,JAKARTA SELATAN,TEBET,22775,410,20384,290,1691,2101,2022-02-17
317506,JAKARTA TIMUR,CAKUNG,28981,266,26184,426,2105,2371,2022-02-18
317105,JAKARTA PUSAT,CEMPAKA PUTIH,13589,91,12366,179,953,1044,2022-02-18
317301,JAKARTA BARAT,CENGKARENG,37596,361,34055,578,2602,2963,2022-02-18
317406,JAKARTA SELATAN,CILANDAK,23654,172,21325,274,1883,2055,2022-02-18
317204,JAKARTA UTARA,CILINCING,21860,161,19838,348,1513,1674,2022-02-18
317510,JAKARTA TIMUR,CIPAYUNG,30295,189,28092,281,1733,1922,2022-02-18
317509,JAKARTA TIMUR,CIRACAS,27557,170,25304,392,1691,1861,2022-02-18
317507,JAKARTA TIMUR,DUREN SAWIT,38534,310,34687,629,2908,3218,2022-02-18
317101,JAKARTA PUSAT,GAMBIR,11364,84,10470,143,667,751,2022-02-18
317302,JAKARTA BARAT,GROGOL PETAMBURAN,26599,300,24101,312,1886,2186,2022-02-18
317409,JAKARTA SELATAN,JAGAKARSA,33264,179,30466,421,2198,2377,2022-02-18
317503,JAKARTA TIMUR,JATINEGARA,25616,224,23181,403,1808,2032,2022-02-18
317108,JAKARTA PUSAT,JOHAR BARU,11594,63,10655,168,708,771,2022-02-18
317306,JAKARTA BARAT,KALI DERES,24257,312,21527,328,2090,2402,2022-02-18
317407,JAKARTA SELATAN,KEBAYORAN BARU,18101,133,16496,195,1277,1410,2022-02-18
317405,JAKARTA SELATAN,KEBAYORAN LAMA,26985,204,24328,380,2073,2277,2022-02-18
317305,JAKARTA BARAT,KEBON JERUK,31078,315,28049,399,2315,2630,2022-02-18
317206,JAKARTA UTARA,KELAPA GADING,18338,212,16189,199,1738,1950,2022-02-18
317103,JAKARTA PUSAT,KEMAYORAN,25630,195,23476,393,1566,1761,2022-02-18
317308,JAKARTA BARAT,KEMBANGAN,27210,259,24517,318,2116,2375,2022-02-18
310102,KAB.ADM.KEP.SERIBU,KEP. SERIBU SELATAN,732,0,705,10,17,17,2022-02-18
310101,KAB.ADM.KEP.SERIBU,KEP. SERIBU UTARA,690,1,652,6,31,32,2022-02-18
317203,JAKARTA UTARA,KOJA,21724,135,19931,349,1309,1444,2022-02-18
317504,JAKARTA TIMUR,KRAMAT JATI,27085,191,24863,410,1621,1812,2022-02-18
111111,LUAR DKI JAKARTA,LUAR DKI JAKARTA,91840,4,91125,615,96,100,2022-02-18
317508,JAKARTA TIMUR,MAKASAR,22538,294,20300,309,1635,1929,2022-02-18
317403,JAKARTA SELATAN,MAMPANG PRAPATAN,15350,81,14081,183,1005,1086,2022-02-18
317501,JAKARTA TIMUR,MATRAMAN,18495,138,17015,291,1051,1189,2022-02-18
317106,JAKARTA PUSAT,MENTENG,8778,68,8004,126,580,648,2022-02-18
317205,JAKARTA UTARA,PADEMANGAN,16490,104,15396,174,816,920,2022-02-18
317307,JAKARTA BARAT,PALMERAH,20634,162,18952,347,1173,1335,2022-02-18
317408,JAKARTA SELATAN,PANCORAN,19118,146,17414,234,1324,1470,2022-02-18
317404,JAKARTA SELATAN,PASAR MINGGU,31136,232,28157,438,2309,2541,2022-02-18
317505,JAKARTA TIMUR,PASAR REBO,21444,152,19671,335,1286,1438,2022-02-18
317201,JAKARTA UTARA,PENJARINGAN,26537,273,24031,243,1990,2263,2022-02-18
317410,JAKARTA SELATAN,PESANGGRAHAN,21192,145,19407,264,1376,1521,2022-02-18
111111,PROSES UPDATE DATA,PROSES UPDATE DATA,72324,899,67224,870,3331,4230,2022-02-18
317502,JAKARTA TIMUR,PULO GADUNG,29426,259,26371,421,2375,2634,2022-02-18
317102,JAKARTA PUSAT,SAWAH BESAR,12769,103,11686,180,800,903,2022-02-18
317104,JAKARTA PUSAT,SENEN,12408,102,11340,172,794,896,2022-02-18
317402,JAKARTA SELATAN,SETIA BUDI,15766,104,14321,187,1154,1258,2022-02-18
317303,JAKARTA BARAT,TAMAN SARI,12262,74,11317,145,726,800,2022-02-18
317304,JAKARTA BARAT,TAMBORA,19601,133,18049,269,1150,1283,2022-02-18
317107,JAKARTA PUSAT,TANAH ABANG,14843,101,13596,232,914,1015,2022-02-18
317202,JAKARTA UTARA,TANJUNG PRIOK,33811,234,30937,435,2205,2439,2022-02-18
317401,JAKARTA SELATAN,TEBET,22983,229,20713,290,1751,1980,2022-02-18
317506,JAKARTA TIMUR,CAKUNG,29214,234,26474,426,2080,2314,2022-02-19
317105,JAKARTA PUSAT,CEMPAKA PUTIH,13682,97,12496,179,910,1007,2022-02-19
317301,JAKARTA BARAT,CENGKARENG,37983,303,34522,580,2578,2881,2022-02-19
317406,JAKARTA SELATAN,CILANDAK,23870,179,21633,275,1783,1962,2022-02-19
317204,JAKARTA UTARA,CILINCING,22213,153,20093,348,1619,1772,2022-02-19
317510,JAKARTA TIMUR,CIPAYUNG,30595,201,28444,281,1669,1870,2022-02-19
317509,JAKARTA TIMUR,CIRACAS,27820,158,25649,394,1619,1777,2022-02-19
317507,JAKARTA TIMUR,DUREN SAWIT,38999,295,35107,631,2966,3261,2022-02-19
317101,JAKARTA PUSAT,GAMBIR,11430,76,10579,143,632,708,2022-02-19
317302,JAKARTA BARAT,GROGOL PETAMBURAN,26869,248,24374,312,1935,2183,2022-02-19
317409,JAKARTA SELATAN,JAGAKARSA,33536,251,30738,422,2125,2376,2022-02-19
317503,JAKARTA TIMUR,JATINEGARA,25842,204,23467,404,1767,1971,2022-02-19
317108,JAKARTA PUSAT,JOHAR BARU,11673,61,10812,170,630,691,2022-02-19
317306,JAKARTA BARAT,KALI DERES,24525,246,21891,328,2060,2306,2022-02-19
317407,JAKARTA SELATAN,KEBAYORAN BARU,18302,130,16726,195,1251,1381,2022-02-19
317405,JAKARTA SELATAN,KEBAYORAN LAMA,27243,198,24691,381,1973,2171,2022-02-19
317305,JAKARTA BARAT,KEBON JERUK,31465,275,28363,400,2427,2702,2022-02-19
317206,JAKARTA UTARA,KELAPA GADING,18593,201,16463,199,1730,1931,2022-02-19
317103,JAKARTA PUSAT,KEMAYORAN,25799,150,23812,396,1441,1591,2022-02-19
317308,JAKARTA BARAT,KEMBANGAN,27478,229,24794,318,2137,2366,2022-02-19
310102,KAB.ADM.KEP.SERIBU,KEP. SERIBU SELATAN,734,2,717,10,5,7,2022-02-19
310101,KAB.ADM.KEP.SERIBU,KEP. SERIBU UTARA,703,2,660,6,35,37,2022-02-19
317203,JAKARTA UTARA,KOJA,21880,130,20146,349,1255,1385,2022-02-19
317504,JAKARTA TIMUR,KRAMAT JATI,27285,199,25159,410,1517,1716,2022-02-19
111111,LUAR DKI JAKARTA,LUAR DKI JAKARTA,91872,1,91146,615,110,111,2022-02-19
317508,JAKARTA TIMUR,MAKASAR,22761,287,20533,309,1632,1919,2022-02-19
317403,JAKARTA SELATAN,MAMPANG PRAPATAN,15457,71,14268,183,935,1006,2022-02-19
317501,JAKARTA TIMUR,MATRAMAN,18663,127,17186,292,1058,1185,2022-02-19
317106,JAKARTA PUSAT,MENTENG,8861,62,8089,126,584,646,2022-02-19
317205,JAKARTA UTARA,PADEMANGAN,16626,90,15543,174,819,909,2022-02-19
317307,JAKARTA BARAT,PALMERAH,20763,138,19130,347,1148,1286,2022-02-19
317408,JAKARTA SELATAN,PANCORAN,19299,138,17575,235,1351,1489,2022-02-19
317404,JAKARTA SELATAN,PASAR MINGGU,31435,212,28505,438,2280,2492,2022-02-19
317505,JAKARTA TIMUR,PASAR REBO,21659,153,19901,335,1270,1423,2022-02-19
317201,JAKARTA UTARA,PENJARINGAN,26784,237,24364,243,1940,2177,2022-02-19
317410,JAKARTA SELATAN,PESANGGRAHAN,21381,136,19678,265,1302,1438,2022-02-19
111111,PROSES UPDATE DATA,PROSES UPDATE DATA,72894,917,67799,870,3308,4225,2022-02-19
317502,JAKARTA TIMUR,PULO GADUNG,29765,259,26664,422,2420,2679,2022-02-19
317102,JAKARTA PUSAT,SAWAH BESAR,12823,79,11815,180,749,828,2022-02-19
317104,JAKARTA PUSAT,SENEN,12477,100,11431,173,773,873,2022-02-19
317402,JAKARTA SELATAN,SETIA BUDI,15923,95,14528,187,1113,1208,2022-02-19
317303,JAKARTA BARAT,TAMAN SARI,12356,66,11460,147,683,749,2022-02-19
317304,JAKARTA BARAT,TAMBORA,19724,104,18247,269,1104,1208,2022-02-19
317107,JAKARTA PUSAT,TANAH ABANG,14932,92,13769,233,838,930,2022-02-19
317202,JAKARTA UTARA,TANJUNG PRIOK,34134,226,31287,435,2186,2412,2022-02-19
317401,JAKARTA SELATAN,TEBET,23209,190,21011,291,1717,1907,2022-02-19
317506,JAKARTA TIMUR,CAKUNG,29496,221,26919,426,1930,2151,2022-02-20
317105,JAKARTA PUSAT,CEMPAKA PUTIH,13783,98,12667,179,839,937,2022-02-20
317301,JAKARTA BARAT,CENGKARENG,38274,320,34956,582,2416,2736,2022-02-20
317406,JAKARTA SELATAN,CILANDAK,24065,203,21895,275,1692,1895,2022-02-20
317204,JAKARTA UTARA,CILINCING,22326,161,20412,350,1403,1564,2022-02-20
317510,JAKARTA TIMUR,CIPAYUNG,30811,199,28657,281,1674,1873,2022-02-20
317509,JAKARTA TIMUR,CIRACAS,28082,150,25825,394,1713,1863,2022-02-20
317507,JAKARTA TIMUR,DUREN SAWIT,39468,305,35660,634,2869,3174,2022-02-20
317101,JAKARTA PUSAT,GAMBIR,11506,80,10684,143,599,679,2022-02-20
317302,JAKARTA BARAT,GROGOL PETAMBURAN,27123,249,24732,313,1829,2078,2022-02-20
317409,JAKARTA SELATAN,JAGAKARSA,33850,248,31132,425,2045,2293,2022-02-20
317503,JAKARTA TIMUR,JATINEGARA,26070,186,23851,405,1628,1814,2022-02-20
317108,JAKARTA PUSAT,JOHAR BARU,11732,53,10899,171,609,662,2022-02-20
317306,JAKARTA BARAT,KALI DERES,24693,234,22266,328,1865,2099,2022-02-20
317407,JAKARTA SELATAN,KEBAYORAN BARU,18403,113,16891,195,1204,1317,2022-02-20
317405,JAKARTA SELATAN,KEBAYORAN LAMA,27506,203,25053,381,1869,2072,2022-02-20
317305,JAKARTA BARAT,KEBON JERUK,31744,288,28776,401,2279,2567,2022-02-20
317206,JAKARTA UTARA,KELAPA GADING,18826,219,16750,200,1657,1876,2022-02-20
317103,JAKARTA PUSAT,KEMAYORAN,25933,155,24104,396,1278,1433,2022-02-20
317308,JAKARTA BARAT,KEMBANGAN,27635,233,25213,319,1870,2103,2022-02-20
310102,KAB.ADM.KEP.SERIBU,KEP. SERIBU SELATAN,734,2,719,10,3,5,2022-02-20
310101,KAB.ADM.KEP.SERIBU,KEP. SERIBU UTARA,712,3,663,6,40,43,2022-02-20
317203,JAKARTA UTARA,KOJA,21993,128,20502,349,1014,1142,2022-02-20
317504,JAKARTA TIMUR,KRAMAT JATI,27552,186,25400,411,1555,1741,2022-02-20
111111,LUAR DKI JAKARTA,LUAR DKI JAKARTA,91879,2,91180,615,82,84,2022-02-20
317508,JAKARTA TIMUR,MAKASAR,22974,199,20823,309,1643,1842,2022-02-20
317403,JAKARTA SELATAN,MAMPANG PRAPATAN,15550,67,14472,184,827,894,2022-02-20
317501,JAKARTA TIMUR,MATRAMAN,18775,119,17437,294,925,1044,2022-02-20
317106,JAKARTA PUSAT,MENTENG,8921,69,8218,127,507,576,2022-02-20
317205,JAKARTA UTARA,PADEMANGAN,16693,100,15699,174,720,820,2022-02-20
317307,JAKARTA BARAT,PALMERAH,20896,127,19360,347,1062,1189,2022-02-20
317408,JAKARTA SELATAN,PANCORAN,19512,140,17849,235,1288,1428,2022-02-20
317404,JAKARTA SELATAN,PASAR MINGGU,31704,218,28872,438,2176,2394,2022-02-20
317505,JAKARTA TIMUR,PASAR REBO,21874,141,20081,335,1317,1458,2022-02-20
317201,JAKARTA UTARA,PENJARINGAN,27008,256,24689,244,1819,2075,2022-02-20
317410,JAKARTA SELATAN,PESANGGRAHAN,21524,131,19913,265,1215,1346,2022-02-20
111111,PROSES UPDATE DATA,PROSES UPDATE DATA,73510,875,68241,870,3524,4399,2022-02-20
317502,JAKARTA TIMUR,PULO GADUNG,30006,228,27156,424,2198,2426,2022-02-20
317102,JAKARTA PUSAT,SAWAH BESAR,12905,105,11935,181,684,789,2022-02-20
317104,JAKARTA PUSAT,SENEN,12563,108,11587,173,695,803,2022-02-20
317402,JAKARTA SELATAN,SETIA BUDI,16020,103,14716,187,1014,1117,2022-02-20
317303,JAKARTA BARAT,TAMAN SARI,12431,77,11577,149,628,705,2022-02-20
317304,JAKARTA BARAT,TAMBORA,19814,109,18398,270,1037,1146,2022-02-20
317107,JAKARTA PUSAT,TANAH ABANG,15013,96,13901,234,782,878,2022-02-20
317202,JAKARTA UTARA,TANJUNG PRIOK,34380,233,31666,436,2045,2278,2022-02-20
317401,JAKARTA SELATAN,TEBET,23398,193,21322,293,1590,1783,2022-02-20
317506,JAKARTA TIMUR,CAKUNG,29605,192,27319,427,1667,1859,2022-02-21
317105,JAKARTA PUSAT,CEMPAKA PUTIH,13835,97,12802,179,757,854,2022-02-21
317301,JAKARTA BARAT,CENGKARENG,38449,333,35354,583,2179,2512,2022-02-21
317406,JAKARTA SELATAN,CILANDAK,24258,175,22238,277,1568,1743,2022-02-21
317204,JAKARTA UTARA,CILINCING,22400,158,20757,350,1135,1293,2022-02-21
317510,JAKARTA TIMUR,CIPAYUNG,30933,185,29133,281,1334,1519,2022-02-21
317509,JAKARTA TIMUR,CIRACAS,28193,123,26182,394,1494,1617,2022-02-21
317507,JAKARTA TIMUR,DUREN SAWIT,39731,297,36171,636,2627,2924,2022-02-21
317101,JAKARTA PUSAT,GAMBIR,11550,69,10807,144,530,599,2022-02-21
317302,JAKARTA BARAT,GROGOL PETAMBURAN,27261,249,25052,313,1647,1896,2022-02-21
317409,JAKARTA SELATAN,JAGAKARSA,34113,221,31601,425,1866,2087,2022-02-21
317503,JAKARTA TIMUR,JATINEGARA,26186,168,24140,407,1471,1639,2022-02-21
317108,JAKARTA PUSAT,JOHAR BARU,11759,54,11042,172,491,545,2022-02-21
317306,JAKARTA BARAT,KALI DERES,24891,264,22693,329,1605,1869,2022-02-21
317407,JAKARTA SELATAN,KEBAYORAN BARU,18508,111,17107,196,1094,1205,2022-02-21
317405,JAKARTA SELATAN,KEBAYORAN LAMA,27680,194,25465,381,1640,1834,2022-02-21
317305,JAKARTA BARAT,KEBON JERUK,31896,277,29163,404,2052,2329,2022-02-21
317206,JAKARTA UTARA,KELAPA GADING,18969,183,16996,200,1590,1773,2022-02-21
317103,JAKARTA PUSAT,KEMAYORAN,26033,149,24355,396,1133,1282,2022-02-21
317308,JAKARTA BARAT,KEMBANGAN,27786,217,25546,319,1704,1921,2022-02-21
310102,KAB.ADM.KEP.SERIBU,KEP. SERIBU SELATAN,738,2,721,10,5,7,2022-02-21
310101,KAB.ADM.KEP.SERIBU,KEP. SERIBU UTARA,712,3,671,6,32,35,2022-02-21
317203,JAKARTA UTARA,KOJA,22058,126,20709,349,874,1000,2022-02-21
317504,JAKARTA TIMUR,KRAMAT JATI,27678,180,25613,412,1473,1653,2022-02-21
111111,LUAR DKI JAKARTA,LUAR DKI JAKARTA,91909,6,91210,615,78,84,2022-02-21
317508,JAKARTA TIMUR,MAKASAR,23075,203,21101,309,1462,1665,2022-02-21
317403,JAKARTA SELATAN,MAMPANG PRAPATAN,15610,50,14626,184,750,800,2022-02-21
317501,JAKARTA TIMUR,MATRAMAN,18841,115,17590,295,841,956,2022-02-21
317106,JAKARTA PUSAT,MENTENG,8962,68,8330,128,436,504,2022-02-21
317205,JAKARTA UTARA,PADEMANGAN,16746,88,15815,174,669,757,2022-02-21
317307,JAKARTA BARAT,PALMERAH,20985,116,19550,347,972,1088,2022-02-21
317408,JAKARTA SELATAN,PANCORAN,19644,123,18094,236,1191,1314,2022-02-21
317404,JAKARTA SELATAN,PASAR MINGGU,31906,183,29262,440,2021,2204,2022-02-21
317505,JAKARTA TIMUR,PASAR REBO,21969,117,20243,335,1274,1391,2022-02-21
317201,JAKARTA UTARA,PENJARINGAN,27189,277,25026,244,1642,1919,2022-02-21
317410,JAKARTA SELATAN,PESANGGRAHAN,21694,120,20125,265,1184,1304,2022-02-21
111111,PROSES UPDATE DATA,PROSES UPDATE DATA,73979,425,68720,870,3964,4389,2022-02-21
317502,JAKARTA TIMUR,PULO GADUNG,30160,214,27499,424,2023,2237,2022-02-21
317102,JAKARTA PUSAT,SAWAH BESAR,12954,107,12069,182,596,703,2022-02-21
317104,JAKARTA PUSAT,SENEN,12591,103,11700,173,615,718,2022-02-21
317402,JAKARTA SELATAN,SETIA BUDI,16084,92,14947,187,858,950,2022-02-21
317303,JAKARTA BARAT,TAMAN SARI,12467,83,11707,150,527,610,2022-02-21
317304,JAKARTA BARAT,TAMBORA,19898,119,18594,270,915,1034,2022-02-21
317107,JAKARTA PUSAT,TANAH ABANG,15076,77,14065,234,700,777,2022-02-21
317202,JAKARTA UTARA,TANJUNG PRIOK,34556,237,32091,436,1792,2029,2022-02-21
317401,JAKARTA SELATAN,TEBET,23508,152,21583,294,1479,1631,2022-02-21
317506,JAKARTA TIMUR,CAKUNG,29721,186,27554,430,1551,1737,2022-02-22
317105,JAKARTA PUSAT,CEMPAKA PUTIH,13900,96,12947,180,677,773,2022-02-22
317301,JAKARTA BARAT,CENGKARENG,38694,321,35685,585,2103,2424,2022-02-22
317406,JAKARTA SELATAN,CILANDAK,24397,178,22462,278,1479,1657,2022-02-22
317204,JAKARTA UTARA,CILINCING,22525,145,20928,351,1101,1246,2022-02-22
317510,JAKARTA TIMUR,CIPAYUNG,31048,181,29264,283,1320,1501,2022-02-22
317509,JAKARTA TIMUR,CIRACAS,28302,122,26349,394,1437,1559,2022-02-22
317507,JAKARTA TIMUR,DUREN SAWIT,39986,283,36516,637,2550,2833,2022-02-22
317101,JAKARTA PUSAT,GAMBIR,11589,70,10881,144,494,564,2022-02-22
317302,JAKARTA BARAT,GROGOL PETAMBURAN,27388,242,25355,315,1476,1718,2022-02-22
317409,JAKARTA SELATAN,JAGAKARSA,34252,211,31863,425,1753,1964,2022-02-22
317503,JAKARTA TIMUR,JATINEGARA,26296,155,24350,407,1384,1539,2022-02-22
317108,JAKARTA PUSAT,JOHAR BARU,11788,53,11142,172,421,474,2022-02-22
317306,JAKARTA BARAT,KALI DERES,25074,241,22932,329,1572,1813,2022-02-22
317407,JAKARTA SELATAN,KEBAYORAN BARU,18610,101,17248,196,1065,1166,2022-02-22
317405,JAKARTA SELATAN,KEBAYORAN LAMA,27865,181,25728,384,1572,1753,2022-02-22
317305,JAKARTA BARAT,KEBON JERUK,32043,267,29455,404,1917,2184,2022-02-22
317206,JAKARTA UTARA,KELAPA GADING,19101,175,17276,201,1449,1624,2022-02-22
317103,JAKARTA PUSAT,KEMAYORAN,26123,149,24536,396,1042,1191,2022-02-22
317308,JAKARTA BARAT,KEMBANGAN,28024,199,25826,320,1679,1878,2022-02-22
310102,KAB.ADM.KEP.SERIBU,KEP. SERIBU SELATAN,738,2,721,10,5,7,2022-02-22
310101,KAB.ADM.KEP.SERIBU,KEP. SERIBU UTARA,717,3,676,6,32,35,2022-02-22
317203,JAKARTA UTARA,KOJA,22136,122,20859,349,806,928,2022-02-22
317504,JAKARTA TIMUR,KRAMAT JATI,27784,167,25822,414,1381,1548,2022-02-22
111111,LUAR DKI JAKARTA,LUAR DKI JAKARTA,91928,7,91228,615,78,85,2022-02-22
317508,JAKARTA TIMUR,MAKASAR,23185,197,21281,309,1398,1595,2022-02-22
317403,JAKARTA SELATAN,MAMPANG PRAPATAN,15648,49,14707,184,708,757,2022-02-22
317501,JAKARTA TIMUR,MATRAMAN,18930,114,17731,295,790,904,2022-02-22
317106,JAKARTA PUSAT,MENTENG,8997,66,8408,128,395,461,2022-02-22
317205,JAKARTA UTARA,PADEMANGAN,16795,84,15904,174,633,717,2022-02-22
317307,JAKARTA BARAT,PALMERAH,21040,104,19710,347,879,983,2022-02-22
317408,JAKARTA SELATAN,PANCORAN,19748,124,18257,237,1130,1254,2022-02-22
317404,JAKARTA SELATAN,PASAR MINGGU,32093,176,29595,442,1880,2056,2022-02-22
317505,JAKARTA TIMUR,PASAR REBO,22073,116,20382,336,1239,1355,2022-02-22
317201,JAKARTA UTARA,PENJARINGAN,27361,243,25328,244,1546,1789,2022-02-22
317410,JAKARTA SELATAN,PESANGGRAHAN,21783,113,20286,265,1119,1232,2022-02-22
111111,PROSES UPDATE DATA,PROSES UPDATE DATA,74503,664,69265,871,3703,4367,2022-02-22
317502,JAKARTA TIMUR,PULO GADUNG,30325,218,27904,428,1775,1993,2022-02-22
317102,JAKARTA PUSAT,SAWAH BESAR,12999,108,12160,182,549,657,2022-02-22
317104,JAKARTA PUSAT,SENEN,12633,99,11800,173,561,660,2022-02-22
317402,JAKARTA SELATAN,SETIA BUDI,16157,90,15062,187,818,908,2022-02-22
317303,JAKARTA BARAT,TAMAN SARI,12498,82,11789,150,477,559,2022-02-22
317304,JAKARTA BARAT,TAMBORA,19973,117,18773,270,813,930,2022-02-22
317107,JAKARTA PUSAT,TANAH ABANG,15124,69,14186,234,635,704,2022-02-22
317202,JAKARTA UTARA,TANJUNG PRIOK,34700,213,32357,438,1692,1905,2022-02-22
317401,JAKARTA SELATAN,TEBET,23639,151,21784,296,1408,1559,2022-02-22
317506,JAKARTA TIMUR,CAKUNG,29924,176,27723,431,1594,1770,2022-02-23
317105,JAKARTA PUSAT,CEMPAKA PUTIH,13997,99,13023,180,695,794,2022-02-23
317301,JAKARTA BARAT,CENGKARENG,38902,325,36003,588,1986,2311,2022-02-23
317406,JAKARTA SELATAN,CILANDAK,24615,185,22692,280,1458,1643,2022-02-23
317204,JAKARTA UTARA,CILINCING,22636,154,21050,352,1080,1234,2022-02-23
317510,JAKARTA TIMUR,CIPAYUNG,31303,185,29388,284,1446,1631,2022-02-23
317509,JAKARTA TIMUR,CIRACAS,28504,134,26477,397,1496,1630,2022-02-23
317507,JAKARTA TIMUR,DUREN SAWIT,40397,267,36808,640,2682,2949,2022-02-23
317101,JAKARTA PUSAT,GAMBIR,11657,76,10943,147,491,567,2022-02-23
317302,JAKARTA BARAT,GROGOL PETAMBURAN,27570,236,25551,316,1467,1703,2022-02-23
317409,JAKARTA SELATAN,JAGAKARSA,34450,210,32059,430,1751,1961,2022-02-23
317503,JAKARTA TIMUR,JATINEGARA,26485,131,24511,407,1436,1567,2022-02-23
317108,JAKARTA PUSAT,JOHAR BARU,11837,50,11199,173,415,465,2022-02-23
317306,JAKARTA BARAT,KALI DERES,25284,219,23173,329,1563,1782,2022-02-23
317407,JAKARTA SELATAN,KEBAYORAN BARU,18731,104,17380,199,1048,1152,2022-02-23
317405,JAKARTA SELATAN,KEBAYORAN LAMA,28026,171,25902,385,1568,1739,2022-02-23
317305,JAKARTA BARAT,KEBON JERUK,32277,290,29683,406,1898,2188,2022-02-23
317206,JAKARTA UTARA,KELAPA GADING,19298,167,17453,202,1476,1643,2022-02-23
317103,JAKARTA PUSAT,KEMAYORAN,26278,154,24674,396,1054,1208,2022-02-23
317308,JAKARTA BARAT,KEMBANGAN,28235,194,26046,321,1674,1868,2022-02-23
310102,KAB.ADM.KEP.SERIBU,KEP. SERIBU SELATAN,745,2,721,10,12,14,2022-02-23
310101,KAB.ADM.KEP.SERIBU,KEP. SERIBU UTARA,718,4,678,6,30,34,2022-02-23
317203,JAKARTA UTARA,KOJA,22251,122,20957,349,823,945,2022-02-23
317504,JAKARTA TIMUR,KRAMAT JATI,27993,160,25952,416,1465,1625,2022-02-23
111111,LUAR DKI JAKARTA,LUAR DKI JAKARTA,91944,6,91251,615,72,78,2022-02-23
317508,JAKARTA TIMUR,MAKASAR,23374,190,21434,310,1440,1630,2022-02-23
317403,JAKARTA SELATAN,MAMPANG PRAPATAN,15728,45,14776,184,723,768,2022-02-23
317501,JAKARTA TIMUR,MATRAMAN,19049,110,17815,295,829,939,2022-02-23
317106,JAKARTA PUSAT,MENTENG,9051,70,8454,128,399,469,2022-02-23
317205,JAKARTA UTARA,PADEMANGAN,16867,89,15998,174,606,695,2022-02-23
317307,JAKARTA BARAT,PALMERAH,21186,99,19819,348,920,1019,2022-02-23
317408,JAKARTA SELATAN,PANCORAN,19911,107,18381,238,1185,1292,2022-02-23
317404,JAKARTA SELATAN,PASAR MINGGU,32299,168,29805,445,1881,2049,2022-02-23
317505,JAKARTA TIMUR,PASAR REBO,22288,123,20474,336,1355,1478,2022-02-23
317201,JAKARTA UTARA,PENJARINGAN,27572,246,25514,245,1567,1813,2022-02-23
317410,JAKARTA SELATAN,PESANGGRAHAN,21908,101,20415,267,1125,1226,2022-02-23
111111,PROSES UPDATE DATA,PROSES UPDATE DATA,75105,589,69850,871,3795,4384,2022-02-23
317502,JAKARTA TIMUR,PULO GADUNG,30551,204,28134,429,1784,1988,2022-02-23
317102,JAKARTA PUSAT,SAWAH BESAR,13078,109,12227,182,560,669,2022-02-23
317104,JAKARTA PUSAT,SENEN,12708,97,11888,173,550,647,2022-02-23
317402,JAKARTA SELATAN,SETIA BUDI,16267,93,15173,188,813,906,2022-02-23
317303,JAKARTA BARAT,TAMAN SARI,12536,89,11852,152,443,532,2022-02-23
317304,JAKARTA BARAT,TAMBORA,20050,115,18892,273,770,885,2022-02-23
317107,JAKARTA PUSAT,TANAH ABANG,15194,68,14252,235,639,707,2022-02-23
317202,JAKARTA UTARA,TANJUNG PRIOK,34898,216,32622,438,1622,1838,2022-02-23
317401,JAKARTA SELATAN,TEBET,23851,143,21982,296,1430,1573,2022-02-23
317506,JAKARTA TIMUR,CAKUNG,30082,167,28107,433,1375,1542,2022-02-24
317105,JAKARTA PUSAT,CEMPAKA PUTIH,14080,91,13209,182,598,689,2022-02-24
317301,JAKARTA BARAT,CENGKARENG,39096,278,36482,590,1746,2024,2022-02-24
317406,JAKARTA SELATAN,CILANDAK,24813,164,22962,280,1407,1571,2022-02-24
317204,JAKARTA UTARA,CILINCING,22795,143,21258,353,1041,1184,2022-02-24
317510,JAKARTA TIMUR,CIPAYUNG,31514,184,29725,287,1318,1502,2022-02-24
317509,JAKARTA TIMUR,CIRACAS,28675,131,26846,399,1299,1430,2022-02-24
317507,JAKARTA TIMUR,DUREN SAWIT,40716,246,37303,643,2524,2770,2022-02-24
317101,JAKARTA PUSAT,GAMBIR,11700,70,11069,148,413,483,2022-02-24
317302,JAKARTA BARAT,GROGOL PETAMBURAN,27762,220,25867,318,1357,1577,2022-02-24
317409,JAKARTA SELATAN,JAGAKARSA,34649,217,32343,432,1657,1874,2022-02-24
317503,JAKARTA TIMUR,JATINEGARA,26663,138,24818,411,1296,1434,2022-02-24
317108,JAKARTA PUSAT,JOHAR BARU,11888,46,11312,173,357,403,2022-02-24
317306,JAKARTA BARAT,KALI DERES,25475,188,23492,330,1465,1653,2022-02-24
317407,JAKARTA SELATAN,KEBAYORAN BARU,18801,85,17564,200,952,1037,2022-02-24
317405,JAKARTA SELATAN,KEBAYORAN LAMA,28206,163,26186,386,1471,1634,2022-02-24
317305,JAKARTA BARAT,KEBON JERUK,32504,280,30148,408,1668,1948,2022-02-24
317206,JAKARTA UTARA,KELAPA GADING,19496,168,17755,202,1371,1539,2022-02-24
317103,JAKARTA PUSAT,KEMAYORAN,26404,153,24957,396,898,1051,2022-02-24
317308,JAKARTA BARAT,KEMBANGAN,28496,178,26409,322,1587,1765,2022-02-24
310102,KAB.ADM.KEP.SERIBU,KEP. SERIBU SELATAN,746,2,722,10,12,14,2022-02-24
310101,KAB.ADM.KEP.SERIBU,KEP. SERIBU UTARA,724,4,680,6,34,38,2022-02-24
317203,JAKARTA UTARA,KOJA,22342,107,21175,349,711,818,2022-02-24
317504,JAKARTA TIMUR,KRAMAT JATI,28179,158,26286,417,1318,1476,2022-02-24
111111,LUAR DKI JAKARTA,LUAR DKI JAKARTA,91998,10,91272,615,101,111,2022-02-24
317508,JAKARTA TIMUR,MAKASAR,23536,180,21784,312,1260,1440,2022-02-24
317403,JAKARTA SELATAN,MAMPANG PRAPATAN,15819,40,14964,185,630,670,2022-02-24
317501,JAKARTA TIMUR,MATRAMAN,19165,101,17981,295,788,889,2022-02-24
317106,JAKARTA PUSAT,MENTENG,9114,69,8551,128,366,435,2022-02-24
317205,JAKARTA UTARA,PADEMANGAN,16946,90,16132,176,548,638,2022-02-24
317307,JAKARTA BARAT,PALMERAH,21273,106,20023,349,795,901,2022-02-24
317408,JAKARTA SELATAN,PANCORAN,20061,109,18564,239,1149,1258,2022-02-24
317404,JAKARTA SELATAN,PASAR MINGGU,32481,170,30147,445,1719,1889,2022-02-24
317505,JAKARTA TIMUR,PASAR REBO,22472,118,20780,337,1237,1355,2022-02-24
317201,JAKARTA UTARA,PENJARINGAN,27734,224,25820,245,1445,1669,2022-02-24
317410,JAKARTA SELATAN,PESANGGRAHAN,22006,104,20621,268,1013,1117,2022-02-24
111111,PROSES UPDATE DATA,PROSES UPDATE DATA,75801,824,70550,871,3556,4380,2022-02-24
317502,JAKARTA TIMUR,PULO GADUNG,30823,183,28527,431,1682,1865,2022-02-24
317102,JAKARTA PUSAT,SAWAH BESAR,13135,111,12360,182,482,593,2022-02-24
317104,JAKARTA PUSAT,SENEN,12787,98,12038,173,478,576,2022-02-24
317402,JAKARTA SELATAN,SETIA BUDI,16380,80,15376,189,735,815,2022-02-24
317303,JAKARTA BARAT,TAMAN SARI,12589,89,11945,152,403,492,2022-02-24
317304,JAKARTA BARAT,TAMBORA,20129,102,19090,274,663,765,2022-02-24
317107,JAKARTA PUSAT,TANAH ABANG,15243,66,14412,235,530,596,2022-02-24
317202,JAKARTA UTARA,TANJUNG PRIOK,35083,205,32947,440,1491,1696,2022-02-24
317401,JAKARTA SELATAN,TEBET,24002,133,22268,297,1304,1437,2022-02-24
317506,JAKARTA TIMUR,CAKUNG,30207,152,28358,434,1263,1415,2022-02-25
317105,JAKARTA PUSAT,CEMPAKA PUTIH,14127,90,13300,182,555,645,2022-02-25
317301,JAKARTA BARAT,CENGKARENG,39213,269,36781,591,1572,1841,2022-02-25
317406,JAKARTA SELATAN,CILANDAK,24918,168,23199,282,1269,1437,2022-02-25
317204,JAKARTA UTARA,CILINCING,22887,128,21450,353,956,1084,2022-02-25
317510,JAKARTA TIMUR,CIPAYUNG,31676,173,29885,289,1329,1502,2022-02-25
317509,JAKARTA TIMUR,CIRACAS,28786,128,27036,400,1222,1350,2022-02-25
317507,JAKARTA TIMUR,DUREN SAWIT,40987,238,37680,646,2423,2661,2022-02-25
317101,JAKARTA PUSAT,GAMBIR,11734,66,11159,149,360,426,2022-02-25
317302,JAKARTA BARAT,GROGOL PETAMBURAN,27848,224,26142,318,1164,1388,2022-02-25
317409,JAKARTA SELATAN,JAGAKARSA,34855,200,32634,434,1587,1787,2022-02-25
317503,JAKARTA TIMUR,JATINEGARA,26777,136,25034,412,1195,1331,2022-02-25
317108,JAKARTA PUSAT,JOHAR BARU,11934,43,11375,173,343,386,2022-02-25
317306,JAKARTA BARAT,KALI DERES,25577,189,23723,333,1332,1521,2022-02-25
317407,JAKARTA SELATAN,KEBAYORAN BARU,18890,84,17719,201,886,970,2022-02-25
317405,JAKARTA SELATAN,KEBAYORAN LAMA,28345,158,26417,387,1383,1541,2022-02-25
317305,JAKARTA BARAT,KEBON JERUK,32663,261,30426,410,1566,1827,2022-02-25
317206,JAKARTA UTARA,KELAPA GADING,19574,162,17987,202,1223,1385,2022-02-25
317103,JAKARTA PUSAT,KEMAYORAN,26498,155,25109,398,836,991,2022-02-25
317308,JAKARTA BARAT,KEMBANGAN,28544,177,26663,322,1382,1559,2022-02-25
310102,KAB.ADM.KEP.SERIBU,KEP. SERIBU SELATAN,748,2,722,10,14,16,2022-02-25
310101,KAB.ADM.KEP.SERIBU,KEP. SERIBU UTARA,730,3,681,6,40,43,2022-02-25
317203,JAKARTA UTARA,KOJA,22430,94,21298,349,689,783,2022-02-25
317504,JAKARTA TIMUR,KRAMAT JATI,28320,156,26486,418,1260,1416,2022-02-25
111111,LUAR DKI JAKARTA,LUAR DKI JAKARTA,92017,9,91305,615,88,97,2022-02-25
317508,JAKARTA TIMUR,MAKASAR,23609,186,21987,312,1124,1310,2022-02-25
317403,JAKARTA SELATAN,MAMPANG PRAPATAN,15864,38,15060,186,580,618,2022-02-25
317501,JAKARTA TIMUR,MATRAMAN,19227,99,18095,296,737,836,2022-02-25
317106,JAKARTA PUSAT,MENTENG,9140,74,8615,128,323,397,2022-02-25
317205,JAKARTA UTARA,PADEMANGAN,16983,81,16236,177,489,570,2022-02-25
317307,JAKARTA BARAT,PALMERAH,21314,98,20159,350,707,805,2022-02-25
317408,JAKARTA SELATAN,PANCORAN,20153,99,18726,240,1088,1187,2022-02-25
317404,JAKARTA SELATAN,PASAR MINGGU,32654,158,30422,447,1627,1785,2022-02-25
317505,JAKARTA TIMUR,PASAR REBO,22549,113,20975,337,1124,1237,2022-02-25
317201,JAKARTA UTARA,PENJARINGAN,27799,221,26083,246,1249,1470,2022-02-25
317410,JAKARTA SELATAN,PESANGGRAHAN,22128,97,20799,268,964,1061,2022-02-25
111111,PROSES UPDATE DATA,PROSES UPDATE DATA,76380,818,71139,871,3552,4370,2022-02-25
317502,JAKARTA TIMUR,PULO GADUNG,30948,171,28811,431,1535,1706,2022-02-25
317102,JAKARTA PUSAT,SAWAH BESAR,13166,96,12472,182,416,512,2022-02-25
317104,JAKARTA PUSAT,SENEN,12835,99,12118,173,445,544,2022-02-25
317402,JAKARTA SELATAN,SETIA BUDI,16441,77,15500,190,674,751,2022-02-25
317303,JAKARTA BARAT,TAMAN SARI,12619,90,12027,154,348,438,2022-02-25
317304,JAKARTA BARAT,TAMBORA,20164,90,19207,275,592,682,2022-02-25
317107,JAKARTA PUSAT,TANAH ABANG,15288,57,14527,237,467,524,2022-02-25
317202,JAKARTA UTARA,TANJUNG PRIOK,35245,186,33204,441,1414,1600,2022-02-25
317401,JAKARTA SELATAN,TEBET,24116,127,22495,300,1194,1321,2022-02-25
317506,JAKARTA TIMUR,CAKUNG,30333,127,28615,437,1154,1281,2022-02-26
317105,JAKARTA PUSAT,CEMPAKA PUTIH,14178,77,13396,182,523,600,2022-02-26
317301,JAKARTA BARAT,CENGKARENG,39359,255,37176,593,1335,1590,2022-02-26
317406,JAKARTA SELATAN,CILANDAK,25040,142,23430,283,1185,1327,2022-02-26
317204,JAKARTA UTARA,CILINCING,23017,104,21667,353,893,997,2022-02-26
317510,JAKARTA TIMUR,CIPAYUNG,31794,144,30082,290,1278,1422,2022-02-26
317509,JAKARTA TIMUR,CIRACAS,29014,114,27372,400,1128,1242,2022-02-26
317507,JAKARTA TIMUR,DUREN SAWIT,41214,199,38073,647,2295,2494,2022-02-26
317101,JAKARTA PUSAT,GAMBIR,11758,59,11224,149,326,385,2022-02-26
317302,JAKARTA BARAT,GROGOL PETAMBURAN,27954,203,26390,319,1042,1245,2022-02-26
317409,JAKARTA SELATAN,JAGAKARSA,35014,108,32939,434,1533,1641,2022-02-26
317503,JAKARTA TIMUR,JATINEGARA,26909,120,25249,413,1127,1247,2022-02-26
317108,JAKARTA PUSAT,JOHAR BARU,11972,39,11427,173,333,372,2022-02-26
317306,JAKARTA BARAT,KALI DERES,25724,169,23994,334,1227,1396,2022-02-26
317407,JAKARTA SELATAN,KEBAYORAN BARU,18970,72,17920,202,776,848,2022-02-26
317405,JAKARTA SELATAN,KEBAYORAN LAMA,28451,140,26679,388,1244,1384,2022-02-26
317305,JAKARTA BARAT,KEBON JERUK,32785,247,30751,411,1376,1623,2022-02-26
317206,JAKARTA UTARA,KELAPA GADING,19693,144,18184,204,1161,1305,2022-02-26
317103,JAKARTA PUSAT,KEMAYORAN,26590,146,25232,399,813,959,2022-02-26
317308,JAKARTA BARAT,KEMBANGAN,28668,170,26904,324,1270,1440,2022-02-26
310102,KAB.ADM.KEP.SERIBU,KEP. SERIBU SELATAN,748,2,722,10,14,16,2022-02-26
310101,KAB.ADM.KEP.SERIBU,KEP. SERIBU UTARA,733,3,694,6,30,33,2022-02-26
317203,JAKARTA UTARA,KOJA,22490,80,21420,349,641,721,2022-02-26
317504,JAKARTA TIMUR,KRAMAT JATI,28417,136,26695,419,1167,1303,2022-02-26
111111,LUAR DKI JAKARTA,LUAR DKI JAKARTA,92027,6,91324,615,82,88,2022-02-26
317508,JAKARTA TIMUR,MAKASAR,23681,163,22211,312,995,1158,2022-02-26
317403,JAKARTA SELATAN,MAMPANG PRAPATAN,15898,37,15159,186,516,553,2022-02-26
317501,JAKARTA TIMUR,MATRAMAN,19306,91,18210,296,709,800,2022-02-26
317106,JAKARTA PUSAT,MENTENG,9174,67,8672,128,307,374,2022-02-26
317205,JAKARTA UTARA,PADEMANGAN,17032,85,16370,177,400,485,2022-02-26
317307,JAKARTA BARAT,PALMERAH,21359,91,20287,350,631,722,2022-02-26
317408,JAKARTA SELATAN,PANCORAN,20238,92,18908,240,998,1090,2022-02-26
317404,JAKARTA SELATAN,PASAR MINGGU,32782,142,30764,447,1429,1571,2022-02-26
317505,JAKARTA TIMUR,PASAR REBO,22673,95,21135,337,1106,1201,2022-02-26
317201,JAKARTA UTARA,PENJARINGAN,27909,206,26345,247,1111,1317,2022-02-26
317410,JAKARTA SELATAN,PESANGGRAHAN,22216,82,21004,270,860,942,2022-02-26
111111,PROSES UPDATE DATA,PROSES UPDATE DATA,76981,861,71782,871,3467,4328,2022-02-26
317502,JAKARTA TIMUR,PULO GADUNG,31093,145,29073,432,1443,1588,2022-02-26
317102,JAKARTA PUSAT,SAWAH BESAR,13207,93,12562,183,369,462,2022-02-26
317104,JAKARTA PUSAT,SENEN,12877,91,12197,173,416,507,2022-02-26
317402,JAKARTA SELATAN,SETIA BUDI,16500,71,15610,191,628,699,2022-02-26
317303,JAKARTA BARAT,TAMAN SARI,12662,87,12115,156,304,391,2022-02-26
317304,JAKARTA BARAT,TAMBORA,20219,84,19350,276,509,593,2022-02-26
317107,JAKARTA PUSAT,TANAH ABANG,15330,59,14614,237,420,479,2022-02-26
317202,JAKARTA UTARA,TANJUNG PRIOK,35382,174,33488,442,1278,1452,2022-02-26
317401,JAKARTA SELATAN,TEBET,24211,102,22702,300,1107,1209,2022-02-26
317506,JAKARTA TIMUR,CAKUNG,29971,116,28375,438,1042,1158,2022-02-27
317105,JAKARTA PUSAT,CEMPAKA PUTIH,14059,76,13343,182,458,534,2022-02-27
317301,JAKARTA BARAT,CENGKARENG,38836,198,36888,594,1156,1354,2022-02-27
317406,JAKARTA SELATAN,CILANDAK,24717,144,23217,283,1073,1217,2022-02-27
317204,JAKARTA UTARA,CILINCING,22817,91,21613,354,759,850,2022-02-27
317510,JAKARTA TIMUR,CIPAYUNG,31600,116,30040,291,1153,1269,2022-02-27
317509,JAKARTA TIMUR,CIRACAS,28808,113,27287,400,1008,1121,2022-02-27
317507,JAKARTA TIMUR,DUREN SAWIT,40800,179,37925,648,2048,2227,2022-02-27
317101,JAKARTA PUSAT,GAMBIR,11601,60,11102,149,290,350,2022-02-27
317302,JAKARTA BARAT,GROGOL PETAMBURAN,27601,183,26136,319,963,1146,2022-02-27
317409,JAKARTA SELATAN,JAGAKARSA,34757,108,32829,434,1386,1494,2022-02-27
317503,JAKARTA TIMUR,JATINEGARA,26575,109,25033,414,1019,1128,2022-02-27
317108,JAKARTA PUSAT,JOHAR BARU,11811,36,11329,174,272,308,2022-02-27
317306,JAKARTA BARAT,KALI DERES,25409,137,23846,334,1092,1229,2022-02-27
317407,JAKARTA SELATAN,KEBAYORAN BARU,18764,74,17815,203,672,746,2022-02-27
317405,JAKARTA SELATAN,KEBAYORAN LAMA,28128,116,26535,388,1089,1205,2022-02-27
317305,JAKARTA BARAT,KEBON JERUK,32295,225,30473,411,1186,1411,2022-02-27
317206,JAKARTA UTARA,KELAPA GADING,19397,156,18028,204,1009,1165,2022-02-27
317103,JAKARTA PUSAT,KEMAYORAN,26285,121,25071,399,694,815,2022-02-27
317308,JAKARTA BARAT,KEMBANGAN,28346,154,26735,324,1133,1287,2022-02-27
310102,KAB.ADM.KEP.SERIBU,KEP. SERIBU SELATAN,746,0,722,10,14,14,2022-02-27
310101,KAB.ADM.KEP.SERIBU,KEP. SERIBU UTARA,732,3,694,6,29,32,2022-02-27
317203,JAKARTA UTARA,KOJA,22226,58,21250,349,569,627,2022-02-27
317504,JAKARTA TIMUR,KRAMAT JATI,28134,117,26541,420,1056,1173,2022-02-27
111111,LUAR DKI JAKARTA,LUAR DKI JAKARTA,91956,6,91239,615,96,102,2022-02-27
317508,JAKARTA TIMUR,MAKASAR,23405,131,22084,312,878,1009,2022-02-27
317403,JAKARTA SELATAN,MAMPANG PRAPATAN,15688,39,15002,186,461,500,2022-02-27
317501,JAKARTA TIMUR,MATRAMAN,19049,70,18054,299,626,696,2022-02-27
317106,JAKARTA PUSAT,MENTENG,9043,67,8572,129,275,342,2022-02-27
317205,JAKARTA UTARA,PADEMANGAN,16768,73,16160,179,356,429,2022-02-27
317307,JAKARTA BARAT,PALMERAH,21057,90,20075,351,541,631,2022-02-27
317408,JAKARTA SELATAN,PANCORAN,19956,85,18752,240,879,964,2022-02-27
317404,JAKARTA SELATAN,PASAR MINGGU,32432,135,30549,447,1301,1436,2022-02-27
317505,JAKARTA TIMUR,PASAR REBO,22529,95,21113,338,983,1078,2022-02-27
317201,JAKARTA UTARA,PENJARINGAN,27384,191,25976,248,969,1160,2022-02-27
317410,JAKARTA SELATAN,PESANGGRAHAN,22039,78,20891,270,800,878,2022-02-27
111111,PROSES UPDATE DATA,PROSES UPDATE DATA,92924,1033,87801,872,3218,4251,2022-02-27
317502,JAKARTA TIMUR,PULO GADUNG,30717,144,28860,435,1278,1422,2022-02-27
317102,JAKARTA PUSAT,SAWAH BESAR,12976,85,12380,183,328,413,2022-02-27
317104,JAKARTA PUSAT,SENEN,12703,73,12095,173,362,435,2022-02-27
317402,JAKARTA SELATAN,SETIA BUDI,16288,71,15469,192,556,627,2022-02-27
317303,JAKARTA BARAT,TAMAN SARI,12419,62,11929,156,272,334,2022-02-27
317304,JAKARTA BARAT,TAMBORA,19846,65,19046,276,459,524,2022-02-27
317107,JAKARTA PUSAT,TANAH ABANG,15096,67,14424,237,368,435,2022-02-27
317202,JAKARTA UTARA,TANJUNG PRIOK,34961,148,33245,442,1126,1274,2022-02-27
317401,JAKARTA SELATAN,TEBET,23888,82,22513,301,992,1074,2022-02-27
317506,JAKARTA TIMUR,CAKUNG,30493,103,29084,438,868,971,2022-02-28
317105,JAKARTA PUSAT,CEMPAKA PUTIH,14242,65,13588,182,407,472,2022-02-28
317301,JAKARTA BARAT,CENGKARENG,39541,133,37761,595,1052,1185,2022-02-28
317406,JAKARTA SELATAN,CILANDAK,25251,129,23865,283,974,1103,2022-02-28
317204,JAKARTA UTARA,CILINCING,23164,87,22043,358,676,763,2022-02-28
317510,JAKARTA TIMUR,CIPAYUNG,31962,106,30574,292,990,1096,2022-02-28
317509,JAKARTA TIMUR,CIRACAS,29187,112,27825,400,850,962,2022-02-28
317507,JAKARTA TIMUR,DUREN SAWIT,41503,167,38928,654,1754,1921,2022-02-28
317101,JAKARTA PUSAT,GAMBIR,11833,57,11363,151,262,319,2022-02-28
317302,JAKARTA BARAT,GROGOL PETAMBURAN,28123,152,26797,319,855,1007,2022-02-28
317409,JAKARTA SELATAN,JAGAKARSA,35285,111,33528,435,1211,1322,2022-02-28
317503,JAKARTA TIMUR,JATINEGARA,27072,106,25681,414,871,977,2022-02-28
317108,JAKARTA PUSAT,JOHAR BARU,11997,22,11567,175,233,255,2022-02-28
317306,JAKARTA BARAT,KALI DERES,25901,111,24507,336,947,1058,2022-02-28
317407,JAKARTA SELATAN,KEBAYORAN BARU,19108,87,18209,203,609,696,2022-02-28
317405,JAKARTA SELATAN,KEBAYORAN LAMA,28684,103,27200,390,991,1094,2022-02-28
317305,JAKARTA BARAT,KEBON JERUK,32960,185,31315,413,1047,1232,2022-02-28
317206,JAKARTA UTARA,KELAPA GADING,19853,138,18632,205,878,1016,2022-02-28
317103,JAKARTA PUSAT,KEMAYORAN,26670,102,25544,401,623,725,2022-02-28
317308,JAKARTA BARAT,KEMBANGAN,28823,139,27371,326,987,1126,2022-02-28
310102,KAB.ADM.KEP.SERIBU,KEP. SERIBU SELATAN,748,0,724,10,14,14,2022-02-28
310101,KAB.ADM.KEP.SERIBU,KEP. SERIBU UTARA,735,1,704,6,24,25,2022-02-28
317203,JAKARTA UTARA,KOJA,22569,56,21659,350,504,560,2022-02-28
317504,JAKARTA TIMUR,KRAMAT JATI,28584,101,27151,423,909,1010,2022-02-28
111111,LUAR DKI JAKARTA,LUAR DKI JAKARTA,92058,2,91355,615,86,88,2022-02-28
317508,JAKARTA TIMUR,MAKASAR,23805,107,22644,313,741,848,2022-02-28
317403,JAKARTA SELATAN,MAMPANG PRAPATAN,15978,38,15343,186,411,449,2022-02-28
317501,JAKARTA TIMUR,MATRAMAN,19383,56,18493,301,533,589,2022-02-28
317106,JAKARTA PUSAT,MENTENG,9219,54,8803,130,232,286,2022-02-28
317205,JAKARTA UTARA,PADEMANGAN,17083,58,16525,179,321,379,2022-02-28
317307,JAKARTA BARAT,PALMERAH,21431,65,20552,351,463,528,2022-02-28
317408,JAKARTA SELATAN,PANCORAN,20351,72,19306,240,733,805,2022-02-28
317404,JAKARTA SELATAN,PASAR MINGGU,33025,121,31301,448,1155,1276,2022-02-28
317505,JAKARTA TIMUR,PASAR REBO,22825,92,21563,338,832,924,2022-02-28
317201,JAKARTA UTARA,PENJARINGAN,28074,154,26800,248,872,1026,2022-02-28
317410,JAKARTA SELATAN,PESANGGRAHAN,22361,65,21344,271,681,746,2022-02-28
111111,PROSES UPDATE DATA,PROSES UPDATE DATA,82523,1461,76509,876,3677,5138,2022-02-28
317502,JAKARTA TIMUR,PULO GADUNG,31294,134,29644,437,1079,1213,2022-02-28
317102,JAKARTA PUSAT,SAWAH BESAR,13266,72,12705,185,304,376,2022-02-28
317104,JAKARTA PUSAT,SENEN,12935,69,12360,173,333,402,2022-02-28
317402,JAKARTA SELATAN,SETIA BUDI,16589,66,15846,195,482,548,2022-02-28
317303,JAKARTA BARAT,TAMAN SARI,12709,52,12274,159,224,276,2022-02-28
317304,JAKARTA BARAT,TAMBORA,20304,57,19563,277,407,464,2022-02-28
317107,JAKARTA PUSAT,TANAH ABANG,15401,62,14779,239,321,383,2022-02-28
317202,JAKARTA UTARA,TANJUNG PRIOK,35569,137,33999,442,991,1128,2022-02-28
317401,JAKARTA SELATAN,TEBET,24368,74,23105,302,887,961,2022-02-28
317506,JAKARTA TIMUR,CAKUNG,30554,88,29216,438,812,900,2022-03-01
317105,JAKARTA PUSAT,CEMPAKA PUTIH,14238,61,13654,182,341,402,2022-03-01
317301,JAKARTA BARAT,CENGKARENG,39608,144,37962,595,907,1051,2022-03-01
317406,JAKARTA SELATAN,CILANDAK,25321,88,24018,284,931,1019,2022-03-01
317204,JAKARTA UTARA,CILINCING,23193,84,22119,360,630,714,2022-03-01
317510,JAKARTA TIMUR,CIPAYUNG,32011,95,30692,292,932,1027,2022-03-01
317509,JAKARTA TIMUR,CIRACAS,29232,86,27942,401,803,889,2022-03-01
317507,JAKARTA TIMUR,DUREN SAWIT,41605,119,39180,657,1649,1768,2022-03-01
317101,JAKARTA PUSAT,GAMBIR,11846,47,11405,152,242,289,2022-03-01
317302,JAKARTA BARAT,GROGOL PETAMBURAN,28189,130,26960,320,779,909,2022-03-01
317409,JAKARTA SELATAN,JAGAKARSA,35335,68,33707,436,1124,1192,2022-03-01
317503,JAKARTA TIMUR,JATINEGARA,27129,75,25798,414,842,917,2022-03-01
317108,JAKARTA PUSAT,JOHAR BARU,12010,13,11587,176,234,247,2022-03-01
317306,JAKARTA BARAT,KALI DERES,25966,104,24680,337,845,949,2022-03-01
317407,JAKARTA SELATAN,KEBAYORAN BARU,19155,72,18312,203,568,640,2022-03-01
317405,JAKARTA SELATAN,KEBAYORAN LAMA,28750,77,27366,394,913,990,2022-03-01
317305,JAKARTA BARAT,KEBON JERUK,33028,162,31511,414,941,1103,2022-03-01
317206,JAKARTA UTARA,KELAPA GADING,19923,98,18789,205,831,929,2022-03-01
317103,JAKARTA PUSAT,KEMAYORAN,26711,90,25656,401,564,654,2022-03-01
317308,JAKARTA BARAT,KEMBANGAN,28894,118,27552,326,898,1016,2022-03-01
310102,KAB.ADM.KEP.SERIBU,KEP. SERIBU SELATAN,748,0,728,10,10,10,2022-03-01
310101,KAB.ADM.KEP.SERIBU,KEP. SERIBU UTARA,736,1,705,6,24,25,2022-03-01
317203,JAKARTA UTARA,KOJA,22585,56,21749,350,430,486,2022-03-01
317504,JAKARTA TIMUR,KRAMAT JATI,28622,77,27293,423,829,906,2022-03-01
111111,LUAR DKI JAKARTA,LUAR DKI JAKARTA,92106,8,91399,615,84,92,2022-03-01
317508,JAKARTA TIMUR,MAKASAR,23849,93,22750,314,692,785,2022-03-01
317403,JAKARTA SELATAN,MAMPANG PRAPATAN,16009,33,15400,186,390,423,2022-03-01
317501,JAKARTA TIMUR,MATRAMAN,19420,52,18570,301,497,549,2022-03-01
317106,JAKARTA PUSAT,MENTENG,9231,44,8850,130,207,251,2022-03-01
317205,JAKARTA UTARA,PADEMANGAN,17106,49,16582,179,296,345,2022-03-01
317307,JAKARTA BARAT,PALMERAH,21449,58,20634,351,406,464,2022-03-01
317408,JAKARTA SELATAN,PANCORAN,20388,50,19410,241,687,737,2022-03-01
317404,JAKARTA SELATAN,PASAR MINGGU,33122,80,31478,448,1116,1196,2022-03-01
317505,JAKARTA TIMUR,PASAR REBO,22852,55,21655,338,804,859,2022-03-01
317201,JAKARTA UTARA,PENJARINGAN,28144,111,26989,248,796,907,2022-03-01
317410,JAKARTA SELATAN,PESANGGRAHAN,22400,48,21461,272,619,667,2022-03-01
111111,PROSES UPDATE DATA,PROSES UPDATE DATA,84283,1828,77151,878,4426,6254,2022-03-01
317502,JAKARTA TIMUR,PULO GADUNG,31365,96,29811,439,1019,1115,2022-03-01
317102,JAKARTA PUSAT,SAWAH BESAR,13288,69,12768,185,266,335,2022-03-01
317104,JAKARTA PUSAT,SENEN,12959,65,12425,173,296,361,2022-03-01
317402,JAKARTA SELATAN,SETIA BUDI,16606,45,15904,195,462,507,2022-03-01
317303,JAKARTA BARAT,TAMAN SARI,12719,52,12314,159,194,246,2022-03-01
317304,JAKARTA BARAT,TAMBORA,20334,52,19647,277,358,410,2022-03-01
317107,JAKARTA PUSAT,TANAH ABANG,15433,47,14856,240,290,337,2022-03-01
317202,JAKARTA UTARA,TANJUNG PRIOK,35622,129,34173,443,877,1006,2022-03-01
317401,JAKARTA SELATAN,TEBET,24399,60,23200,302,837,897,2022-03-01
317506,JAKARTA TIMUR,CAKUNG,30617,75,29303,439,800,875,2022-03-02
317105,JAKARTA PUSAT,CEMPAKA PUTIH,14269,54,13689,182,344,398,2022-03-02
317301,JAKARTA BARAT,CENGKARENG,39701,137,38117,597,850,987,2022-03-02
317406,JAKARTA SELATAN,CILANDAK,25424,89,24132,285,918,1007,2022-03-02
317204,JAKARTA UTARA,CILINCING,23233,73,22174,360,626,699,2022-03-02
317510,JAKARTA TIMUR,CIPAYUNG,32090,89,30761,292,948,1037,2022-03-02
317509,JAKARTA TIMUR,CIRACAS,29297,80,28015,402,800,880,2022-03-02
317507,JAKARTA TIMUR,DUREN SAWIT,41702,109,39381,657,1555,1664,2022-03-02
317101,JAKARTA PUSAT,GAMBIR,11869,44,11434,152,239,283,2022-03-02
317302,JAKARTA BARAT,GROGOL PETAMBURAN,28254,125,27042,322,765,890,2022-03-02
317409,JAKARTA SELATAN,JAGAKARSA,35405,58,33840,436,1071,1129,2022-03-02
317503,JAKARTA TIMUR,JATINEGARA,27182,67,25884,414,817,884,2022-03-02
317108,JAKARTA PUSAT,JOHAR BARU,12007,11,11610,176,210,221,2022-03-02
317306,JAKARTA BARAT,KALI DERES,26027,93,24810,337,787,880,2022-03-02
317407,JAKARTA SELATAN,KEBAYORAN BARU,19190,60,18371,203,556,616,2022-03-02
317405,JAKARTA SELATAN,KEBAYORAN LAMA,28836,79,27475,394,888,967,2022-03-02
317305,JAKARTA BARAT,KEBON JERUK,33129,158,31638,415,918,1076,2022-03-02
317206,JAKARTA UTARA,KELAPA GADING,19996,78,18916,205,797,875,2022-03-02
317103,JAKARTA PUSAT,KEMAYORAN,26748,84,25716,402,546,630,2022-03-02
317308,JAKARTA BARAT,KEMBANGAN,28983,109,27680,326,868,977,2022-03-02
310102,KAB.ADM.KEP.SERIBU,KEP. SERIBU SELATAN,748,0,728,10,10,10,2022-03-02
310101,KAB.ADM.KEP.SERIBU,KEP. SERIBU UTARA,739,1,709,6,23,24,2022-03-02
317203,JAKARTA UTARA,KOJA,22623,47,21794,351,431,478,2022-03-02
317504,JAKARTA TIMUR,KRAMAT JATI,28689,65,27376,423,825,890,2022-03-02
111111,LUAR DKI JAKARTA,LUAR DKI JAKARTA,92138,8,91414,615,101,109,2022-03-02
317508,JAKARTA TIMUR,MAKASAR,23910,91,22828,315,676,767,2022-03-02
317403,JAKARTA SELATAN,MAMPANG PRAPATAN,16027,31,15444,186,366,397,2022-03-02
317501,JAKARTA TIMUR,MATRAMAN,19462,48,18613,301,500,548,2022-03-02
317106,JAKARTA PUSAT,MENTENG,9256,43,8870,131,212,255,2022-03-02
317205,JAKARTA UTARA,PADEMANGAN,17123,43,16621,179,280,323,2022-03-02
317307,JAKARTA BARAT,PALMERAH,21481,59,20676,352,394,453,2022-03-02
317408,JAKARTA SELATAN,PANCORAN,20436,43,19494,241,658,701,2022-03-02
317404,JAKARTA SELATAN,PASAR MINGGU,33199,73,31624,448,1054,1127,2022-03-02
317505,JAKARTA TIMUR,PASAR REBO,22890,55,21727,339,769,824,2022-03-02
317201,JAKARTA UTARA,PENJARINGAN,28224,108,27111,248,757,865,2022-03-02
317410,JAKARTA SELATAN,PESANGGRAHAN,22438,38,21515,273,612,650,2022-03-02
111111,PROSES UPDATE DATA,PROSES UPDATE DATA,86157,1885,77600,880,5792,7677,2022-03-02
317502,JAKARTA TIMUR,PULO GADUNG,31454,94,29934,439,987,1081,2022-03-02
317102,JAKARTA PUSAT,SAWAH BESAR,13312,66,12801,185,260,326,2022-03-02
317104,JAKARTA PUSAT,SENEN,12991,60,12459,174,298,358,2022-03-02
317402,JAKARTA SELATAN,SETIA BUDI,16657,36,15965,196,460,496,2022-03-02
317303,JAKARTA BARAT,TAMAN SARI,12757,54,12337,159,207,261,2022-03-02
317304,JAKARTA BARAT,TAMBORA,20370,52,19703,278,337,389,2022-03-02
317107,JAKARTA PUSAT,TANAH ABANG,15473,47,14889,240,297,344,2022-03-02
317202,JAKARTA UTARA,TANJUNG PRIOK,35662,115,34283,443,821,936,2022-03-02
317401,JAKARTA SELATAN,TEBET,24494,51,23325,302,816,867,2022-03-02
317506,JAKARTA TIMUR,CAKUNG,30704,47,29524,440,693,740,2022-03-03
317105,JAKARTA PUSAT,CEMPAKA PUTIH,14319,45,13788,182,304,349,2022-03-03
317301,JAKARTA BARAT,CENGKARENG,39809,115,38327,597,770,885,2022-03-03
317406,JAKARTA SELATAN,CILANDAK,25513,76,24356,285,796,872,2022-03-03
317204,JAKARTA UTARA,CILINCING,23285,59,22362,360,504,563,2022-03-03
317510,JAKARTA TIMUR,CIPAYUNG,32150,56,31034,294,766,822,2022-03-03
317509,JAKARTA TIMUR,CIRACAS,29351,60,28220,403,668,728,2022-03-03
317507,JAKARTA TIMUR,DUREN SAWIT,41854,80,39770,660,1344,1424,2022-03-03
317101,JAKARTA PUSAT,GAMBIR,11904,35,11497,152,220,255,2022-03-03
317302,JAKARTA BARAT,GROGOL PETAMBURAN,28344,83,27224,322,715,798,2022-03-03
317409,JAKARTA SELATAN,JAGAKARSA,35523,46,34099,437,941,987,2022-03-03
317503,JAKARTA TIMUR,JATINEGARA,27256,53,26073,415,715,768,2022-03-03
317108,JAKARTA PUSAT,JOHAR BARU,12035,16,11652,176,191,207,2022-03-03
317306,JAKARTA BARAT,KALI DERES,26110,80,25023,337,670,750,2022-03-03
317407,JAKARTA SELATAN,KEBAYORAN BARU,19254,49,18503,203,499,548,2022-03-03
317405,JAKARTA SELATAN,KEBAYORAN LAMA,28948,71,27676,394,807,878,2022-03-03
317305,JAKARTA BARAT,KEBON JERUK,33250,122,31897,415,816,938,2022-03-03
317206,JAKARTA UTARA,KELAPA GADING,20089,65,19118,205,701,766,2022-03-03
317103,JAKARTA PUSAT,KEMAYORAN,26829,71,25870,402,486,557,2022-03-03
317308,JAKARTA BARAT,KEMBANGAN,29118,105,27925,327,761,866,2022-03-03
310102,KAB.ADM.KEP.SERIBU,KEP. SERIBU SELATAN,748,0,735,10,3,3,2022-03-03
310101,KAB.ADM.KEP.SERIBU,KEP. SERIBU UTARA,740,1,715,6,18,19,2022-03-03
317203,JAKARTA UTARA,KOJA,22680,40,21904,351,385,425,2022-03-03
317504,JAKARTA TIMUR,KRAMAT JATI,28764,49,27605,424,686,735,2022-03-03
111111,LUAR DKI JAKARTA,LUAR DKI JAKARTA,92147,5,91450,615,77,82,2022-03-03
317508,JAKARTA TIMUR,MAKASAR,23968,60,23046,316,546,606,2022-03-03
317403,JAKARTA SELATAN,MAMPANG PRAPATAN,16064,32,15538,186,308,340,2022-03-03
317501,JAKARTA TIMUR,MATRAMAN,19506,31,18754,302,419,450,2022-03-03
317106,JAKARTA PUSAT,MENTENG,9274,37,8921,131,185,222,2022-03-03
317205,JAKARTA UTARA,PADEMANGAN,17151,35,16693,179,244,279,2022-03-03
317307,JAKARTA BARAT,PALMERAH,21545,56,20797,353,339,395,2022-03-03
317408,JAKARTA SELATAN,PANCORAN,20510,28,19670,241,571,599,2022-03-03
317404,JAKARTA SELATAN,PASAR MINGGU,33292,56,31869,449,918,974,2022-03-03
317505,JAKARTA TIMUR,PASAR REBO,22965,46,21928,339,652,698,2022-03-03
317201,JAKARTA UTARA,PENJARINGAN,28297,80,27324,249,644,724,2022-03-03
317410,JAKARTA SELATAN,PESANGGRAHAN,22524,33,21693,273,525,558,2022-03-03
111111,PROSES UPDATE DATA,PROSES UPDATE DATA,87899,2144,78150,883,6722,8866,2022-03-03
317502,JAKARTA TIMUR,PULO GADUNG,31560,84,30144,441,891,975,2022-03-03
317102,JAKARTA PUSAT,SAWAH BESAR,13340,53,12880,185,222,275,2022-03-03
317104,JAKARTA PUSAT,SENEN,13036,45,12544,174,273,318,2022-03-03
317402,JAKARTA SELATAN,SETIA BUDI,16668,23,16081,195,369,392,2022-03-03
317303,JAKARTA BARAT,TAMAN SARI,12775,40,12381,159,195,235,2022-03-03
317304,JAKARTA BARAT,TAMBORA,20405,39,19786,278,302,341,2022-03-03
317107,JAKARTA PUSAT,TANAH ABANG,15508,39,14964,240,265,304,2022-03-03
317202,JAKARTA UTARA,TANJUNG PRIOK,35744,102,34466,443,733,835,2022-03-03
317401,JAKARTA SELATAN,TEBET,24583,35,23523,302,723,758,2022-03-03
317506,JAKARTA TIMUR,CAKUNG,30744,47,29683,440,574,621,2022-03-04
317105,JAKARTA PUSAT,CEMPAKA PUTIH,14339,45,13852,182,260,305,2022-03-04
317301,JAKARTA BARAT,CENGKARENG,39878,111,38472,598,697,808,2022-03-04
317406,JAKARTA SELATAN,CILANDAK,25595,75,24516,285,719,794,2022-03-04
317204,JAKARTA UTARA,CILINCING,23343,56,22465,360,462,518,2022-03-04
317510,JAKARTA TIMUR,CIPAYUNG,32253,49,31215,294,695,744,2022-03-04
317509,JAKARTA TIMUR,CIRACAS,29423,63,28365,403,592,655,2022-03-04
317507,JAKARTA TIMUR,DUREN SAWIT,41949,80,40076,661,1132,1212,2022-03-04
317101,JAKARTA PUSAT,GAMBIR,11916,33,11539,152,192,225,2022-03-04
317302,JAKARTA BARAT,GROGOL PETAMBURAN,28416,80,27370,323,643,723,2022-03-04
317409,JAKARTA SELATAN,JAGAKARSA,35607,46,34303,437,821,867,2022-03-04
317503,JAKARTA TIMUR,JATINEGARA,27320,49,26221,416,634,683,2022-03-04
317108,JAKARTA PUSAT,JOHAR BARU,12049,16,11687,176,170,186,2022-03-04
317306,JAKARTA BARAT,KALI DERES,26172,73,25164,337,598,671,2022-03-04
317407,JAKARTA SELATAN,KEBAYORAN BARU,19320,47,18591,203,479,526,2022-03-04
317405,JAKARTA SELATAN,KEBAYORAN LAMA,29041,80,27828,394,739,819,2022-03-04
317305,JAKARTA BARAT,KEBON JERUK,33324,121,32079,415,709,830,2022-03-04
317206,JAKARTA UTARA,KELAPA GADING,20164,65,19257,205,637,702,2022-03-04
317103,JAKARTA PUSAT,KEMAYORAN,26879,64,25979,403,433,497,2022-03-04
317308,JAKARTA BARAT,KEMBANGAN,29210,104,28086,328,692,796,2022-03-04
310102,KAB.ADM.KEP.SERIBU,KEP. SERIBU SELATAN,748,0,735,10,3,3,2022-03-04
310101,KAB.ADM.KEP.SERIBU,KEP. SERIBU UTARA,740,1,717,6,16,17,2022-03-04
317203,JAKARTA UTARA,KOJA,22716,41,21983,351,341,382,2022-03-04
317504,JAKARTA TIMUR,KRAMAT JATI,28830,46,27757,425,602,648,2022-03-04
111111,LUAR DKI JAKARTA,LUAR DKI JAKARTA,92163,6,91476,615,66,72,2022-03-04
317508,JAKARTA TIMUR,MAKASAR,24026,58,23162,317,489,547,2022-03-04
317403,JAKARTA SELATAN,MAMPANG PRAPATAN,16093,33,15617,186,257,290,2022-03-04
317501,JAKARTA TIMUR,MATRAMAN,19551,33,18846,302,370,403,2022-03-04
317106,JAKARTA PUSAT,MENTENG,9297,35,8959,131,172,207,2022-03-04
317205,JAKARTA UTARA,PADEMANGAN,17184,37,16746,181,220,257,2022-03-04
317307,JAKARTA BARAT,PALMERAH,21580,58,20877,353,292,350,2022-03-04
317408,JAKARTA SELATAN,PANCORAN,20580,27,19793,242,518,545,2022-03-04
317404,JAKARTA SELATAN,PASAR MINGGU,33402,52,32049,450,851,903,2022-03-04
317505,JAKARTA TIMUR,PASAR REBO,23007,42,22110,340,515,557,2022-03-04
317201,JAKARTA UTARA,PENJARINGAN,28381,80,27446,249,606,686,2022-03-04
317410,JAKARTA SELATAN,PESANGGRAHAN,22579,37,21782,273,487,524,2022-03-04
111111,PROSES UPDATE DATA,PROSES UPDATE DATA,89272,2206,78727,889,7450,9656,2022-03-04
317502,JAKARTA TIMUR,PULO GADUNG,31635,86,30350,442,757,843,2022-03-04
317102,JAKARTA PUSAT,SAWAH BESAR,13362,50,12915,185,212,262,2022-03-04
317104,JAKARTA PUSAT,SENEN,13058,49,12596,174,239,288,2022-03-04
317402,JAKARTA SELATAN,SETIA BUDI,16686,21,16145,196,324,345,2022-03-04
317303,JAKARTA BARAT,TAMAN SARI,12801,38,12426,160,177,215,2022-03-04
317304,JAKARTA BARAT,TAMBORA,20444,42,19838,278,286,328,2022-03-04
317107,JAKARTA PUSAT,TANAH ABANG,15523,38,15006,241,238,276,2022-03-04
317202,JAKARTA UTARA,TANJUNG PRIOK,35818,103,34654,443,618,721,2022-03-04
317401,JAKARTA SELATAN,TEBET,24647,34,23674,303,636,670,2022-03-04
317506,JAKARTA TIMUR,CAKUNG,30791,55,29800,441,495,550,2022-03-05
317105,JAKARTA PUSAT,CEMPAKA PUTIH,14356,38,13906,183,229,267,2022-03-05
317301,JAKARTA BARAT,CENGKARENG,39925,113,38609,599,604,717,2022-03-05
317406,JAKARTA SELATAN,CILANDAK,25675,94,24656,285,640,734,2022-03-05
317204,JAKARTA UTARA,CILINCING,23380,44,22576,361,399,443,2022-03-05
317510,JAKARTA TIMUR,CIPAYUNG,32330,48,31396,294,592,640,2022-03-05
317509,JAKARTA TIMUR,CIRACAS,29504,55,28490,405,554,609,2022-03-05
317507,JAKARTA TIMUR,DUREN SAWIT,42055,73,40339,662,981,1054,2022-03-05
317101,JAKARTA PUSAT,GAMBIR,11926,29,11567,152,178,207,2022-03-05
317302,JAKARTA BARAT,GROGOL PETAMBURAN,28486,94,27526,323,543,637,2022-03-05
317409,JAKARTA SELATAN,JAGAKARSA,35654,42,34463,437,712,754,2022-03-05
317503,JAKARTA TIMUR,JATINEGARA,27374,52,26357,416,549,601,2022-03-05
317108,JAKARTA PUSAT,JOHAR BARU,12066,16,11728,176,146,162,2022-03-05
317306,JAKARTA BARAT,KALI DERES,26223,72,25295,337,519,591,2022-03-05
317407,JAKARTA SELATAN,KEBAYORAN BARU,19383,50,18672,203,458,508,2022-03-05
317405,JAKARTA SELATAN,KEBAYORAN LAMA,29093,69,27994,395,635,704,2022-03-05
317305,JAKARTA BARAT,KEBON JERUK,33386,109,32246,415,616,725,2022-03-05
317206,JAKARTA UTARA,KELAPA GADING,20218,60,19391,205,562,622,2022-03-05
317103,JAKARTA PUSAT,KEMAYORAN,26919,68,26090,403,358,426,2022-03-05
317308,JAKARTA BARAT,KEMBANGAN,29256,88,28232,328,608,696,2022-03-05
310102,KAB.ADM.KEP.SERIBU,KEP. SERIBU SELATAN,749,1,737,10,1,2,2022-03-05
310101,KAB.ADM.KEP.SERIBU,KEP. SERIBU UTARA,741,1,723,6,11,12,2022-03-05
317203,JAKARTA UTARA,KOJA,22738,41,22073,352,272,313,2022-03-05
317504,JAKARTA TIMUR,KRAMAT JATI,28884,52,27894,426,512,564,2022-03-05
111111,LUAR DKI JAKARTA,LUAR DKI JAKARTA,92178,4,91488,615,71,75,2022-03-05
317508,JAKARTA TIMUR,MAKASAR,24081,64,23272,317,428,492,2022-03-05
317403,JAKARTA SELATAN,MAMPANG PRAPATAN,16119,27,15673,187,232,259,2022-03-05
317501,JAKARTA TIMUR,MATRAMAN,19576,34,18932,302,308,342,2022-03-05
317106,JAKARTA PUSAT,MENTENG,9317,34,9002,131,150,184,2022-03-05
317205,JAKARTA UTARA,PADEMANGAN,17219,41,16809,181,188,229,2022-03-05
317307,JAKARTA BARAT,PALMERAH,21626,64,20962,353,247,311,2022-03-05
317408,JAKARTA SELATAN,PANCORAN,20616,23,19910,243,440,463,2022-03-05
317404,JAKARTA SELATAN,PASAR MINGGU,33451,42,32226,450,733,775,2022-03-05
317505,JAKARTA TIMUR,PASAR REBO,23037,45,22215,341,436,481,2022-03-05
317201,JAKARTA UTARA,PENJARINGAN,28445,89,27554,249,553,642,2022-03-05
317410,JAKARTA SELATAN,PESANGGRAHAN,22621,37,21869,274,441,478,2022-03-05
111111,PROSES UPDATE DATA,PROSES UPDATE DATA,90434,2322,79358,895,7859,10181,2022-03-05
317502,JAKARTA TIMUR,PULO GADUNG,31686,86,30517,442,641,727,2022-03-05
317102,JAKARTA PUSAT,SAWAH BESAR,13377,49,12958,185,185,234,2022-03-05
317104,JAKARTA PUSAT,SENEN,13079,43,12656,174,206,249,2022-03-05
317402,JAKARTA SELATAN,SETIA BUDI,16722,24,16233,197,268,292,2022-03-05
317303,JAKARTA BARAT,TAMAN SARI,12826,43,12468,161,154,197,2022-03-05
317304,JAKARTA BARAT,TAMBORA,20466,40,19883,278,265,305,2022-03-05
317107,JAKARTA PUSAT,TANAH ABANG,15557,40,15051,241,225,265,2022-03-05
317202,JAKARTA UTARA,TANJUNG PRIOK,35877,101,34821,445,510,611,2022-03-05
317401,JAKARTA SELATAN,TEBET,24702,38,23798,304,562,600,2022-03-05
317506,JAKARTA TIMUR,CAKUNG,30842,39,29923,441,439,478,2022-03-06
317105,JAKARTA PUSAT,CEMPAKA PUTIH,14394,34,13948,184,228,262,2022-03-06
317301,JAKARTA BARAT,CENGKARENG,40009,96,38760,599,554,650,2022-03-06
317406,JAKARTA SELATAN,CILANDAK,25756,95,24780,285,596,691,2022-03-06
317204,JAKARTA UTARA,CILINCING,23419,37,22673,362,347,384,2022-03-06
317510,JAKARTA TIMUR,CIPAYUNG,32383,45,31520,294,524,569,2022-03-06
317509,JAKARTA TIMUR,CIRACAS,29554,42,28598,406,508,550,2022-03-06
317507,JAKARTA TIMUR,DUREN SAWIT,42159,83,40520,664,892,975,2022-03-06
317101,JAKARTA PUSAT,GAMBIR,11950,30,11603,153,164,194,2022-03-06
317302,JAKARTA BARAT,GROGOL PETAMBURAN,28565,82,27644,324,515,597,2022-03-06
317409,JAKARTA SELATAN,JAGAKARSA,35713,34,34650,437,592,626,2022-03-06
317503,JAKARTA TIMUR,JATINEGARA,27421,36,26500,416,469,505,2022-03-06
317108,JAKARTA PUSAT,JOHAR BARU,12083,16,11769,176,122,138,2022-03-06
317306,JAKARTA BARAT,KALI DERES,26303,80,25398,337,488,568,2022-03-06
317407,JAKARTA SELATAN,KEBAYORAN BARU,19442,53,18744,204,441,494,2022-03-06
317405,JAKARTA SELATAN,KEBAYORAN LAMA,29182,74,28100,396,612,686,2022-03-06
317305,JAKARTA BARAT,KEBON JERUK,33481,108,32373,415,585,693,2022-03-06
317206,JAKARTA UTARA,KELAPA GADING,20278,46,19481,205,546,592,2022-03-06
317103,JAKARTA PUSAT,KEMAYORAN,26947,56,26162,403,326,382,2022-03-06
317308,JAKARTA BARAT,KEMBANGAN,29341,76,28352,328,585,661,2022-03-06
310102,KAB.ADM.KEP.SERIBU,KEP. SERIBU SELATAN,749,1,738,10,0,1,2022-03-06
310101,KAB.ADM.KEP.SERIBU,KEP. SERIBU UTARA,741,1,726,6,8,9,2022-03-06
317203,JAKARTA UTARA,KOJA,22770,37,22141,353,239,276,2022-03-06
317504,JAKARTA TIMUR,KRAMAT JATI,28940,48,27991,426,475,523,2022-03-06
111111,LUAR DKI JAKARTA,LUAR DKI JAKARTA,92180,5,91497,615,63,68,2022-03-06
317508,JAKARTA TIMUR,MAKASAR,24133,60,23352,317,404,464,2022-03-06
317403,JAKARTA SELATAN,MAMPANG PRAPATAN,16164,26,15716,187,235,261,2022-03-06
317501,JAKARTA TIMUR,MATRAMAN,19612,28,18996,303,285,313,2022-03-06
317106,JAKARTA PUSAT,MENTENG,9331,31,9034,131,135,166,2022-03-06
317205,JAKARTA UTARA,PADEMANGAN,17249,39,16871,181,158,197,2022-03-06
317307,JAKARTA BARAT,PALMERAH,21673,56,21002,353,262,318,2022-03-06
317408,JAKARTA SELATAN,PANCORAN,20688,22,19984,244,438,460,2022-03-06
317404,JAKARTA SELATAN,PASAR MINGGU,33552,43,32380,451,678,721,2022-03-06
317505,JAKARTA TIMUR,PASAR REBO,23091,33,22334,341,383,416,2022-03-06
317201,JAKARTA UTARA,PENJARINGAN,28522,82,27646,249,545,627,2022-03-06
317410,JAKARTA SELATAN,PESANGGRAHAN,22689,35,21978,274,402,437,2022-03-06
111111,PROSES UPDATE DATA,PROSES UPDATE DATA,91802,2463,79977,896,8466,10929,2022-03-06
317502,JAKARTA TIMUR,PULO GADUNG,31762,75,30655,444,588,663,2022-03-06
317102,JAKARTA PUSAT,SAWAH BESAR,13411,50,13001,186,174,224,2022-03-06
317104,JAKARTA PUSAT,SENEN,13097,43,12692,175,187,230,2022-03-06
317402,JAKARTA SELATAN,SETIA BUDI,16765,27,16294,197,247,274,2022-03-06
317303,JAKARTA BARAT,TAMAN SARI,12848,34,12504,161,149,183,2022-03-06
317304,JAKARTA BARAT,TAMBORA,20494,42,19934,278,240,282,2022-03-06
317107,JAKARTA PUSAT,TANAH ABANG,15574,35,15093,241,205,240,2022-03-06
317202,JAKARTA UTARA,TANJUNG PRIOK,35948,96,34933,445,474,570,2022-03-06
317401,JAKARTA SELATAN,TEBET,24786,41,23898,305,542,583,2022-03-06
317506,JAKARTA TIMUR,CAKUNG,30877,37,30019,441,380,417,2022-03-07
317105,JAKARTA PUSAT,CEMPAKA PUTIH,14420,31,14001,185,203,234,2022-03-07
317301,JAKARTA BARAT,CENGKARENG,40069,109,38866,601,493,602,2022-03-07
317406,JAKARTA SELATAN,CILANDAK,25828,95,24882,286,565,660,2022-03-07
317204,JAKARTA UTARA,CILINCING,23435,35,22761,362,277,312,2022-03-07
317510,JAKARTA TIMUR,CIPAYUNG,32440,45,31615,294,486,531,2022-03-07
317509,JAKARTA TIMUR,CIRACAS,29588,38,28706,407,437,475,2022-03-07
317507,JAKARTA TIMUR,DUREN SAWIT,42229,79,40718,666,766,845,2022-03-07
317101,JAKARTA PUSAT,GAMBIR,11964,25,11642,153,144,169,2022-03-07
317302,JAKARTA BARAT,GROGOL PETAMBURAN,28614,83,27750,325,456,539,2022-03-07
317409,JAKARTA SELATAN,JAGAKARSA,35771,36,34780,437,518,554,2022-03-07
317503,JAKARTA TIMUR,JATINEGARA,27455,34,26593,416,412,446,2022-03-07
317108,JAKARTA PUSAT,JOHAR BARU,12085,17,11789,176,103,120,2022-03-07
317306,JAKARTA BARAT,KALI DERES,26347,79,25491,338,439,518,2022-03-07
317407,JAKARTA SELATAN,KEBAYORAN BARU,19480,52,18830,204,394,446,2022-03-07
317405,JAKARTA SELATAN,KEBAYORAN LAMA,29250,72,28199,396,583,655,2022-03-07
317305,JAKARTA BARAT,KEBON JERUK,33555,113,32473,417,552,665,2022-03-07
317206,JAKARTA UTARA,KELAPA GADING,20323,50,19593,205,475,525,2022-03-07
317103,JAKARTA PUSAT,KEMAYORAN,26972,55,26232,405,280,335,2022-03-07
317308,JAKARTA BARAT,KEMBANGAN,29418,82,28453,328,555,637,2022-03-07
310102,KAB.ADM.KEP.SERIBU,KEP. SERIBU SELATAN,747,0,737,10,0,0,2022-03-07
310101,KAB.ADM.KEP.SERIBU,KEP. SERIBU UTARA,739,1,728,6,4,5,2022-03-07
317203,JAKARTA UTARA,KOJA,22785,38,22182,353,212,250,2022-03-07
317504,JAKARTA TIMUR,KRAMAT JATI,28965,50,28087,426,402,452,2022-03-07
111111,LUAR DKI JAKARTA,LUAR DKI JAKARTA,92199,5,91516,615,63,68,2022-03-07
317508,JAKARTA TIMUR,MAKASAR,24162,60,23434,318,350,410,2022-03-07
317403,JAKARTA SELATAN,MAMPANG PRAPATAN,16180,26,15753,187,214,240,2022-03-07
317501,JAKARTA TIMUR,MATRAMAN,19637,30,19060,304,243,273,2022-03-07
317106,JAKARTA PUSAT,MENTENG,9341,32,9068,131,110,142,2022-03-07
317205,JAKARTA UTARA,PADEMANGAN,17274,43,16894,185,152,195,2022-03-07
317307,JAKARTA BARAT,PALMERAH,21698,54,21058,354,232,286,2022-03-07
317408,JAKARTA SELATAN,PANCORAN,20731,27,20051,244,409,436,2022-03-07
317404,JAKARTA SELATAN,PASAR MINGGU,33612,44,32498,452,618,662,2022-03-07
317505,JAKARTA TIMUR,PASAR REBO,23130,35,22437,341,317,352,2022-03-07
317201,JAKARTA UTARA,PENJARINGAN,28587,81,27748,249,509,590,2022-03-07
317410,JAKARTA SELATAN,PESANGGRAHAN,22716,34,22041,276,365,399,2022-03-07
111111,PROSES UPDATE DATA,PROSES UPDATE DATA,92911,2564,80669,898,8780,11344,2022-03-07
317502,JAKARTA TIMUR,PULO GADUNG,31818,81,30778,445,514,595,2022-03-07
317102,JAKARTA PUSAT,SAWAH BESAR,13425,50,13031,186,158,208,2022-03-07
317104,JAKARTA PUSAT,SENEN,13114,46,12730,175,163,209,2022-03-07
317402,JAKARTA SELATAN,SETIA BUDI,16790,28,16345,197,220,248,2022-03-07
317303,JAKARTA BARAT,TAMAN SARI,12862,37,12530,161,134,171,2022-03-07
317304,JAKARTA BARAT,TAMBORA,20514,40,19992,278,204,244,2022-03-07
317107,JAKARTA PUSAT,TANAH ABANG,15588,33,15129,241,185,218,2022-03-07
317202,JAKARTA UTARA,TANJUNG PRIOK,36014,97,35046,446,425,522,2022-03-07
317401,JAKARTA SELATAN,TEBET,24827,44,23991,308,484,528,2022-03-07
317506,JAKARTA TIMUR,CAKUNG,30920,35,30085,442,358,393,2022-03-08
317105,JAKARTA PUSAT,CEMPAKA PUTIH,14435,27,14028,185,195,222,2022-03-08
317301,JAKARTA BARAT,CENGKARENG,40127,116,38958,602,451,567,2022-03-08
317406,JAKARTA SELATAN,CILANDAK,25918,87,25001,287,543,630,2022-03-08
317204,JAKARTA UTARA,CILINCING,23461,36,22806,363,256,292,2022-03-08
317510,JAKARTA TIMUR,CIPAYUNG,32504,48,31679,294,483,531,2022-03-08
317509,JAKARTA TIMUR,CIRACAS,29627,34,28786,407,400,434,2022-03-08
317507,JAKARTA TIMUR,DUREN SAWIT,42339,76,40853,667,743,819,2022-03-08
317101,JAKARTA PUSAT,GAMBIR,11973,22,11676,153,122,144,2022-03-08
317302,JAKARTA BARAT,GROGOL PETAMBURAN,28689,84,27840,327,438,522,2022-03-08
317409,JAKARTA SELATAN,JAGAKARSA,35839,43,34858,438,500,543,2022-03-08
317503,JAKARTA TIMUR,JATINEGARA,27488,35,26667,416,370,405,2022-03-08
317108,JAKARTA PUSAT,JOHAR BARU,12094,16,11800,176,102,118,2022-03-08
317306,JAKARTA BARAT,KALI DERES,26402,78,25584,338,402,480,2022-03-08
317407,JAKARTA SELATAN,KEBAYORAN BARU,19548,46,18917,206,379,425,2022-03-08
317405,JAKARTA SELATAN,KEBAYORAN LAMA,29385,66,28353,397,569,635,2022-03-08
317305,JAKARTA BARAT,KEBON JERUK,33625,110,32590,417,508,618,2022-03-08
317206,JAKARTA UTARA,KELAPA GADING,20370,48,19653,205,464,512,2022-03-08
317103,JAKARTA PUSAT,KEMAYORAN,26999,55,26277,405,262,317,2022-03-08
317308,JAKARTA BARAT,KEMBANGAN,29498,83,28542,329,544,627,2022-03-08
310102,KAB.ADM.KEP.SERIBU,KEP. SERIBU SELATAN,748,1,737,10,0,1,2022-03-08
310101,KAB.ADM.KEP.SERIBU,KEP. SERIBU UTARA,737,0,728,6,3,3,2022-03-08
317203,JAKARTA UTARA,KOJA,22842,33,22248,353,208,241,2022-03-08
317504,JAKARTA TIMUR,KRAMAT JATI,29078,54,28233,426,365,419,2022-03-08
111111,LUAR DKI JAKARTA,LUAR DKI JAKARTA,92245,10,91541,615,79,89,2022-03-08
317508,JAKARTA TIMUR,MAKASAR,24220,62,23492,318,348,410,2022-03-08
317403,JAKARTA SELATAN,MAMPANG PRAPATAN,16196,27,15782,187,200,227,2022-03-08
317501,JAKARTA TIMUR,MATRAMAN,19658,29,19101,304,224,253,2022-03-08
317106,JAKARTA PUSAT,MENTENG,9357,28,9088,131,110,138,2022-03-08
317205,JAKARTA UTARA,PADEMANGAN,17290,45,16919,185,141,186,2022-03-08
317307,JAKARTA BARAT,PALMERAH,21726,53,21089,355,229,282,2022-03-08
317408,JAKARTA SELATAN,PANCORAN,20778,29,20112,244,393,422,2022-03-08
317404,JAKARTA SELATAN,PASAR MINGGU,33687,49,32583,452,603,652,2022-03-08
317505,JAKARTA TIMUR,PASAR REBO,23182,37,22503,342,300,337,2022-03-08
317201,JAKARTA UTARA,PENJARINGAN,28650,82,27825,250,493,575,2022-03-08
317410,JAKARTA SELATAN,PESANGGRAHAN,22773,37,22092,277,367,404,2022-03-08
111111,PROSES UPDATE DATA,PROSES UPDATE DATA,94296,2549,82048,898,8801,11350,2022-03-08
317502,JAKARTA TIMUR,PULO GADUNG,31898,76,30890,447,485,561,2022-03-08
317102,JAKARTA PUSAT,SAWAH BESAR,13434,39,13063,187,145,184,2022-03-08
317104,JAKARTA PUSAT,SENEN,13144,37,12770,175,162,199,2022-03-08
317402,JAKARTA SELATAN,SETIA BUDI,16830,31,16378,197,224,255,2022-03-08
317303,JAKARTA BARAT,TAMAN SARI,12888,40,12555,163,130,170,2022-03-08
317304,JAKARTA BARAT,TAMBORA,20548,45,20031,279,193,238,2022-03-08
317107,JAKARTA PUSAT,TANAH ABANG,15619,30,15167,242,180,210,2022-03-08
317202,JAKARTA UTARA,TANJUNG PRIOK,36075,96,35130,447,402,498,2022-03-08
317401,JAKARTA SELATAN,TEBET,24915,47,24081,308,479,526,2022-03-08
317506,JAKARTA TIMUR,CAKUNG,30979,38,30131,442,368,406,2022-03-09
317105,JAKARTA PUSAT,CEMPAKA PUTIH,14464,29,14046,185,204,233,2022-03-09
317301,JAKARTA BARAT,CENGKARENG,40210,116,39015,602,477,593,2022-03-09
317406,JAKARTA SELATAN,CILANDAK,26037,88,25100,287,562,650,2022-03-09
317204,JAKARTA UTARA,CILINCING,23503,35,22843,363,262,297,2022-03-09
317510,JAKARTA TIMUR,CIPAYUNG,32570,48,31729,295,498,546,2022-03-09
317509,JAKARTA TIMUR,CIRACAS,29677,34,28843,407,393,427,2022-03-09
317507,JAKARTA TIMUR,DUREN SAWIT,42437,74,40945,669,749,823,2022-03-09
317101,JAKARTA PUSAT,GAMBIR,12000,19,11698,154,129,148,2022-03-09
317302,JAKARTA BARAT,GROGOL PETAMBURAN,28760,86,27885,327,462,548,2022-03-09
317409,JAKARTA SELATAN,JAGAKARSA,35918,44,34902,439,533,577,2022-03-09
317503,JAKARTA TIMUR,JATINEGARA,27545,37,26725,416,367,404,2022-03-09
317108,JAKARTA PUSAT,JOHAR BARU,12120,19,11815,176,110,129,2022-03-09
317306,JAKARTA BARAT,KALI DERES,26469,78,25654,338,399,477,2022-03-09
317407,JAKARTA SELATAN,KEBAYORAN BARU,19645,45,18991,206,403,448,2022-03-09
317405,JAKARTA SELATAN,KEBAYORAN LAMA,29501,63,28465,397,576,639,2022-03-09
317305,JAKARTA BARAT,KEBON JERUK,33714,112,32646,417,539,651,2022-03-09
317206,JAKARTA UTARA,KELAPA GADING,20415,46,19707,205,457,503,2022-03-09
317103,JAKARTA PUSAT,KEMAYORAN,27034,58,26308,405,263,321,2022-03-09
317308,JAKARTA BARAT,KEMBANGAN,29618,89,28608,329,592,681,2022-03-09
310102,KAB.ADM.KEP.SERIBU,KEP. SERIBU SELATAN,748,0,737,10,1,1,2022-03-09
310101,KAB.ADM.KEP.SERIBU,KEP. SERIBU UTARA,740,0,733,6,1,1,2022-03-09
317203,JAKARTA UTARA,KOJA,22926,33,22320,353,220,253,2022-03-09
317504,JAKARTA TIMUR,KRAMAT JATI,29185,52,28304,427,402,454,2022-03-09
111111,LUAR DKI JAKARTA,LUAR DKI JAKARTA,92262,12,91556,615,79,91,2022-03-09
317508,JAKARTA TIMUR,MAKASAR,24298,59,23534,318,387,446,2022-03-09
317403,JAKARTA SELATAN,MAMPANG PRAPATAN,16240,23,15815,187,215,238,2022-03-09
317501,JAKARTA TIMUR,MATRAMAN,19697,28,19132,304,233,261,2022-03-09
317106,JAKARTA PUSAT,MENTENG,9379,30,9105,131,113,143,2022-03-09
317205,JAKARTA UTARA,PADEMANGAN,17314,46,16942,185,141,187,2022-03-09
317307,JAKARTA BARAT,PALMERAH,21765,53,21112,356,244,297,2022-03-09
317408,JAKARTA SELATAN,PANCORAN,20833,25,20153,244,411,436,2022-03-09
317404,JAKARTA SELATAN,PASAR MINGGU,33769,51,32663,454,601,652,2022-03-09
317505,JAKARTA TIMUR,PASAR REBO,23246,38,22531,342,335,373,2022-03-09
317201,JAKARTA UTARA,PENJARINGAN,28729,83,27892,250,504,587,2022-03-09
317410,JAKARTA SELATAN,PESANGGRAHAN,22846,38,22142,277,389,427,2022-03-09
111111,PROSES UPDATE DATA,PROSES UPDATE DATA,95565,2414,83751,899,8501,10915,2022-03-09
317502,JAKARTA TIMUR,PULO GADUNG,31990,73,30943,447,527,600,2022-03-09
317102,JAKARTA PUSAT,SAWAH BESAR,13460,39,13093,187,141,180,2022-03-09
317104,JAKARTA PUSAT,SENEN,13188,34,12795,175,184,218,2022-03-09
317402,JAKARTA SELATAN,SETIA BUDI,16864,33,16410,197,224,257,2022-03-09
317303,JAKARTA BARAT,TAMAN SARI,12907,41,12558,163,145,186,2022-03-09
317304,JAKARTA BARAT,TAMBORA,20585,45,20059,280,201,246,2022-03-09
317107,JAKARTA PUSAT,TANAH ABANG,15651,28,15187,242,194,222,2022-03-09
317202,JAKARTA UTARA,TANJUNG PRIOK,36137,101,35175,447,414,515,2022-03-09
317401,JAKARTA SELATAN,TEBET,24987,48,24154,308,477,525,2022-03-09
317506,JAKARTA TIMUR,CAKUNG,31035,44,30185,443,363,407,2022-03-10
317105,JAKARTA PUSAT,CEMPAKA PUTIH,14500,30,14075,185,210,240,2022-03-10
317301,JAKARTA BARAT,CENGKARENG,40262,111,39092,603,456,567,2022-03-10
317406,JAKARTA SELATAN,CILANDAK,26139,87,25192,287,573,660,2022-03-10
317204,JAKARTA UTARA,CILINCING,23544,37,22887,363,257,294,2022-03-10
317510,JAKARTA TIMUR,CIPAYUNG,32638,47,31781,295,515,562,2022-03-10
317509,JAKARTA TIMUR,CIRACAS,29757,34,28888,408,427,461,2022-03-10
317507,JAKARTA TIMUR,DUREN SAWIT,42547,79,41046,669,753,832,2022-03-10
317101,JAKARTA PUSAT,GAMBIR,12017,20,11713,154,130,150,2022-03-10
317302,JAKARTA BARAT,GROGOL PETAMBURAN,28813,90,27939,327,457,547,2022-03-10
317409,JAKARTA SELATAN,JAGAKARSA,35999,46,34963,439,551,597,2022-03-10
317503,JAKARTA TIMUR,JATINEGARA,27577,44,26774,417,342,386,2022-03-10
317108,JAKARTA PUSAT,JOHAR BARU,12140,22,11835,177,106,128,2022-03-10
317306,JAKARTA BARAT,KALI DERES,26563,76,25712,339,436,512,2022-03-10
317407,JAKARTA SELATAN,KEBAYORAN BARU,19708,46,19045,207,410,456,2022-03-10
317405,JAKARTA SELATAN,KEBAYORAN LAMA,29623,63,28570,398,592,655,2022-03-10
317305,JAKARTA BARAT,KEBON JERUK,33783,110,32718,417,538,648,2022-03-10
317206,JAKARTA UTARA,KELAPA GADING,20478,40,19781,205,452,492,2022-03-10
317103,JAKARTA PUSAT,KEMAYORAN,27087,55,26340,407,285,340,2022-03-10
317308,JAKARTA BARAT,KEMBANGAN,29681,92,28663,329,597,689,2022-03-10
310102,KAB.ADM.KEP.SERIBU,KEP. SERIBU SELATAN,748,0,738,10,0,0,2022-03-10
310101,KAB.ADM.KEP.SERIBU,KEP. SERIBU UTARA,741,0,735,6,0,0,2022-03-10
317203,JAKARTA UTARA,KOJA,22974,32,22359,353,230,262,2022-03-10
317504,JAKARTA TIMUR,KRAMAT JATI,29292,54,28401,427,410,464,2022-03-10
111111,LUAR DKI JAKARTA,LUAR DKI JAKARTA,92285,13,91569,615,88,101,2022-03-10
317508,JAKARTA TIMUR,MAKASAR,24364,64,23587,318,395,459,2022-03-10
317403,JAKARTA SELATAN,MAMPANG PRAPATAN,16276,27,15840,187,222,249,2022-03-10
317501,JAKARTA TIMUR,MATRAMAN,19732,29,19170,304,229,258,2022-03-10
317106,JAKARTA PUSAT,MENTENG,9396,29,9120,131,116,145,2022-03-10
317205,JAKARTA UTARA,PADEMANGAN,17368,45,16995,185,143,188,2022-03-10
317307,JAKARTA BARAT,PALMERAH,21791,58,21134,358,241,299,2022-03-10
317408,JAKARTA SELATAN,PANCORAN,20877,27,20192,244,414,441,2022-03-10
317404,JAKARTA SELATAN,PASAR MINGGU,33862,47,32760,454,601,648,2022-03-10
317505,JAKARTA TIMUR,PASAR REBO,23309,34,22565,342,368,402,2022-03-10
317201,JAKARTA UTARA,PENJARINGAN,28793,88,27948,250,507,595,2022-03-10
317410,JAKARTA SELATAN,PESANGGRAHAN,22895,39,22188,277,391,430,2022-03-10
111111,PROSES UPDATE DATA,PROSES UPDATE DATA,96715,2362,85262,901,8190,10552,2022-03-10
317502,JAKARTA TIMUR,PULO GADUNG,32056,72,31016,447,521,593,2022-03-10
317102,JAKARTA PUSAT,SAWAH BESAR,13488,38,13128,187,135,173,2022-03-10
317104,JAKARTA PUSAT,SENEN,13210,34,12818,175,183,217,2022-03-10
317402,JAKARTA SELATAN,SETIA BUDI,16880,30,16439,198,213,243,2022-03-10
317303,JAKARTA BARAT,TAMAN SARI,12936,45,12592,163,136,181,2022-03-10
317304,JAKARTA BARAT,TAMBORA,20618,47,20085,282,204,251,2022-03-10
317107,JAKARTA PUSAT,TANAH ABANG,15672,23,15211,242,196,219,2022-03-10
317202,JAKARTA UTARA,TANJUNG PRIOK,36256,104,35278,448,426,530,2022-03-10
317401,JAKARTA SELATAN,TEBET,25048,49,24220,308,471,520,2022-03-10
317506,JAKARTA TIMUR,CAKUNG,31071,39,30278,444,310,349,2022-03-11
317105,JAKARTA PUSAT,CEMPAKA PUTIH,14525,30,14116,185,194,224,2022-03-11
317301,JAKARTA BARAT,CENGKARENG,40308,92,39211,603,402,494,2022-03-11
317406,JAKARTA SELATAN,CILANDAK,26217,84,25286,287,560,644,2022-03-11
317204,JAKARTA UTARA,CILINCING,23563,33,22961,363,206,239,2022-03-11
317510,JAKARTA TIMUR,CIPAYUNG,32688,41,31918,295,434,475,2022-03-11
317509,JAKARTA TIMUR,CIRACAS,29797,28,28983,408,378,406,2022-03-11
317507,JAKARTA TIMUR,DUREN SAWIT,42625,69,41188,669,699,768,2022-03-11
317101,JAKARTA PUSAT,GAMBIR,12035,16,11737,154,128,144,2022-03-11
317302,JAKARTA BARAT,GROGOL PETAMBURAN,28867,84,28024,327,432,516,2022-03-11
317409,JAKARTA SELATAN,JAGAKARSA,36074,44,35088,441,501,545,2022-03-11
317503,JAKARTA TIMUR,JATINEGARA,27592,36,26847,417,292,328,2022-03-11
317108,JAKARTA PUSAT,JOHAR BARU,12157,19,11864,178,96,115,2022-03-11
317306,JAKARTA BARAT,KALI DERES,26601,68,25791,339,403,471,2022-03-11
317407,JAKARTA SELATAN,KEBAYORAN BARU,19746,39,19107,207,393,432,2022-03-11
317405,JAKARTA SELATAN,KEBAYORAN LAMA,29684,55,28669,398,562,617,2022-03-11
317305,JAKARTA BARAT,KEBON JERUK,33848,90,32832,418,508,598,2022-03-11
317206,JAKARTA UTARA,KELAPA GADING,20520,32,19877,205,406,438,2022-03-11
317103,JAKARTA PUSAT,KEMAYORAN,27117,40,26411,407,259,299,2022-03-11
317308,JAKARTA BARAT,KEMBANGAN,29752,74,28806,329,543,617,2022-03-11
310102,KAB.ADM.KEP.SERIBU,KEP. SERIBU SELATAN,748,0,738,10,0,0,2022-03-11
310101,KAB.ADM.KEP.SERIBU,KEP. SERIBU UTARA,741,0,735,6,0,0,2022-03-11
317203,JAKARTA UTARA,KOJA,22988,23,22429,353,183,206,2022-03-11
317504,JAKARTA TIMUR,KRAMAT JATI,29341,50,28496,427,368,418,2022-03-11
111111,LUAR DKI JAKARTA,LUAR DKI JAKARTA,92308,8,91594,615,91,99,2022-03-11
317508,JAKARTA TIMUR,MAKASAR,24409,56,23660,319,374,430,2022-03-11
317403,JAKARTA SELATAN,MAMPANG PRAPATAN,16294,21,15883,187,203,224,2022-03-11
317501,JAKARTA TIMUR,MATRAMAN,19759,24,19230,304,201,225,2022-03-11
317106,JAKARTA PUSAT,MENTENG,9403,23,9152,131,97,120,2022-03-11
317205,JAKARTA UTARA,PADEMANGAN,17377,41,17024,185,127,168,2022-03-11
317307,JAKARTA BARAT,PALMERAH,21815,50,21205,358,202,252,2022-03-11
317408,JAKARTA SELATAN,PANCORAN,20914,29,20260,244,381,410,2022-03-11
317404,JAKARTA SELATAN,PASAR MINGGU,33912,41,32855,455,561,602,2022-03-11
317505,JAKARTA TIMUR,PASAR REBO,23352,31,22635,343,343,374,2022-03-11
317201,JAKARTA UTARA,PENJARINGAN,28850,82,28044,250,474,556,2022-03-11
317410,JAKARTA SELATAN,PESANGGRAHAN,22936,31,22264,278,363,394,2022-03-11
111111,PROSES UPDATE DATA,PROSES UPDATE DATA,97674,2219,87254,901,7300,9519,2022-03-11
317502,JAKARTA TIMUR,PULO GADUNG,32105,61,31128,449,467,528,2022-03-11
317102,JAKARTA PUSAT,SAWAH BESAR,13506,34,13155,187,130,164,2022-03-11
317104,JAKARTA PUSAT,SENEN,13218,27,12869,175,147,174,2022-03-11
317402,JAKARTA SELATAN,SETIA BUDI,16906,30,16467,198,211,241,2022-03-11
317303,JAKARTA BARAT,TAMAN SARI,12947,43,12618,163,123,166,2022-03-11
317304,JAKARTA BARAT,TAMBORA,20639,42,20127,284,186,228,2022-03-11
317107,JAKARTA PUSAT,TANAH ABANG,15691,20,15252,242,177,197,2022-03-11
317202,JAKARTA UTARA,TANJUNG PRIOK,36296,82,35382,449,383,465,2022-03-11
317401,JAKARTA SELATAN,TEBET,25105,43,24311,309,442,485,2022-03-11
317506,JAKARTA TIMUR,CAKUNG,31098,33,30334,444,287,320,2022-03-12
317105,JAKARTA PUSAT,CEMPAKA PUTIH,14545,26,14154,185,180,206,2022-03-12
317301,JAKARTA BARAT,CENGKARENG,40346,87,39295,604,360,447,2022-03-12
317406,JAKARTA SELATAN,CILANDAK,26270,72,25383,287,528,600,2022-03-12
317204,JAKARTA UTARA,CILINCING,23588,27,23017,363,181,208,2022-03-12
317510,JAKARTA TIMUR,CIPAYUNG,32743,38,32003,296,406,444,2022-03-12
317509,JAKARTA TIMUR,CIRACAS,29832,20,29079,409,324,344,2022-03-12
317507,JAKARTA TIMUR,DUREN SAWIT,42680,63,41305,671,641,704,2022-03-12
317101,JAKARTA PUSAT,GAMBIR,12046,18,11759,154,115,133,2022-03-12
317302,JAKARTA BARAT,GROGOL PETAMBURAN,28921,80,28103,329,409,489,2022-03-12
317409,JAKARTA SELATAN,JAGAKARSA,36142,39,35189,443,471,510,2022-03-12
317503,JAKARTA TIMUR,JATINEGARA,27620,32,26917,417,254,286,2022-03-12
317108,JAKARTA PUSAT,JOHAR BARU,12166,19,11879,178,90,109,2022-03-12
317306,JAKARTA BARAT,KALI DERES,26639,62,25858,339,380,442,2022-03-12
317407,JAKARTA SELATAN,KEBAYORAN BARU,19778,38,19179,210,351,389,2022-03-12
317405,JAKARTA SELATAN,KEBAYORAN LAMA,29750,41,28779,399,531,572,2022-03-12
317305,JAKARTA BARAT,KEBON JERUK,33892,82,32921,419,470,552,2022-03-12
317206,JAKARTA UTARA,KELAPA GADING,20575,25,19964,205,381,406,2022-03-12
317103,JAKARTA PUSAT,KEMAYORAN,27139,33,26484,407,215,248,2022-03-12
317308,JAKARTA BARAT,KEMBANGAN,29785,75,28900,329,481,556,2022-03-12
310102,KAB.ADM.KEP.SERIBU,KEP. SERIBU SELATAN,749,0,738,10,1,1,2022-03-12
310101,KAB.ADM.KEP.SERIBU,KEP. SERIBU UTARA,741,0,735,6,0,0,2022-03-12
317203,JAKARTA UTARA,KOJA,23004,20,22464,353,167,187,2022-03-12
317504,JAKARTA TIMUR,KRAMAT JATI,29375,46,28558,427,344,390,2022-03-12
111111,LUAR DKI JAKARTA,LUAR DKI JAKARTA,92324,5,91612,615,92,97,2022-03-12
317508,JAKARTA TIMUR,MAKASAR,24441,48,23731,320,342,390,2022-03-12
317403,JAKARTA SELATAN,MAMPANG PRAPATAN,16317,20,15911,187,199,219,2022-03-12
317501,JAKARTA TIMUR,MATRAMAN,19778,21,19272,305,180,201,2022-03-12
317106,JAKARTA PUSAT,MENTENG,9417,18,9168,131,100,118,2022-03-12
317205,JAKARTA UTARA,PADEMANGAN,17394,36,17057,185,116,152,2022-03-12
317307,JAKARTA BARAT,PALMERAH,21837,41,21253,359,184,225,2022-03-12
317408,JAKARTA SELATAN,PANCORAN,20945,32,20346,244,323,355,2022-03-12
317404,JAKARTA SELATAN,PASAR MINGGU,33975,39,32966,456,514,553,2022-03-12
317505,JAKARTA TIMUR,PASAR REBO,23372,28,22683,344,317,345,2022-03-12
317201,JAKARTA UTARA,PENJARINGAN,28901,80,28133,251,437,517,2022-03-12
317410,JAKARTA SELATAN,PESANGGRAHAN,22984,28,22316,278,362,390,2022-03-12
111111,PROSES UPDATE DATA,PROSES UPDATE DATA,98383,2096,88954,903,6430,8526,2022-03-12
317502,JAKARTA TIMUR,PULO GADUNG,32157,52,31218,449,438,490,2022-03-12
317102,JAKARTA PUSAT,SAWAH BESAR,13520,32,13172,188,128,160,2022-03-12
317104,JAKARTA PUSAT,SENEN,13233,22,12904,175,132,154,2022-03-12
317402,JAKARTA SELATAN,SETIA BUDI,16899,28,16489,198,184,212,2022-03-12
317303,JAKARTA BARAT,TAMAN SARI,12963,36,12650,163,114,150,2022-03-12
317304,JAKARTA BARAT,TAMBORA,20659,36,20170,285,168,204,2022-03-12
317107,JAKARTA PUSAT,TANAH ABANG,15703,18,15279,242,164,182,2022-03-12
317202,JAKARTA UTARA,TANJUNG PRIOK,36355,66,35454,449,386,452,2022-03-12
317401,JAKARTA SELATAN,TEBET,25145,38,24389,310,408,446,2022-03-12
317506,JAKARTA TIMUR,CAKUNG,31124,31,30364,444,285,316,2022-03-13
317105,JAKARTA PUSAT,CEMPAKA PUTIH,14560,27,14167,186,180,207,2022-03-13
317301,JAKARTA BARAT,CENGKARENG,40399,90,39334,608,367,457,2022-03-13
317406,JAKARTA SELATAN,CILANDAK,26321,55,25441,287,538,593,2022-03-13
317204,JAKARTA UTARA,CILINCING,23599,25,23036,364,174,199,2022-03-13
317510,JAKARTA TIMUR,CIPAYUNG,32779,40,32039,297,403,443,2022-03-13
317509,JAKARTA TIMUR,CIRACAS,29865,24,29103,410,328,352,2022-03-13
317507,JAKARTA TIMUR,DUREN SAWIT,42747,70,41384,673,620,690,2022-03-13
317101,JAKARTA PUSAT,GAMBIR,12060,22,11771,154,113,135,2022-03-13
317302,JAKARTA BARAT,GROGOL PETAMBURAN,28960,79,28158,329,394,473,2022-03-13
317409,JAKARTA SELATAN,JAGAKARSA,36184,41,35225,445,473,514,2022-03-13
317503,JAKARTA TIMUR,JATINEGARA,27657,32,26956,421,248,280,2022-03-13
317108,JAKARTA PUSAT,JOHAR BARU,12173,18,11891,178,86,104,2022-03-13
317306,JAKARTA BARAT,KALI DERES,26667,58,25903,339,367,425,2022-03-13
317407,JAKARTA SELATAN,KEBAYORAN BARU,19794,33,19222,210,329,362,2022-03-13
317405,JAKARTA SELATAN,KEBAYORAN LAMA,29788,39,28829,399,521,560,2022-03-13
317305,JAKARTA BARAT,KEBON JERUK,33925,78,32975,420,452,530,2022-03-13
317206,JAKARTA UTARA,KELAPA GADING,20604,27,20005,205,367,394,2022-03-13
317103,JAKARTA PUSAT,KEMAYORAN,27162,31,26514,408,209,240,2022-03-13
317308,JAKARTA BARAT,KEMBANGAN,29818,80,28950,330,458,538,2022-03-13
310102,KAB.ADM.KEP.SERIBU,KEP. SERIBU SELATAN,749,0,738,10,1,1,2022-03-13
310101,KAB.ADM.KEP.SERIBU,KEP. SERIBU UTARA,741,0,735,6,0,0,2022-03-13
317203,JAKARTA UTARA,KOJA,23015,20,22473,353,169,189,2022-03-13
317504,JAKARTA TIMUR,KRAMAT JATI,29413,43,28604,427,339,382,2022-03-13
111111,LUAR DKI JAKARTA,LUAR DKI JAKARTA,92332,5,91622,615,90,95,2022-03-13
317508,JAKARTA TIMUR,MAKASAR,24459,43,23764,320,332,375,2022-03-13
317403,JAKARTA SELATAN,MAMPANG PRAPATAN,16331,20,15925,187,199,219,2022-03-13
317501,JAKARTA TIMUR,MATRAMAN,19788,20,19293,306,169,189,2022-03-13
317106,JAKARTA PUSAT,MENTENG,9425,18,9182,132,93,111,2022-03-13
317205,JAKARTA UTARA,PADEMANGAN,17409,33,17078,187,111,144,2022-03-13
317307,JAKARTA BARAT,PALMERAH,21859,43,21273,359,184,227,2022-03-13
317408,JAKARTA SELATAN,PANCORAN,20977,24,20380,245,328,352,2022-03-13
317404,JAKARTA SELATAN,PASAR MINGGU,34027,44,33021,458,504,548,2022-03-13
317505,JAKARTA TIMUR,PASAR REBO,23405,38,22704,345,318,356,2022-03-13
317201,JAKARTA UTARA,PENJARINGAN,28957,83,28180,252,442,525,2022-03-13
317410,JAKARTA SELATAN,PESANGGRAHAN,23014,23,22361,278,352,375,2022-03-13
111111,PROSES UPDATE DATA,PROSES UPDATE DATA,99081,2085,90000,905,6091,8176,2022-03-13
317502,JAKARTA TIMUR,PULO GADUNG,32186,48,31270,449,419,467,2022-03-13
317102,JAKARTA PUSAT,SAWAH BESAR,13535,32,13190,188,125,157,2022-03-13
317104,JAKARTA PUSAT,SENEN,13257,35,12913,175,134,169,2022-03-13
317402,JAKARTA SELATAN,SETIA BUDI,16917,29,16518,198,172,201,2022-03-13
317303,JAKARTA BARAT,TAMAN SARI,12977,35,12667,164,111,146,2022-03-13
317304,JAKARTA BARAT,TAMBORA,20674,33,20188,285,168,201,2022-03-13
317107,JAKARTA PUSAT,TANAH ABANG,15718,18,15300,242,158,176,2022-03-13
317202,JAKARTA UTARA,TANJUNG PRIOK,36386,54,35498,450,384,438,2022-03-13
317401,JAKARTA SELATAN,TEBET,25182,36,24432,312,402,438,2022-03-13
317506,JAKARTA TIMUR,CAKUNG,31135,25,30421,446,243,268,2022-03-14
317105,JAKARTA PUSAT,CEMPAKA PUTIH,14573,24,14203,187,159,183,2022-03-14
317301,JAKARTA BARAT,CENGKARENG,40422,76,39416,609,321,397,2022-03-14
317406,JAKARTA SELATAN,CILANDAK,26363,40,25538,290,495,535,2022-03-14
317204,JAKARTA UTARA,CILINCING,23614,21,23078,365,150,171,2022-03-14
317510,JAKARTA TIMUR,CIPAYUNG,32797,35,32128,298,336,371,2022-03-14
317509,JAKARTA TIMUR,CIRACAS,29900,25,29173,411,291,316,2022-03-14
317507,JAKARTA TIMUR,DUREN SAWIT,42784,61,41506,675,542,603,2022-03-14
317101,JAKARTA PUSAT,GAMBIR,12073,19,11796,154,104,123,2022-03-14
317302,JAKARTA BARAT,GROGOL PETAMBURAN,28983,65,28246,330,342,407,2022-03-14
317409,JAKARTA SELATAN,JAGAKARSA,36209,44,35296,445,424,468,2022-03-14
317503,JAKARTA TIMUR,JATINEGARA,27669,35,27015,422,197,232,2022-03-14
317108,JAKARTA PUSAT,JOHAR BARU,12180,17,11914,179,70,87,2022-03-14
317306,JAKARTA BARAT,KALI DERES,26684,43,25982,339,320,363,2022-03-14
317407,JAKARTA SELATAN,KEBAYORAN BARU,19815,28,19301,210,276,304,2022-03-14
317405,JAKARTA SELATAN,KEBAYORAN LAMA,29818,34,28915,399,470,504,2022-03-14
317305,JAKARTA BARAT,KEBON JERUK,33946,58,33084,420,384,442,2022-03-14
317206,JAKARTA UTARA,KELAPA GADING,20625,25,20081,206,313,338,2022-03-14
317103,JAKARTA PUSAT,KEMAYORAN,27173,24,26557,408,184,208,2022-03-14
317308,JAKARTA BARAT,KEMBANGAN,29853,83,29039,331,400,483,2022-03-14
310102,KAB.ADM.KEP.SERIBU,KEP. SERIBU SELATAN,748,0,738,10,0,0,2022-03-14
310101,KAB.ADM.KEP.SERIBU,KEP. SERIBU UTARA,741,0,735,6,0,0,2022-03-14
317203,JAKARTA UTARA,KOJA,23035,13,22518,354,150,163,2022-03-14
317504,JAKARTA TIMUR,KRAMAT JATI,29424,36,28662,428,298,334,2022-03-14
111111,LUAR DKI JAKARTA,LUAR DKI JAKARTA,92346,4,91643,615,84,88,2022-03-14
317508,JAKARTA TIMUR,MAKASAR,24470,32,23831,320,287,319,2022-03-14
317403,JAKARTA SELATAN,MAMPANG PRAPATAN,16336,19,15972,187,158,177,2022-03-14
317501,JAKARTA TIMUR,MATRAMAN,19801,15,19334,306,146,161,2022-03-14
317106,JAKARTA PUSAT,MENTENG,9436,12,9208,132,84,96,2022-03-14
317205,JAKARTA UTARA,PADEMANGAN,17413,26,17106,187,94,120,2022-03-14
317307,JAKARTA BARAT,PALMERAH,21872,33,21320,360,159,192,2022-03-14
317408,JAKARTA SELATAN,PANCORAN,21000,28,20453,245,274,302,2022-03-14
317404,JAKARTA SELATAN,PASAR MINGGU,34063,41,33116,458,448,489,2022-03-14
317505,JAKARTA TIMUR,PASAR REBO,23418,29,22768,346,275,304,2022-03-14
317201,JAKARTA UTARA,PENJARINGAN,28984,72,28259,252,401,473,2022-03-14
317410,JAKARTA SELATAN,PESANGGRAHAN,23028,16,22430,279,303,319,2022-03-14
111111,PROSES UPDATE DATA,PROSES UPDATE DATA,99590,1835,91475,908,5372,7207,2022-03-14
317502,JAKARTA TIMUR,PULO GADUNG,32219,48,31346,452,373,421,2022-03-14
317102,JAKARTA PUSAT,SAWAH BESAR,13547,29,13221,188,109,138,2022-03-14
317104,JAKARTA PUSAT,SENEN,13267,29,12942,175,121,150,2022-03-14
317402,JAKARTA SELATAN,SETIA BUDI,16935,34,16555,198,148,182,2022-03-14
317303,JAKARTA BARAT,TAMAN SARI,12989,32,12692,165,100,132,2022-03-14
317304,JAKARTA BARAT,TAMBORA,20688,36,20223,285,144,180,2022-03-14
317107,JAKARTA PUSAT,TANAH ABANG,15731,14,15336,244,137,151,2022-03-14
317202,JAKARTA UTARA,TANJUNG PRIOK,36415,40,35575,451,349,389,2022-03-14
317401,JAKARTA SELATAN,TEBET,25195,24,24520,313,338,362,2022-03-14
317506,JAKARTA TIMUR,CAKUNG,31149,22,30455,448,224,246,2022-03-15
317105,JAKARTA PUSAT,CEMPAKA PUTIH,14578,22,14224,187,145,167,2022-03-15
317301,JAKARTA BARAT,CENGKARENG,40464,56,39490,610,308,364,2022-03-15
317406,JAKARTA SELATAN,CILANDAK,26415,38,25611,291,475,513,2022-03-15
317204,JAKARTA UTARA,CILINCING,23622,17,23098,365,142,159,2022-03-15
317510,JAKARTA TIMUR,CIPAYUNG,32820,28,32170,299,323,351,2022-03-15
317509,JAKARTA TIMUR,CIRACAS,29915,23,29198,411,283,306,2022-03-15
317507,JAKARTA TIMUR,DUREN SAWIT,42822,51,41580,678,513,564,2022-03-15
317101,JAKARTA PUSAT,GAMBIR,12086,19,11810,155,102,121,2022-03-15
317302,JAKARTA BARAT,GROGOL PETAMBURAN,29014,51,28308,330,325,376,2022-03-15
317409,JAKARTA SELATAN,JAGAKARSA,36248,40,35353,446,409,449,2022-03-15
317503,JAKARTA TIMUR,JATINEGARA,27693,34,27034,424,201,235,2022-03-15
317108,JAKARTA PUSAT,JOHAR BARU,12187,16,11920,179,72,88,2022-03-15
317306,JAKARTA BARAT,KALI DERES,26714,28,26039,339,308,336,2022-03-15
317407,JAKARTA SELATAN,KEBAYORAN BARU,19824,24,19328,211,261,285,2022-03-15
317405,JAKARTA SELATAN,KEBAYORAN LAMA,29865,28,28981,400,456,484,2022-03-15
317305,JAKARTA BARAT,KEBON JERUK,33989,40,33147,420,382,422,2022-03-15
317206,JAKARTA UTARA,KELAPA GADING,20670,18,20117,207,328,346,2022-03-15
317103,JAKARTA PUSAT,KEMAYORAN,27188,22,26580,408,178,200,2022-03-15
317308,JAKARTA BARAT,KEMBANGAN,29877,67,29110,331,369,436,2022-03-15
310102,KAB.ADM.KEP.SERIBU,KEP. SERIBU SELATAN,748,0,738,10,0,0,2022-03-15
310101,KAB.ADM.KEP.SERIBU,KEP. SERIBU UTARA,741,0,735,6,0,0,2022-03-15
317203,JAKARTA UTARA,KOJA,23038,12,22536,355,135,147,2022-03-15
317504,JAKARTA TIMUR,KRAMAT JATI,29432,30,28689,428,285,315,2022-03-15
111111,LUAR DKI JAKARTA,LUAR DKI JAKARTA,92372,5,91669,615,83,88,2022-03-15
317508,JAKARTA TIMUR,MAKASAR,24488,25,23860,320,283,308,2022-03-15
317403,JAKARTA SELATAN,MAMPANG PRAPATAN,16344,10,15990,188,156,166,2022-03-15
317501,JAKARTA TIMUR,MATRAMAN,19817,14,19355,307,141,155,2022-03-15
317106,JAKARTA PUSAT,MENTENG,9441,14,9222,132,73,87,2022-03-15
317205,JAKARTA UTARA,PADEMANGAN,17429,17,17136,187,89,106,2022-03-15
317307,JAKARTA BARAT,PALMERAH,21895,27,21347,360,161,188,2022-03-15
317408,JAKARTA SELATAN,PANCORAN,21017,27,20483,246,261,288,2022-03-15
317404,JAKARTA SELATAN,PASAR MINGGU,34101,37,33175,459,430,467,2022-03-15
317505,JAKARTA TIMUR,PASAR REBO,23428,28,22796,346,258,286,2022-03-15
317201,JAKARTA UTARA,PENJARINGAN,29033,65,28321,252,395,460,2022-03-15
317410,JAKARTA SELATAN,PESANGGRAHAN,23054,14,22464,279,297,311,2022-03-15
111111,PROSES UPDATE DATA,PROSES UPDATE DATA,100204,1741,92565,913,4985,6726,2022-03-15
317502,JAKARTA TIMUR,PULO GADUNG,32252,39,31408,454,351,390,2022-03-15
317102,JAKARTA PUSAT,SAWAH BESAR,13561,24,13243,188,106,130,2022-03-15
317104,JAKARTA PUSAT,SENEN,13276,23,12954,176,123,146,2022-03-15
317402,JAKARTA SELATAN,SETIA BUDI,16957,26,16578,198,155,181,2022-03-15
317303,JAKARTA BARAT,TAMAN SARI,13002,27,12712,165,98,125,2022-03-15
317304,JAKARTA BARAT,TAMBORA,20704,34,20241,286,143,177,2022-03-15
317107,JAKARTA PUSAT,TANAH ABANG,15744,12,15347,244,141,153,2022-03-15
317202,JAKARTA UTARA,TANJUNG PRIOK,36435,32,35626,453,324,356,2022-03-15
317401,JAKARTA SELATAN,TEBET,25225,22,24564,313,326,348,2022-03-15
317506,JAKARTA TIMUR,CAKUNG,31176,21,30483,448,224,245,2022-03-16
317105,JAKARTA PUSAT,CEMPAKA PUTIH,14598,20,14241,188,149,169,2022-03-16
317301,JAKARTA BARAT,CENGKARENG,40491,50,39525,611,305,355,2022-03-16
317406,JAKARTA SELATAN,CILANDAK,26457,40,25667,291,459,499,2022-03-16
317204,JAKARTA UTARA,CILINCING,23638,17,23111,365,145,162,2022-03-16
317510,JAKARTA TIMUR,CIPAYUNG,32841,30,32199,299,313,343,2022-03-16
317509,JAKARTA TIMUR,CIRACAS,29941,25,29226,411,279,304,2022-03-16
317507,JAKARTA TIMUR,DUREN SAWIT,42880,52,41654,678,496,548,2022-03-16
317101,JAKARTA PUSAT,GAMBIR,12097,19,11816,156,106,125,2022-03-16
317302,JAKARTA BARAT,GROGOL PETAMBURAN,29044,46,28347,330,321,367,2022-03-16
317409,JAKARTA SELATAN,JAGAKARSA,36297,39,35399,446,413,452,2022-03-16
317503,JAKARTA TIMUR,JATINEGARA,27713,34,27047,424,208,242,2022-03-16
317108,JAKARTA PUSAT,JOHAR BARU,12197,17,11919,179,82,99,2022-03-16
317306,JAKARTA BARAT,KALI DERES,26742,25,26069,339,309,334,2022-03-16
317407,JAKARTA SELATAN,KEBAYORAN BARU,19863,26,19360,211,266,292,2022-03-16
317405,JAKARTA SELATAN,KEBAYORAN LAMA,29906,29,29027,400,450,479,2022-03-16
317305,JAKARTA BARAT,KEBON JERUK,34040,43,33203,421,373,416,2022-03-16
317206,JAKARTA UTARA,KELAPA GADING,20717,18,20145,207,347,365,2022-03-16
317103,JAKARTA PUSAT,KEMAYORAN,27208,23,26602,408,175,198,2022-03-16
317308,JAKARTA BARAT,KEMBANGAN,29908,62,29158,331,357,419,2022-03-16
310102,KAB.ADM.KEP.SERIBU,KEP. SERIBU SELATAN,748,0,738,10,0,0,2022-03-16
310101,KAB.ADM.KEP.SERIBU,KEP. SERIBU UTARA,741,0,735,6,0,0,2022-03-16
317203,JAKARTA UTARA,KOJA,23056,12,22550,355,139,151,2022-03-16
317504,JAKARTA TIMUR,KRAMAT JATI,29473,27,28723,429,294,321,2022-03-16
111111,LUAR DKI JAKARTA,LUAR DKI JAKARTA,92373,4,91680,615,74,78,2022-03-16
317508,JAKARTA TIMUR,MAKASAR,24508,27,23888,320,273,300,2022-03-16
317403,JAKARTA SELATAN,MAMPANG PRAPATAN,16364,12,16003,188,161,173,2022-03-16
317501,JAKARTA TIMUR,MATRAMAN,19839,12,19369,307,151,163,2022-03-16
317106,JAKARTA PUSAT,MENTENG,9448,14,9230,132,72,86,2022-03-16
317205,JAKARTA UTARA,PADEMANGAN,17450,12,17152,187,99,111,2022-03-16
317307,JAKARTA BARAT,PALMERAH,21913,25,21358,361,169,194,2022-03-16
317408,JAKARTA SELATAN,PANCORAN,21038,24,20525,246,243,267,2022-03-16
317404,JAKARTA SELATAN,PASAR MINGGU,34157,36,33226,461,434,470,2022-03-16
317505,JAKARTA TIMUR,PASAR REBO,23454,28,22835,347,244,272,2022-03-16
317201,JAKARTA UTARA,PENJARINGAN,29074,61,28380,252,381,442,2022-03-16
317410,JAKARTA SELATAN,PESANGGRAHAN,23090,11,22496,279,304,315,2022-03-16
111111,PROSES UPDATE DATA,PROSES UPDATE DATA,100766,1728,93569,913,4556,6284,2022-03-16
317502,JAKARTA TIMUR,PULO GADUNG,32278,38,31451,456,333,371,2022-03-16
317102,JAKARTA PUSAT,SAWAH BESAR,13575,23,13253,188,111,134,2022-03-16
317104,JAKARTA PUSAT,SENEN,13291,23,12971,177,120,143,2022-03-16
317402,JAKARTA SELATAN,SETIA BUDI,16970,23,16601,198,148,171,2022-03-16
317303,JAKARTA BARAT,TAMAN SARI,13012,28,12719,165,100,128,2022-03-16
317304,JAKARTA BARAT,TAMBORA,20719,32,20264,286,137,169,2022-03-16
317107,JAKARTA PUSAT,TANAH ABANG,15750,13,15359,244,134,147,2022-03-16
317202,JAKARTA UTARA,TANJUNG PRIOK,36480,31,35677,453,319,350,2022-03-16
317401,JAKARTA SELATAN,TEBET,25263,22,24606,313,322,344,2022-03-16
317506,JAKARTA TIMUR,CAKUNG,31197,16,30543,449,189,205,2022-03-17
317105,JAKARTA PUSAT,CEMPAKA PUTIH,14608,14,14281,188,125,139,2022-03-17
317301,JAKARTA BARAT,CENGKARENG,40520,39,39592,611,278,317,2022-03-17
317406,JAKARTA SELATAN,CILANDAK,26507,34,25752,292,429,463,2022-03-17
317204,JAKARTA UTARA,CILINCING,23651,15,23144,365,127,142,2022-03-17
317510,JAKARTA TIMUR,CIPAYUNG,32870,22,32281,299,268,290,2022-03-17
317509,JAKARTA TIMUR,CIRACAS,29975,19,29307,411,238,257,2022-03-17
317507,JAKARTA TIMUR,DUREN SAWIT,42943,49,41768,678,448,497,2022-03-17
317101,JAKARTA PUSAT,GAMBIR,12107,12,11841,156,98,110,2022-03-17
317302,JAKARTA BARAT,GROGOL PETAMBURAN,29088,40,28422,330,296,336,2022-03-17
317409,JAKARTA SELATAN,JAGAKARSA,36335,29,35496,446,364,393,2022-03-17
317503,JAKARTA TIMUR,JATINEGARA,27731,24,27091,424,192,216,2022-03-17
317108,JAKARTA PUSAT,JOHAR BARU,12206,14,11938,179,75,89,2022-03-17
317306,JAKARTA BARAT,KALI DERES,26761,18,26121,339,283,301,2022-03-17
317407,JAKARTA SELATAN,KEBAYORAN BARU,19880,24,19428,212,216,240,2022-03-17
317405,JAKARTA SELATAN,KEBAYORAN LAMA,29948,31,29114,400,403,434,2022-03-17
317305,JAKARTA BARAT,KEBON JERUK,34084,39,33278,421,346,385,2022-03-17
317206,JAKARTA UTARA,KELAPA GADING,20743,13,20204,207,319,332,2022-03-17
317103,JAKARTA PUSAT,KEMAYORAN,27220,17,26633,409,161,178,2022-03-17
317308,JAKARTA BARAT,KEMBANGAN,29950,43,29266,331,310,353,2022-03-17
310102,KAB.ADM.KEP.SERIBU,KEP. SERIBU SELATAN,748,0,738,10,0,0,2022-03-17
310101,KAB.ADM.KEP.SERIBU,KEP. SERIBU UTARA,743,0,735,6,2,2,2022-03-17
317203,JAKARTA UTARA,KOJA,23067,12,22585,355,115,127,2022-03-17
317504,JAKARTA TIMUR,KRAMAT JATI,29496,20,28790,429,257,277,2022-03-17
111111,LUAR DKI JAKARTA,LUAR DKI JAKARTA,92379,3,91705,615,56,59,2022-03-17
317508,JAKARTA TIMUR,MAKASAR,24537,17,23975,320,225,242,2022-03-17
317403,JAKARTA SELATAN,MAMPANG PRAPATAN,16378,8,16045,188,137,145,2022-03-17
317501,JAKARTA TIMUR,MATRAMAN,19855,10,19396,307,142,152,2022-03-17
317106,JAKARTA PUSAT,MENTENG,9458,10,9242,132,74,84,2022-03-17
317205,JAKARTA UTARA,PADEMANGAN,17465,12,17169,187,97,109,2022-03-17
317307,JAKARTA BARAT,PALMERAH,21932,20,21402,361,149,169,2022-03-17
317408,JAKARTA SELATAN,PANCORAN,21062,21,20576,246,219,240,2022-03-17
317404,JAKARTA SELATAN,PASAR MINGGU,34197,29,33317,461,390,419,2022-03-17
317505,JAKARTA TIMUR,PASAR REBO,23473,21,22898,347,207,228,2022-03-17
317201,JAKARTA UTARA,PENJARINGAN,29124,54,28466,252,352,406,2022-03-17
317410,JAKARTA SELATAN,PESANGGRAHAN,23112,8,22569,279,256,264,2022-03-17
111111,PROSES UPDATE DATA,PROSES UPDATE DATA,101314,1570,94828,919,3997,5567,2022-03-17
317502,JAKARTA TIMUR,PULO GADUNG,32311,30,31534,456,291,321,2022-03-17
317102,JAKARTA PUSAT,SAWAH BESAR,13590,20,13271,188,111,131,2022-03-17
317104,JAKARTA PUSAT,SENEN,13296,21,13004,177,94,115,2022-03-17
317402,JAKARTA SELATAN,SETIA BUDI,16992,16,16631,198,147,163,2022-03-17
317303,JAKARTA BARAT,TAMAN SARI,13030,24,12748,165,93,117,2022-03-17
317304,JAKARTA BARAT,TAMBORA,20731,27,20299,286,119,146,2022-03-17
317107,JAKARTA PUSAT,TANAH ABANG,15760,10,15399,244,107,117,2022-03-17
317202,JAKARTA UTARA,TANJUNG PRIOK,36506,22,35733,454,297,319,2022-03-17
317401,JAKARTA SELATAN,TEBET,25287,18,24670,314,285,303,2022-03-17
317506,JAKARTA TIMUR,CAKUNG,31220,14,30585,449,172,186,2022-03-18
317105,JAKARTA PUSAT,CEMPAKA PUTIH,14616,11,14306,188,111,122,2022-03-18
317301,JAKARTA BARAT,CENGKARENG,40549,40,39644,611,254,294,2022-03-18
317406,JAKARTA SELATAN,CILANDAK,26547,34,25823,292,398,432,2022-03-18
317204,JAKARTA UTARA,CILINCING,23665,13,23167,365,120,133,2022-03-18
317510,JAKARTA TIMUR,CIPAYUNG,32890,21,32343,299,227,248,2022-03-18
317509,JAKARTA TIMUR,CIRACAS,30005,18,29348,411,228,246,2022-03-18
317507,JAKARTA TIMUR,DUREN SAWIT,42983,48,41843,678,414,462,2022-03-18
317101,JAKARTA PUSAT,GAMBIR,12116,12,11859,156,89,101,2022-03-18
317302,JAKARTA BARAT,GROGOL PETAMBURAN,29120,38,28466,330,286,324,2022-03-18
317409,JAKARTA SELATAN,JAGAKARSA,36355,26,35551,446,332,358,2022-03-18
317503,JAKARTA TIMUR,JATINEGARA,27745,21,27123,424,177,198,2022-03-18
317108,JAKARTA PUSAT,JOHAR BARU,12214,14,11957,179,64,78,2022-03-18
317306,JAKARTA BARAT,KALI DERES,26774,16,26206,340,212,228,2022-03-18
317407,JAKARTA SELATAN,KEBAYORAN BARU,19911,22,19461,212,216,238,2022-03-18
317405,JAKARTA SELATAN,KEBAYORAN LAMA,29982,29,29198,400,355,384,2022-03-18
317305,JAKARTA BARAT,KEBON JERUK,34138,36,33347,421,334,370,2022-03-18
317206,JAKARTA UTARA,KELAPA GADING,20779,15,20255,207,302,317,2022-03-18
317103,JAKARTA PUSAT,KEMAYORAN,27236,14,26670,409,143,157,2022-03-18
317308,JAKARTA BARAT,KEMBANGAN,29979,42,29340,331,266,308,2022-03-18
310102,KAB.ADM.KEP.SERIBU,KEP. SERIBU SELATAN,748,0,738,10,0,0,2022-03-18
310101,KAB.ADM.KEP.SERIBU,KEP. SERIBU UTARA,741,0,735,6,0,0,2022-03-18
317203,JAKARTA UTARA,KOJA,23072,11,22613,355,93,104,2022-03-18
317504,JAKARTA TIMUR,KRAMAT JATI,29534,21,28846,429,238,259,2022-03-18
111111,LUAR DKI JAKARTA,LUAR DKI JAKARTA,92394,2,91727,615,50,52,2022-03-18
317508,JAKARTA TIMUR,MAKASAR,24559,21,24029,320,189,210,2022-03-18
317403,JAKARTA SELATAN,MAMPANG PRAPATAN,16402,6,16071,188,137,143,2022-03-18
317501,JAKARTA TIMUR,MATRAMAN,19885,8,19421,307,149,157,2022-03-18
317106,JAKARTA PUSAT,MENTENG,9462,7,9263,132,60,67,2022-03-18
317205,JAKARTA UTARA,PADEMANGAN,17478,13,17187,187,91,104,2022-03-18
317307,JAKARTA BARAT,PALMERAH,21950,20,21424,362,144,164,2022-03-18
317408,JAKARTA SELATAN,PANCORAN,21085,21,20623,246,195,216,2022-03-18
317404,JAKARTA SELATAN,PASAR MINGGU,34235,28,33382,461,364,392,2022-03-18
317505,JAKARTA TIMUR,PASAR REBO,23493,22,22945,347,179,201,2022-03-18
317201,JAKARTA UTARA,PENJARINGAN,29168,53,28521,252,342,395,2022-03-18
317410,JAKARTA SELATAN,PESANGGRAHAN,23153,10,22608,279,256,266,2022-03-18
111111,PROSES UPDATE DATA,PROSES UPDATE DATA,101802,1567,95896,934,3405,4972,2022-03-18
317502,JAKARTA TIMUR,PULO GADUNG,32354,31,31590,457,276,307,2022-03-18
317102,JAKARTA PUSAT,SAWAH BESAR,13607,21,13291,188,107,128,2022-03-18
317104,JAKARTA PUSAT,SENEN,13314,20,13029,177,88,108,2022-03-18
317402,JAKARTA SELATAN,SETIA BUDI,16992,13,16646,198,135,148,2022-03-18
317303,JAKARTA BARAT,TAMAN SARI,13041,21,12766,165,89,110,2022-03-18
317304,JAKARTA BARAT,TAMBORA,20740,26,20321,286,107,133,2022-03-18
317107,JAKARTA PUSAT,TANAH ABANG,15773,10,15424,244,95,105,2022-03-18
317202,JAKARTA UTARA,TANJUNG PRIOK,36549,20,35790,454,285,305,2022-03-18
317401,JAKARTA SELATAN,TEBET,25328,16,24720,314,278,294,2022-03-18
317506,JAKARTA TIMUR,CAKUNG,31248,10,30615,449,174,184,2022-03-19
317105,JAKARTA PUSAT,CEMPAKA PUTIH,14627,9,14329,188,101,110,2022-03-19
317301,JAKARTA BARAT,CENGKARENG,40592,42,39690,611,249,291,2022-03-19
317406,JAKARTA SELATAN,CILANDAK,26597,33,25901,292,371,404,2022-03-19
317204,JAKARTA UTARA,CILINCING,23669,8,23202,365,94,102,2022-03-19
317510,JAKARTA TIMUR,CIPAYUNG,32923,23,32402,300,198,221,2022-03-19
317509,JAKARTA TIMUR,CIRACAS,30038,17,29397,412,212,229,2022-03-19
317507,JAKARTA TIMUR,DUREN SAWIT,43017,41,41931,678,367,408,2022-03-19
317101,JAKARTA PUSAT,GAMBIR,12127,12,11875,156,84,96,2022-03-19
317302,JAKARTA BARAT,GROGOL PETAMBURAN,29161,30,28530,330,271,301,2022-03-19
317409,JAKARTA SELATAN,JAGAKARSA,36395,24,35622,446,303,327,2022-03-19
317503,JAKARTA TIMUR,JATINEGARA,27766,18,27154,424,170,188,2022-03-19
317108,JAKARTA PUSAT,JOHAR BARU,12220,9,11973,179,59,68,2022-03-19
317306,JAKARTA BARAT,KALI DERES,26813,19,26255,341,198,217,2022-03-19
317407,JAKARTA SELATAN,KEBAYORAN BARU,19940,24,19508,212,196,220,2022-03-19
317405,JAKARTA SELATAN,KEBAYORAN LAMA,30012,25,29273,400,314,339,2022-03-19
317305,JAKARTA BARAT,KEBON JERUK,34172,38,33408,421,305,343,2022-03-19
317206,JAKARTA UTARA,KELAPA GADING,20813,17,20311,207,278,295,2022-03-19
317103,JAKARTA PUSAT,KEMAYORAN,27248,14,26702,409,123,137,2022-03-19
317308,JAKARTA BARAT,KEMBANGAN,30017,38,29404,331,244,282,2022-03-19
310102,KAB.ADM.KEP.SERIBU,KEP. SERIBU SELATAN,748,0,738,10,0,0,2022-03-19
310101,KAB.ADM.KEP.SERIBU,KEP. SERIBU UTARA,741,0,735,6,0,0,2022-03-19
317203,JAKARTA UTARA,KOJA,23092,13,22632,355,92,105,2022-03-19
317504,JAKARTA TIMUR,KRAMAT JATI,29549,16,28896,429,208,224,2022-03-19
111111,LUAR DKI JAKARTA,LUAR DKI JAKARTA,92400,1,91742,615,42,43,2022-03-19
317508,JAKARTA TIMUR,MAKASAR,24575,16,24078,320,161,177,2022-03-19
317403,JAKARTA SELATAN,MAMPANG PRAPATAN,16416,7,16088,188,133,140,2022-03-19
317501,JAKARTA TIMUR,MATRAMAN,19899,8,19454,308,129,137,2022-03-19
317106,JAKARTA PUSAT,MENTENG,9472,7,9267,132,66,73,2022-03-19
317205,JAKARTA UTARA,PADEMANGAN,17491,11,17196,188,96,107,2022-03-19
317307,JAKARTA BARAT,PALMERAH,21982,15,21448,362,157,172,2022-03-19
317408,JAKARTA SELATAN,PANCORAN,21116,19,20655,246,196,215,2022-03-19
317404,JAKARTA SELATAN,PASAR MINGGU,34270,26,33448,461,335,361,2022-03-19
317505,JAKARTA TIMUR,PASAR REBO,23513,20,22997,347,149,169,2022-03-19
317201,JAKARTA UTARA,PENJARINGAN,29202,52,28568,252,330,382,2022-03-19
317410,JAKARTA SELATAN,PESANGGRAHAN,23174,9,22649,279,237,246,2022-03-19
111111,PROSES UPDATE DATA,PROSES UPDATE DATA,102240,1470,96742,941,3087,4557,2022-03-19
317502,JAKARTA TIMUR,PULO GADUNG,32384,29,31637,457,261,290,2022-03-19
317102,JAKARTA PUSAT,SAWAH BESAR,13619,20,13308,188,103,123,2022-03-19
317104,JAKARTA PUSAT,SENEN,13318,16,13044,177,81,97,2022-03-19
317402,JAKARTA SELATAN,SETIA BUDI,17025,12,16671,198,144,156,2022-03-19
317303,JAKARTA BARAT,TAMAN SARI,13053,20,12781,165,87,107,2022-03-19
317304,JAKARTA BARAT,TAMBORA,20750,25,20345,286,94,119,2022-03-19
317107,JAKARTA PUSAT,TANAH ABANG,15795,13,15440,244,98,111,2022-03-19
317202,JAKARTA UTARA,TANJUNG PRIOK,36581,23,35855,454,249,272,2022-03-19
317401,JAKARTA SELATAN,TEBET,25368,16,24773,314,265,281,2022-03-19
317506,JAKARTA TIMUR,CAKUNG,31263,11,30646,449,157,168,2022-03-20
317105,JAKARTA PUSAT,CEMPAKA PUTIH,14639,12,14355,188,84,96,2022-03-20
317301,JAKARTA BARAT,CENGKARENG,40615,42,39738,611,224,266,2022-03-20
317406,JAKARTA SELATAN,CILANDAK,26635,47,25959,293,336,383,2022-03-20
317204,JAKARTA UTARA,CILINCING,23679,9,23224,365,81,90,2022-03-20
317510,JAKARTA TIMUR,CIPAYUNG,32948,23,32455,300,170,193,2022-03-20
317509,JAKARTA TIMUR,CIRACAS,30069,21,29430,413,205,226,2022-03-20
317507,JAKARTA TIMUR,DUREN SAWIT,43046,47,41996,679,324,371,2022-03-20
317101,JAKARTA PUSAT,GAMBIR,12132,12,11895,156,69,81,2022-03-20
317302,JAKARTA BARAT,GROGOL PETAMBURAN,29183,37,28591,331,224,261,2022-03-20
317409,JAKARTA SELATAN,JAGAKARSA,36417,27,35701,446,243,270,2022-03-20
317503,JAKARTA TIMUR,JATINEGARA,27781,19,27179,424,159,178,2022-03-20
317108,JAKARTA PUSAT,JOHAR BARU,12226,8,11984,179,55,63,2022-03-20
317306,JAKARTA BARAT,KALI DERES,26839,27,26297,342,173,200,2022-03-20
317407,JAKARTA SELATAN,KEBAYORAN BARU,19950,24,19537,212,177,201,2022-03-20
317405,JAKARTA SELATAN,KEBAYORAN LAMA,30030,29,29327,400,274,303,2022-03-20
317305,JAKARTA BARAT,KEBON JERUK,34208,46,33467,421,274,320,2022-03-20
317206,JAKARTA UTARA,KELAPA GADING,20830,18,20353,207,252,270,2022-03-20
317103,JAKARTA PUSAT,KEMAYORAN,27272,17,26735,411,109,126,2022-03-20
317308,JAKARTA BARAT,KEMBANGAN,30040,41,29450,331,218,259,2022-03-20
310102,KAB.ADM.KEP.SERIBU,KEP. SERIBU SELATAN,748,0,738,10,0,0,2022-03-20
310101,KAB.ADM.KEP.SERIBU,KEP. SERIBU UTARA,741,0,735,6,0,0,2022-03-20
317203,JAKARTA UTARA,KOJA,23102,24,22649,355,74,98,2022-03-20
317504,JAKARTA TIMUR,KRAMAT JATI,29566,12,28930,429,195,207,2022-03-20
111111,LUAR DKI JAKARTA,LUAR DKI JAKARTA,92404,2,91747,615,40,42,2022-03-20
317508,JAKARTA TIMUR,MAKASAR,24582,20,24108,320,134,154,2022-03-20
317403,JAKARTA SELATAN,MAMPANG PRAPATAN,16440,6,16110,188,136,142,2022-03-20
317501,JAKARTA TIMUR,MATRAMAN,19912,13,19474,309,116,129,2022-03-20
317106,JAKARTA PUSAT,MENTENG,9482,8,9280,132,62,70,2022-03-20
317205,JAKARTA UTARA,PADEMANGAN,17496,9,17209,188,90,99,2022-03-20
317307,JAKARTA BARAT,PALMERAH,21992,16,21485,362,129,145,2022-03-20
317408,JAKARTA SELATAN,PANCORAN,21124,15,20693,246,170,185,2022-03-20
317404,JAKARTA SELATAN,PASAR MINGGU,34302,35,33510,461,296,331,2022-03-20
317505,JAKARTA TIMUR,PASAR REBO,23517,15,23033,347,122,137,2022-03-20
317201,JAKARTA UTARA,PENJARINGAN,29221,54,28627,252,288,342,2022-03-20
317410,JAKARTA SELATAN,PESANGGRAHAN,23200,11,22697,281,211,222,2022-03-20
111111,PROSES UPDATE DATA,PROSES UPDATE DATA,102689,1376,97465,941,2907,4283,2022-03-20
317502,JAKARTA TIMUR,PULO GADUNG,32401,26,31686,458,231,257,2022-03-20
317102,JAKARTA PUSAT,SAWAH BESAR,13632,21,13324,188,99,120,2022-03-20
317104,JAKARTA PUSAT,SENEN,13324,12,13058,177,77,89,2022-03-20
317402,JAKARTA SELATAN,SETIA BUDI,17034,12,16692,198,132,144,2022-03-20
317303,JAKARTA BARAT,TAMAN SARI,13063,24,12792,166,81,105,2022-03-20
317304,JAKARTA BARAT,TAMBORA,20763,25,20367,286,85,110,2022-03-20
317107,JAKARTA PUSAT,TANAH ABANG,15810,18,15466,245,81,99,2022-03-20
317202,JAKARTA UTARA,TANJUNG PRIOK,36598,36,35900,455,207,243,2022-03-20
317401,JAKARTA SELATAN,TEBET,25390,17,24826,314,233,250,2022-03-20
317506,JAKARTA TIMUR,CAKUNG,31269,19,30668,449,133,152,2022-03-21
317105,JAKARTA PUSAT,CEMPAKA PUTIH,14639,14,14374,188,63,77,2022-03-21
317301,JAKARTA BARAT,CENGKARENG,40627,44,39783,611,189,233,2022-03-21
317406,JAKARTA SELATAN,CILANDAK,26661,58,26012,293,298,356,2022-03-21
317204,JAKARTA UTARA,CILINCING,23684,17,23234,365,68,85,2022-03-21
317510,JAKARTA TIMUR,CIPAYUNG,32964,27,32484,301,152,179,2022-03-21
317509,JAKARTA TIMUR,CIRACAS,30094,19,29464,413,198,217,2022-03-21
317507,JAKARTA TIMUR,DUREN SAWIT,43069,42,42051,679,297,339,2022-03-21
317101,JAKARTA PUSAT,GAMBIR,12134,9,11909,156,60,69,2022-03-21
317302,JAKARTA BARAT,GROGOL PETAMBURAN,29203,36,28633,331,203,239,2022-03-21
317409,JAKARTA SELATAN,JAGAKARSA,36439,37,35752,446,204,241,2022-03-21
317503,JAKARTA TIMUR,JATINEGARA,27792,20,27213,424,135,155,2022-03-21
317108,JAKARTA PUSAT,JOHAR BARU,12232,7,11992,179,54,61,2022-03-21
317306,JAKARTA BARAT,KALI DERES,26848,30,26323,344,151,181,2022-03-21
317407,JAKARTA SELATAN,KEBAYORAN BARU,19935,21,19543,212,159,180,2022-03-21
317405,JAKARTA SELATAN,KEBAYORAN LAMA,30048,36,29382,400,230,266,2022-03-21
317305,JAKARTA BARAT,KEBON JERUK,34225,53,33502,421,249,302,2022-03-21
317206,JAKARTA UTARA,KELAPA GADING,20848,22,20386,207,233,255,2022-03-21
317103,JAKARTA PUSAT,KEMAYORAN,27280,17,26753,411,99,116,2022-03-21
317308,JAKARTA BARAT,KEMBANGAN,30057,40,29488,331,198,238,2022-03-21
310102,KAB.ADM.KEP.SERIBU,KEP. SERIBU SELATAN,749,1,738,10,0,1,2022-03-21
310101,KAB.ADM.KEP.SERIBU,KEP. SERIBU UTARA,741,0,735,6,0,0,2022-03-21
317203,JAKARTA UTARA,KOJA,23110,25,22664,355,66,91,2022-03-21
317504,JAKARTA TIMUR,KRAMAT JATI,29557,15,28964,429,149,164,2022-03-21
111111,LUAR DKI JAKARTA,LUAR DKI JAKARTA,92441,4,91764,615,58,62,2022-03-21
317508,JAKARTA TIMUR,MAKASAR,24593,24,24132,320,117,141,2022-03-21
317403,JAKARTA SELATAN,MAMPANG PRAPATAN,16439,9,16134,188,108,117,2022-03-21
317501,JAKARTA TIMUR,MATRAMAN,19916,20,19477,309,110,130,2022-03-21
317106,JAKARTA PUSAT,MENTENG,9487,6,9291,132,58,64,2022-03-21
317205,JAKARTA UTARA,PADEMANGAN,17509,14,17224,188,83,97,2022-03-21
317307,JAKARTA BARAT,PALMERAH,21997,9,21511,362,115,124,2022-03-21
317408,JAKARTA SELATAN,PANCORAN,21142,16,20723,246,157,173,2022-03-21
317404,JAKARTA SELATAN,PASAR MINGGU,34326,39,33560,462,265,304,2022-03-21
317505,JAKARTA TIMUR,PASAR REBO,23523,12,23058,347,106,118,2022-03-21
317201,JAKARTA UTARA,PENJARINGAN,29242,51,28681,252,258,309,2022-03-21
317410,JAKARTA SELATAN,PESANGGRAHAN,23206,14,22725,281,186,200,2022-03-21
111111,PROSES UPDATE DATA,PROSES UPDATE DATA,103054,1243,98099,941,2771,4014,2022-03-21
317502,JAKARTA TIMUR,PULO GADUNG,32430,27,31724,459,220,247,2022-03-21
317102,JAKARTA PUSAT,SAWAH BESAR,13636,22,13343,188,83,105,2022-03-21
317104,JAKARTA PUSAT,SENEN,13335,14,13075,177,69,83,2022-03-21
317402,JAKARTA SELATAN,SETIA BUDI,17044,14,16705,198,127,141,2022-03-21
317303,JAKARTA BARAT,TAMAN SARI,13071,23,12809,167,72,95,2022-03-21
317304,JAKARTA BARAT,TAMBORA,20775,27,20377,286,85,112,2022-03-21
317107,JAKARTA PUSAT,TANAH ABANG,15808,17,15481,245,65,82,2022-03-21
317202,JAKARTA UTARA,TANJUNG PRIOK,36611,44,35938,455,174,218,2022-03-21
317401,JAKARTA SELATAN,TEBET,25407,22,24862,314,209,231,2022-03-21
317506,JAKARTA TIMUR,CAKUNG,31293,18,30688,451,136,154,2022-03-22
317105,JAKARTA PUSAT,CEMPAKA PUTIH,14648,9,14385,188,66,75,2022-03-22
317301,JAKARTA BARAT,CENGKARENG,40654,49,39821,612,172,221,2022-03-22
317406,JAKARTA SELATAN,CILANDAK,26699,55,26067,293,284,339,2022-03-22
317204,JAKARTA UTARA,CILINCING,23691,16,23242,365,68,84,2022-03-22
317510,JAKARTA TIMUR,CIPAYUNG,32973,25,32503,301,144,169,2022-03-22
317509,JAKARTA TIMUR,CIRACAS,30116,19,29493,413,191,210,2022-03-22
317507,JAKARTA TIMUR,DUREN SAWIT,43099,40,42098,679,282,322,2022-03-22
317101,JAKARTA PUSAT,GAMBIR,12145,8,11918,156,63,71,2022-03-22
317302,JAKARTA BARAT,GROGOL PETAMBURAN,29224,32,28663,331,198,230,2022-03-22
317409,JAKARTA SELATAN,JAGAKARSA,36464,33,35773,446,212,245,2022-03-22
317503,JAKARTA TIMUR,JATINEGARA,27802,21,27239,424,118,139,2022-03-22
317108,JAKARTA PUSAT,JOHAR BARU,12238,9,12001,179,49,58,2022-03-22
317306,JAKARTA BARAT,KALI DERES,26860,30,26343,344,143,173,2022-03-22
317407,JAKARTA SELATAN,KEBAYORAN BARU,19949,14,19562,212,161,175,2022-03-22
317405,JAKARTA SELATAN,KEBAYORAN LAMA,30074,37,29411,400,226,263,2022-03-22
317305,JAKARTA BARAT,KEBON JERUK,34248,51,33525,421,251,302,2022-03-22
317206,JAKARTA UTARA,KELAPA GADING,20868,18,20407,207,236,254,2022-03-22
317103,JAKARTA PUSAT,KEMAYORAN,27289,21,26764,411,93,114,2022-03-22
317308,JAKARTA BARAT,KEMBANGAN,30083,36,29525,331,191,227,2022-03-22
310102,KAB.ADM.KEP.SERIBU,KEP. SERIBU SELATAN,749,0,738,10,1,1,2022-03-22
310101,KAB.ADM.KEP.SERIBU,KEP. SERIBU UTARA,741,0,735,6,0,0,2022-03-22
317203,JAKARTA UTARA,KOJA,23113,24,22674,355,60,84,2022-03-22
317504,JAKARTA TIMUR,KRAMAT JATI,29571,9,28984,429,149,158,2022-03-22
111111,LUAR DKI JAKARTA,LUAR DKI JAKARTA,92446,2,91766,615,63,65,2022-03-22
317508,JAKARTA TIMUR,MAKASAR,24606,24,24146,320,116,140,2022-03-22
317403,JAKARTA SELATAN,MAMPANG PRAPATAN,16450,4,16142,188,116,120,2022-03-22
317501,JAKARTA TIMUR,MATRAMAN,19927,18,19488,309,112,130,2022-03-22
317106,JAKARTA PUSAT,MENTENG,9492,6,9303,132,51,57,2022-03-22
317205,JAKARTA UTARA,PADEMANGAN,17516,14,17233,188,81,95,2022-03-22
317307,JAKARTA BARAT,PALMERAH,22006,11,21520,362,113,124,2022-03-22
317408,JAKARTA SELATAN,PANCORAN,21151,11,20750,246,144,155,2022-03-22
317404,JAKARTA SELATAN,PASAR MINGGU,34363,34,33600,463,266,300,2022-03-22
317505,JAKARTA TIMUR,PASAR REBO,23531,6,23072,347,106,112,2022-03-22
317201,JAKARTA UTARA,PENJARINGAN,29270,46,28731,252,241,287,2022-03-22
317410,JAKARTA SELATAN,PESANGGRAHAN,23224,16,22745,281,182,198,2022-03-22
111111,PROSES UPDATE DATA,PROSES UPDATE DATA,103408,1203,98643,945,2617,3820,2022-03-22
317502,JAKARTA TIMUR,PULO GADUNG,32455,29,31753,459,214,243,2022-03-22
317102,JAKARTA PUSAT,SAWAH BESAR,13648,21,13357,188,82,103,2022-03-22
317104,JAKARTA PUSAT,SENEN,13342,12,13089,177,64,76,2022-03-22
317402,JAKARTA SELATAN,SETIA BUDI,17054,8,16723,198,125,133,2022-03-22
317303,JAKARTA BARAT,TAMAN SARI,13075,20,12817,167,71,91,2022-03-22
317304,JAKARTA BARAT,TAMBORA,20787,28,20394,287,78,106,2022-03-22
317107,JAKARTA PUSAT,TANAH ABANG,15815,15,15495,245,60,75,2022-03-22
317202,JAKARTA UTARA,TANJUNG PRIOK,36628,41,35956,455,176,217,2022-03-22
317401,JAKARTA SELATAN,TEBET,25424,24,24885,314,201,225,2022-03-22
317506,JAKARTA TIMUR,CAKUNG,31306,18,30698,451,139,157,2022-03-23
317105,JAKARTA PUSAT,CEMPAKA PUTIH,14662,9,14390,188,75,84,2022-03-23
317301,JAKARTA BARAT,CENGKARENG,40676,47,39843,612,174,221,2022-03-23
317406,JAKARTA SELATAN,CILANDAK,26735,51,26107,293,284,335,2022-03-23
317204,JAKARTA UTARA,CILINCING,23703,15,23254,365,69,84,2022-03-23
317510,JAKARTA TIMUR,CIPAYUNG,32999,23,32514,301,161,184,2022-03-23
317509,JAKARTA TIMUR,CIRACAS,30145,18,29502,413,212,230,2022-03-23
317507,JAKARTA TIMUR,DUREN SAWIT,43135,37,42126,679,293,330,2022-03-23
317101,JAKARTA PUSAT,GAMBIR,12151,7,11928,156,60,67,2022-03-23
317302,JAKARTA BARAT,GROGOL PETAMBURAN,29258,30,28682,331,215,245,2022-03-23
317409,JAKARTA SELATAN,JAGAKARSA,36479,31,35799,446,203,234,2022-03-23
317503,JAKARTA TIMUR,JATINEGARA,27812,20,27250,425,117,137,2022-03-23
317108,JAKARTA PUSAT,JOHAR BARU,12240,9,12004,179,48,57,2022-03-23
317306,JAKARTA BARAT,KALI DERES,26883,30,26365,344,144,174,2022-03-23
317407,JAKARTA SELATAN,KEBAYORAN BARU,19978,13,19581,212,172,185,2022-03-23
317405,JAKARTA SELATAN,KEBAYORAN LAMA,30122,33,29446,400,243,276,2022-03-23
317305,JAKARTA BARAT,KEBON JERUK,34277,48,33554,421,254,302,2022-03-23
317206,JAKARTA UTARA,KELAPA GADING,20904,17,20440,207,240,257,2022-03-23
317103,JAKARTA PUSAT,KEMAYORAN,27306,22,26777,411,96,118,2022-03-23
317308,JAKARTA BARAT,KEMBANGAN,30113,35,29540,331,207,242,2022-03-23
310102,KAB.ADM.KEP.SERIBU,KEP. SERIBU SELATAN,748,0,738,10,0,0,2022-03-23
310101,KAB.ADM.KEP.SERIBU,KEP. SERIBU UTARA,741,0,735,6,0,0,2022-03-23
317203,JAKARTA UTARA,KOJA,23122,23,22685,355,59,82,2022-03-23
317504,JAKARTA TIMUR,KRAMAT JATI,29597,9,29001,429,158,167,2022-03-23
111111,LUAR DKI JAKARTA,LUAR DKI JAKARTA,92467,5,91771,615,76,81,2022-03-23
317508,JAKARTA TIMUR,MAKASAR,24624,21,24158,321,124,145,2022-03-23
317403,JAKARTA SELATAN,MAMPANG PRAPATAN,16466,4,16154,188,120,124,2022-03-23
317501,JAKARTA TIMUR,MATRAMAN,19937,17,19506,310,104,121,2022-03-23
317106,JAKARTA PUSAT,MENTENG,9503,3,9310,132,58,61,2022-03-23
317205,JAKARTA UTARA,PADEMANGAN,17522,12,17240,188,82,94,2022-03-23
317307,JAKARTA BARAT,PALMERAH,22033,11,21533,362,127,138,2022-03-23
317408,JAKARTA SELATAN,PANCORAN,21171,10,20768,246,147,157,2022-03-23
317404,JAKARTA SELATAN,PASAR MINGGU,34401,33,33625,463,280,313,2022-03-23
317505,JAKARTA TIMUR,PASAR REBO,23544,5,23078,348,113,118,2022-03-23
317201,JAKARTA UTARA,PENJARINGAN,29297,43,28764,252,238,281,2022-03-23
317410,JAKARTA SELATAN,PESANGGRAHAN,23249,16,22762,281,190,206,2022-03-23
111111,PROSES UPDATE DATA,PROSES UPDATE DATA,103779,1180,99136,945,2518,3698,2022-03-23
317502,JAKARTA TIMUR,PULO GADUNG,32493,26,31791,459,217,243,2022-03-23
317102,JAKARTA PUSAT,SAWAH BESAR,13651,18,13367,188,78,96,2022-03-23
317104,JAKARTA PUSAT,SENEN,13350,12,13095,177,66,78,2022-03-23
317402,JAKARTA SELATAN,SETIA BUDI,17067,5,16743,198,121,126,2022-03-23
317303,JAKARTA BARAT,TAMAN SARI,13067,19,12803,167,78,97,2022-03-23
317304,JAKARTA BARAT,TAMBORA,20802,23,20407,287,85,108,2022-03-23
317107,JAKARTA PUSAT,TANAH ABANG,15823,14,15504,245,60,74,2022-03-23
317202,JAKARTA UTARA,TANJUNG PRIOK,36652,38,35982,455,177,215,2022-03-23
317401,JAKARTA SELATAN,TEBET,25454,22,24897,314,221,243,2022-03-23
317506,JAKARTA TIMUR,CAKUNG,31317,21,30718,451,127,148,2022-03-24
317105,JAKARTA PUSAT,CEMPAKA PUTIH,14676,12,14407,188,69,81,2022-03-24
317301,JAKARTA BARAT,CENGKARENG,40707,52,39881,612,162,214,2022-03-24
317406,JAKARTA SELATAN,CILANDAK,26763,51,26161,293,258,309,2022-03-24
317204,JAKARTA UTARA,CILINCING,23720,16,23271,365,68,84,2022-03-24
317510,JAKARTA TIMUR,CIPAYUNG,33009,20,32553,301,135,155,2022-03-24
317509,JAKARTA TIMUR,CIRACAS,30158,21,29539,413,185,206,2022-03-24
317507,JAKARTA TIMUR,DUREN SAWIT,43158,40,42186,679,253,293,2022-03-24
317101,JAKARTA PUSAT,GAMBIR,12155,6,11940,156,53,59,2022-03-24
317302,JAKARTA BARAT,GROGOL PETAMBURAN,29282,36,28714,331,201,237,2022-03-24
317409,JAKARTA SELATAN,JAGAKARSA,36506,32,35857,446,171,203,2022-03-24
317503,JAKARTA TIMUR,JATINEGARA,27820,21,27284,425,90,111,2022-03-24
317108,JAKARTA PUSAT,JOHAR BARU,12245,10,12017,179,39,49,2022-03-24
317306,JAKARTA BARAT,KALI DERES,26905,42,26402,344,117,159,2022-03-24
317407,JAKARTA SELATAN,KEBAYORAN BARU,19984,13,19606,212,153,166,2022-03-24
317405,JAKARTA SELATAN,KEBAYORAN LAMA,30159,33,29501,400,225,258,2022-03-24
317305,JAKARTA BARAT,KEBON JERUK,34299,54,33607,421,217,271,2022-03-24
317206,JAKARTA UTARA,KELAPA GADING,20925,21,20494,207,203,224,2022-03-24
317103,JAKARTA PUSAT,KEMAYORAN,27322,30,26793,411,88,118,2022-03-24
317308,JAKARTA BARAT,KEMBANGAN,30134,38,29582,331,183,221,2022-03-24
310102,KAB.ADM.KEP.SERIBU,KEP. SERIBU SELATAN,748,0,738,10,0,0,2022-03-24
310101,KAB.ADM.KEP.SERIBU,KEP. SERIBU UTARA,741,0,735,6,0,0,2022-03-24
317203,JAKARTA UTARA,KOJA,23129,22,22698,355,54,76,2022-03-24
317504,JAKARTA TIMUR,KRAMAT JATI,29612,12,29025,430,145,157,2022-03-24
111111,LUAR DKI JAKARTA,LUAR DKI JAKARTA,92482,7,91787,615,73,80,2022-03-24
317508,JAKARTA TIMUR,MAKASAR,24638,23,24182,321,112,135,2022-03-24
317403,JAKARTA SELATAN,MAMPANG PRAPATAN,16476,4,16169,188,115,119,2022-03-24
317501,JAKARTA TIMUR,MATRAMAN,19946,19,19530,310,87,106,2022-03-24
317106,JAKARTA PUSAT,MENTENG,9508,3,9316,132,57,60,2022-03-24
317205,JAKARTA UTARA,PADEMANGAN,17533,15,17249,188,81,96,2022-03-24
317307,JAKARTA BARAT,PALMERAH,22048,15,21555,363,115,130,2022-03-24
317408,JAKARTA SELATAN,PANCORAN,21188,12,20794,246,136,148,2022-03-24
317404,JAKARTA SELATAN,PASAR MINGGU,34433,34,33680,463,256,290,2022-03-24
317505,JAKARTA TIMUR,PASAR REBO,23555,7,23102,348,98,105,2022-03-24
317201,JAKARTA UTARA,PENJARINGAN,29319,42,28815,252,210,252,2022-03-24
317410,JAKARTA SELATAN,PESANGGRAHAN,23267,16,22806,281,164,180,2022-03-24
111111,PROSES UPDATE DATA,PROSES UPDATE DATA,104153,1061,99746,948,2398,3459,2022-03-24
317502,JAKARTA TIMUR,PULO GADUNG,32519,26,31817,459,217,243,2022-03-24
317102,JAKARTA PUSAT,SAWAH BESAR,13655,19,13383,188,65,84,2022-03-24
317104,JAKARTA PUSAT,SENEN,13359,12,13108,177,62,74,2022-03-24
317402,JAKARTA SELATAN,SETIA BUDI,17066,6,16763,198,99,105,2022-03-24
317303,JAKARTA BARAT,TAMAN SARI,13095,16,12844,167,68,84,2022-03-24
317304,JAKARTA BARAT,TAMBORA,20810,24,20427,287,72,96,2022-03-24
317107,JAKARTA PUSAT,TANAH ABANG,15835,15,15514,245,61,76,2022-03-24
317202,JAKARTA UTARA,TANJUNG PRIOK,36670,37,36020,455,158,195,2022-03-24
317401,JAKARTA SELATAN,TEBET,25482,28,24942,314,198,226,2022-03-24
317506,JAKARTA TIMUR,CAKUNG,31329,21,30747,451,110,131,2022-03-25
317105,JAKARTA PUSAT,CEMPAKA PUTIH,14683,12,14418,188,65,77,2022-03-25
317301,JAKARTA BARAT,CENGKARENG,40722,51,39908,612,151,202,2022-03-25
317406,JAKARTA SELATAN,CILANDAK,26790,46,26211,293,240,286,2022-03-25
317204,JAKARTA UTARA,CILINCING,23728,13,23280,365,70,83,2022-03-25
317510,JAKARTA TIMUR,CIPAYUNG,33033,19,32586,301,127,146,2022-03-25
317509,JAKARTA TIMUR,CIRACAS,30183,21,29574,413,175,196,2022-03-25
317507,JAKARTA TIMUR,DUREN SAWIT,43186,35,42247,679,225,260,2022-03-25
317101,JAKARTA PUSAT,GAMBIR,12164,8,11948,156,52,60,2022-03-25
317302,JAKARTA BARAT,GROGOL PETAMBURAN,29310,37,28750,331,192,229,2022-03-25
317409,JAKARTA SELATAN,JAGAKARSA,36522,27,35889,448,158,185,2022-03-25
317503,JAKARTA TIMUR,JATINEGARA,27834,22,27298,425,89,111,2022-03-25
317108,JAKARTA PUSAT,JOHAR BARU,12254,10,12025,179,40,50,2022-03-25
317306,JAKARTA BARAT,KALI DERES,26922,40,26421,344,117,157,2022-03-25
317407,JAKARTA SELATAN,KEBAYORAN BARU,19993,12,19626,212,143,155,2022-03-25
317405,JAKARTA SELATAN,KEBAYORAN LAMA,30197,30,29535,400,232,262,2022-03-25
317305,JAKARTA BARAT,KEBON JERUK,34329,50,33656,421,202,252,2022-03-25
317206,JAKARTA UTARA,KELAPA GADING,20949,22,20526,207,194,216,2022-03-25
317103,JAKARTA PUSAT,KEMAYORAN,27331,29,26814,411,77,106,2022-03-25
317308,JAKARTA BARAT,KEMBANGAN,30143,38,29619,332,154,192,2022-03-25
310102,KAB.ADM.KEP.SERIBU,KEP. SERIBU SELATAN,748,0,738,10,0,0,2022-03-25
310101,KAB.ADM.KEP.SERIBU,KEP. SERIBU UTARA,741,0,735,6,0,0,2022-03-25
317203,JAKARTA UTARA,KOJA,23138,21,22711,355,51,72,2022-03-25
317504,JAKARTA TIMUR,KRAMAT JATI,29624,11,29053,430,130,141,2022-03-25
111111,LUAR DKI JAKARTA,LUAR DKI JAKARTA,92487,8,91801,615,63,71,2022-03-25
317508,JAKARTA TIMUR,MAKASAR,24656,22,24204,321,109,131,2022-03-25
317403,JAKARTA SELATAN,MAMPANG PRAPATAN,16485,3,16188,188,106,109,2022-03-25
317501,JAKARTA TIMUR,MATRAMAN,19965,18,19545,310,92,110,2022-03-25
317106,JAKARTA PUSAT,MENTENG,9511,4,9322,132,53,57,2022-03-25
317205,JAKARTA UTARA,PADEMANGAN,17553,17,17271,188,77,94,2022-03-25
317307,JAKARTA BARAT,PALMERAH,22058,14,21574,363,107,121,2022-03-25
317408,JAKARTA SELATAN,PANCORAN,21207,12,20808,246,141,153,2022-03-25
317404,JAKARTA SELATAN,PASAR MINGGU,34456,31,33732,463,230,261,2022-03-25
317505,JAKARTA TIMUR,PASAR REBO,23558,6,23124,348,80,86,2022-03-25
317201,JAKARTA UTARA,PENJARINGAN,29341,43,28861,253,184,227,2022-03-25
317410,JAKARTA SELATAN,PESANGGRAHAN,23290,16,22829,282,163,179,2022-03-25
111111,PROSES UPDATE DATA,PROSES UPDATE DATA,104397,986,100345,948,2118,3104,2022-03-25
317502,JAKARTA TIMUR,PULO GADUNG,32536,25,31844,459,208,233,2022-03-25
317102,JAKARTA PUSAT,SAWAH BESAR,13661,19,13396,188,58,77,2022-03-25
317104,JAKARTA PUSAT,SENEN,13363,13,13112,177,61,74,2022-03-25
317402,JAKARTA SELATAN,SETIA BUDI,17074,6,16784,198,86,92,2022-03-25
317303,JAKARTA BARAT,TAMAN SARI,13102,14,12859,167,62,76,2022-03-25
317304,JAKARTA BARAT,TAMBORA,20814,22,20439,287,66,88,2022-03-25
317107,JAKARTA PUSAT,TANAH ABANG,15843,14,15523,245,61,75,2022-03-25
317202,JAKARTA UTARA,TANJUNG PRIOK,36695,36,36069,455,135,171,2022-03-25
317401,JAKARTA SELATAN,TEBET,25496,27,24964,314,191,218,2022-03-25
317506,JAKARTA TIMUR,CAKUNG,31334,18,30770,452,94,112,2022-03-26
317105,JAKARTA PUSAT,CEMPAKA PUTIH,14695,12,14423,188,72,84,2022-03-26
317301,JAKARTA BARAT,CENGKARENG,40744,53,39941,613,137,190,2022-03-26
317406,JAKARTA SELATAN,CILANDAK,26807,50,26245,293,219,269,2022-03-26
317204,JAKARTA UTARA,CILINCING,23737,14,23297,365,61,75,2022-03-26
317510,JAKARTA TIMUR,CIPAYUNG,33056,16,32604,302,134,150,2022-03-26
317509,JAKARTA TIMUR,CIRACAS,30193,22,29599,413,159,181,2022-03-26
317507,JAKARTA TIMUR,DUREN SAWIT,43201,36,42292,679,194,230,2022-03-26
317101,JAKARTA PUSAT,GAMBIR,12168,9,11959,156,44,53,2022-03-26
317302,JAKARTA BARAT,GROGOL PETAMBURAN,29323,32,28790,331,170,202,2022-03-26
317409,JAKARTA SELATAN,JAGAKARSA,36537,27,35908,448,154,181,2022-03-26
317503,JAKARTA TIMUR,JATINEGARA,27839,21,27317,425,76,97,2022-03-26
317108,JAKARTA PUSAT,JOHAR BARU,12260,9,12033,179,39,48,2022-03-26
317306,JAKARTA BARAT,KALI DERES,26936,40,26439,344,113,153,2022-03-26
317407,JAKARTA SELATAN,KEBAYORAN BARU,20015,15,19645,212,143,158,2022-03-26
317405,JAKARTA SELATAN,KEBAYORAN LAMA,30222,29,29574,400,219,248,2022-03-26
317305,JAKARTA BARAT,KEBON JERUK,34357,55,33705,421,176,231,2022-03-26
317206,JAKARTA UTARA,KELAPA GADING,20969,22,20556,207,184,206,2022-03-26
317103,JAKARTA PUSAT,KEMAYORAN,27343,26,26828,411,78,104,2022-03-26
317308,JAKARTA BARAT,KEMBANGAN,30169,39,29653,332,145,184,2022-03-26
310102,KAB.ADM.KEP.SERIBU,KEP. SERIBU SELATAN,748,0,738,10,0,0,2022-03-26
310101,KAB.ADM.KEP.SERIBU,KEP. SERIBU UTARA,741,0,735,6,0,0,2022-03-26
317203,JAKARTA UTARA,KOJA,23146,16,22718,355,57,73,2022-03-26
317504,JAKARTA TIMUR,KRAMAT JATI,29637,12,29074,430,121,133,2022-03-26
111111,LUAR DKI JAKARTA,LUAR DKI JAKARTA,92630,60,91814,615,141,201,2022-03-26
317508,JAKARTA TIMUR,MAKASAR,24669,24,24224,322,99,123,2022-03-26
317403,JAKARTA SELATAN,MAMPANG PRAPATAN,16492,3,16202,188,99,102,2022-03-26
317501,JAKARTA TIMUR,MATRAMAN,19971,20,19572,310,69,89,2022-03-26
317106,JAKARTA PUSAT,MENTENG,9512,5,9332,132,43,48,2022-03-26
317205,JAKARTA UTARA,PADEMANGAN,17558,21,17286,188,63,84,2022-03-26
317307,JAKARTA BARAT,PALMERAH,22071,18,21592,363,98,116,2022-03-26
317408,JAKARTA SELATAN,PANCORAN,21224,12,20835,247,130,142,2022-03-26
317404,JAKARTA SELATAN,PASAR MINGGU,34476,36,33767,463,210,246,2022-03-26
317505,JAKARTA TIMUR,PASAR REBO,23569,9,23141,348,71,80,2022-03-26
317201,JAKARTA UTARA,PENJARINGAN,29362,36,28903,253,170,206,2022-03-26
317410,JAKARTA SELATAN,PESANGGRAHAN,23307,16,22864,282,145,161,2022-03-26
111111,PROSES UPDATE DATA,PROSES UPDATE DATA,104489,809,100775,948,1957,2766,2022-03-26
317502,JAKARTA TIMUR,PULO GADUNG,32566,25,31875,459,207,232,2022-03-26
317102,JAKARTA PUSAT,SAWAH BESAR,13668,18,13414,188,48,66,2022-03-26
317104,JAKARTA PUSAT,SENEN,13368,14,13131,177,46,60,2022-03-26
317402,JAKARTA SELATAN,SETIA BUDI,17084,6,16800,198,80,86,2022-03-26
317303,JAKARTA BARAT,TAMAN SARI,13105,12,12872,167,54,66,2022-03-26
317304,JAKARTA BARAT,TAMBORA,20818,19,20452,287,60,79,2022-03-26
317107,JAKARTA PUSAT,TANAH ABANG,15850,13,15538,245,54,67,2022-03-26
317202,JAKARTA UTARA,TANJUNG PRIOK,36719,31,36107,455,126,157,2022-03-26
317401,JAKARTA SELATAN,TEBET,25512,26,24993,314,179,205,2022-03-26
317506,JAKARTA TIMUR,CAKUNG,31336,18,30795,452,71,89,2022-03-27
317105,JAKARTA PUSAT,CEMPAKA PUTIH,14701,12,14431,188,70,82,2022-03-27
317301,JAKARTA BARAT,CENGKARENG,40761,56,39971,613,121,177,2022-03-27
317406,JAKARTA SELATAN,CILANDAK,26827,50,26287,293,197,247,2022-03-27
317204,JAKARTA UTARA,CILINCING,23739,14,23305,365,55,69,2022-03-27
317510,JAKARTA TIMUR,CIPAYUNG,33068,17,32625,302,124,141,2022-03-27
317509,JAKARTA TIMUR,CIRACAS,30214,23,29632,413,146,169,2022-03-27
317507,JAKARTA TIMUR,DUREN SAWIT,43222,36,42322,679,185,221,2022-03-27
317101,JAKARTA PUSAT,GAMBIR,12175,8,11970,156,41,49,2022-03-27
317302,JAKARTA BARAT,GROGOL PETAMBURAN,29338,31,28826,331,150,181,2022-03-27
317409,JAKARTA SELATAN,JAGAKARSA,36558,27,35940,448,143,170,2022-03-27
317503,JAKARTA TIMUR,JATINEGARA,27844,19,27328,425,72,91,2022-03-27
317108,JAKARTA PUSAT,JOHAR BARU,12263,9,12039,179,36,45,2022-03-27
317306,JAKARTA BARAT,KALI DERES,26941,38,26463,344,96,134,2022-03-27
317407,JAKARTA SELATAN,KEBAYORAN BARU,20020,16,19672,212,120,136,2022-03-27
317405,JAKARTA SELATAN,KEBAYORAN LAMA,30237,28,29604,403,202,230,2022-03-27
317305,JAKARTA BARAT,KEBON JERUK,34373,50,33748,421,154,204,2022-03-27
317206,JAKARTA UTARA,KELAPA GADING,20984,20,20601,207,156,176,2022-03-27
317103,JAKARTA PUSAT,KEMAYORAN,27349,26,26833,411,79,105,2022-03-27
317308,JAKARTA BARAT,KEMBANGAN,30187,40,29676,332,139,179,2022-03-27
310102,KAB.ADM.KEP.SERIBU,KEP. SERIBU SELATAN,748,0,738,10,0,0,2022-03-27
310101,KAB.ADM.KEP.SERIBU,KEP. SERIBU UTARA,741,0,735,6,0,0,2022-03-27
317203,JAKARTA UTARA,KOJA,23149,15,22728,355,51,66,2022-03-27
317504,JAKARTA TIMUR,KRAMAT JATI,29643,12,29101,430,100,112,2022-03-27
111111,LUAR DKI JAKARTA,LUAR DKI JAKARTA,92744,105,91829,615,195,300,2022-03-27
317508,JAKARTA TIMUR,MAKASAR,24678,21,24245,322,90,111,2022-03-27
317403,JAKARTA SELATAN,MAMPANG PRAPATAN,16490,3,16214,188,85,88,2022-03-27
317501,JAKARTA TIMUR,MATRAMAN,19977,18,19590,310,59,77,2022-03-27
317106,JAKARTA PUSAT,MENTENG,9518,6,9339,132,41,47,2022-03-27
317205,JAKARTA UTARA,PADEMANGAN,17560,18,17290,189,63,81,2022-03-27
317307,JAKARTA BARAT,PALMERAH,22071,17,21606,363,85,102,2022-03-27
317408,JAKARTA SELATAN,PANCORAN,21234,12,20857,247,118,130,2022-03-27
317404,JAKARTA SELATAN,PASAR MINGGU,34502,37,33797,463,205,242,2022-03-27
317505,JAKARTA TIMUR,PASAR REBO,23576,9,23156,348,63,72,2022-03-27
317201,JAKARTA UTARA,PENJARINGAN,29381,38,28941,253,149,187,2022-03-27
317410,JAKARTA SELATAN,PESANGGRAHAN,23313,16,22888,282,127,143,2022-03-27
111111,PROSES UPDATE DATA,PROSES UPDATE DATA,104568,729,101259,949,1631,2360,2022-03-27
317502,JAKARTA TIMUR,PULO GADUNG,32577,25,31908,459,185,210,2022-03-27
317102,JAKARTA PUSAT,SAWAH BESAR,13674,20,13426,188,40,60,2022-03-27
317104,JAKARTA PUSAT,SENEN,13372,14,13137,177,44,58,2022-03-27
317402,JAKARTA SELATAN,SETIA BUDI,17084,6,16816,198,64,70,2022-03-27
317303,JAKARTA BARAT,TAMAN SARI,13107,12,12885,167,43,55,2022-03-27
317304,JAKARTA BARAT,TAMBORA,20826,21,20462,287,56,77,2022-03-27
317107,JAKARTA PUSAT,TANAH ABANG,15861,12,15544,245,60,72,2022-03-27
317202,JAKARTA UTARA,TANJUNG PRIOK,36737,33,36125,455,124,157,2022-03-27
317401,JAKARTA SELATAN,TEBET,25523,25,25033,314,151,176,2022-03-27
317506,JAKARTA TIMUR,CAKUNG,31343,18,30814,452,59,77,2022-03-28
317105,JAKARTA PUSAT,CEMPAKA PUTIH,14699,8,14441,188,62,70,2022-03-28
317301,JAKARTA BARAT,CENGKARENG,40774,59,39998,614,103,162,2022-03-28
317406,JAKARTA SELATAN,CILANDAK,26852,45,26337,294,176,221,2022-03-28
317204,JAKARTA UTARA,CILINCING,23745,17,23313,365,50,67,2022-03-28
317510,JAKARTA TIMUR,CIPAYUNG,33076,10,32651,303,112,122,2022-03-28
317509,JAKARTA TIMUR,CIRACAS,30231,19,29668,414,130,149,2022-03-28
317507,JAKARTA TIMUR,DUREN SAWIT,43244,38,42362,680,164,202,2022-03-28
317101,JAKARTA PUSAT,GAMBIR,12176,8,11974,156,38,46,2022-03-28
317302,JAKARTA BARAT,GROGOL PETAMBURAN,29344,27,28845,332,140,167,2022-03-28
317409,JAKARTA SELATAN,JAGAKARSA,36574,26,35967,449,132,158,2022-03-28
317503,JAKARTA TIMUR,JATINEGARA,27852,17,27342,426,67,84,2022-03-28
317108,JAKARTA PUSAT,JOHAR BARU,12264,8,12047,179,30,38,2022-03-28
317306,JAKARTA BARAT,KALI DERES,26950,37,26488,344,81,118,2022-03-28
317407,JAKARTA SELATAN,KEBAYORAN BARU,20020,15,19691,212,102,117,2022-03-28
317405,JAKARTA SELATAN,KEBAYORAN LAMA,30252,28,29631,404,189,217,2022-03-28
317305,JAKARTA BARAT,KEBON JERUK,34384,52,33774,421,137,189,2022-03-28
317206,JAKARTA UTARA,KELAPA GADING,20993,22,20616,207,148,170,2022-03-28
317103,JAKARTA PUSAT,KEMAYORAN,27355,23,26858,411,63,86,2022-03-28
317308,JAKARTA BARAT,KEMBANGAN,30195,36,29704,332,123,159,2022-03-28
310102,KAB.ADM.KEP.SERIBU,KEP. SERIBU SELATAN,748,0,738,10,0,0,2022-03-28
310101,KAB.ADM.KEP.SERIBU,KEP. SERIBU UTARA,741,0,735,6,0,0,2022-03-28
317203,JAKARTA UTARA,KOJA,23149,12,22739,355,43,55,2022-03-28
317504,JAKARTA TIMUR,KRAMAT JATI,29653,17,29120,430,86,103,2022-03-28
111111,LUAR DKI JAKARTA,LUAR DKI JAKARTA,92870,116,91843,615,296,412,2022-03-28
317508,JAKARTA TIMUR,MAKASAR,24678,19,24254,322,83,102,2022-03-28
317403,JAKARTA SELATAN,MAMPANG PRAPATAN,16499,7,16238,188,66,73,2022-03-28
317501,JAKARTA TIMUR,MATRAMAN,19981,17,19604,310,50,67,2022-03-28
317106,JAKARTA PUSAT,MENTENG,9518,6,9349,132,31,37,2022-03-28
317205,JAKARTA UTARA,PADEMANGAN,17567,18,17303,189,57,75,2022-03-28
317307,JAKARTA BARAT,PALMERAH,22082,19,21632,363,68,87,2022-03-28
317408,JAKARTA SELATAN,PANCORAN,21242,15,20879,247,101,116,2022-03-28
317404,JAKARTA SELATAN,PASAR MINGGU,34524,40,33834,463,187,227,2022-03-28
317505,JAKARTA TIMUR,PASAR REBO,23580,10,23169,348,53,63,2022-03-28
317201,JAKARTA UTARA,PENJARINGAN,29390,36,28964,254,136,172,2022-03-28
317410,JAKARTA SELATAN,PESANGGRAHAN,23316,14,22914,282,106,120,2022-03-28
111111,PROSES UPDATE DATA,PROSES UPDATE DATA,104666,545,101701,949,1471,2016,2022-03-28
317502,JAKARTA TIMUR,PULO GADUNG,32606,27,31939,459,181,208,2022-03-28
317102,JAKARTA PUSAT,SAWAH BESAR,13677,18,13434,188,37,55,2022-03-28
317104,JAKARTA PUSAT,SENEN,13375,15,13143,177,40,55,2022-03-28
317402,JAKARTA SELATAN,SETIA BUDI,17089,5,16829,199,56,61,2022-03-28
317303,JAKARTA BARAT,TAMAN SARI,13107,9,12896,167,35,44,2022-03-28
317304,JAKARTA BARAT,TAMBORA,20830,23,20471,288,48,71,2022-03-28
317107,JAKARTA PUSAT,TANAH ABANG,15863,10,15555,245,53,63,2022-03-28
317202,JAKARTA UTARA,TANJUNG PRIOK,36753,32,36136,455,130,162,2022-03-28
317401,JAKARTA SELATAN,TEBET,25537,21,25069,314,133,154,2022-03-28
317506,JAKARTA TIMUR,CAKUNG,31354,15,30819,452,68,83,2022-03-29
317105,JAKARTA PUSAT,CEMPAKA PUTIH,14707,5,14447,188,67,72,2022-03-29
317301,JAKARTA BARAT,CENGKARENG,40782,43,40013,615,111,154,2022-03-29
317406,JAKARTA SELATAN,CILANDAK,26878,33,26361,294,190,223,2022-03-29
317204,JAKARTA UTARA,CILINCING,23751,11,23319,365,56,67,2022-03-29
317510,JAKARTA TIMUR,CIPAYUNG,33089,16,32655,303,115,131,2022-03-29
317509,JAKARTA TIMUR,CIRACAS,30239,16,29682,414,127,143,2022-03-29
317507,JAKARTA TIMUR,DUREN SAWIT,43263,26,42387,680,170,196,2022-03-29
317101,JAKARTA PUSAT,GAMBIR,12178,6,11978,156,38,44,2022-03-29
317302,JAKARTA BARAT,GROGOL PETAMBURAN,29363,32,28866,332,133,165,2022-03-29
317409,JAKARTA SELATAN,JAGAKARSA,36592,25,35986,449,132,157,2022-03-29
317503,JAKARTA TIMUR,JATINEGARA,27867,16,27351,426,74,90,2022-03-29
317108,JAKARTA PUSAT,JOHAR BARU,12265,5,12051,179,30,35,2022-03-29
317306,JAKARTA BARAT,KALI DERES,26951,27,26488,344,92,119,2022-03-29
317407,JAKARTA SELATAN,KEBAYORAN BARU,20042,12,19697,212,121,133,2022-03-29
317405,JAKARTA SELATAN,KEBAYORAN LAMA,30274,26,29650,404,194,220,2022-03-29
317305,JAKARTA BARAT,KEBON JERUK,34395,41,33800,422,132,173,2022-03-29
317206,JAKARTA UTARA,KELAPA GADING,21021,22,20632,208,159,181,2022-03-29
317103,JAKARTA PUSAT,KEMAYORAN,27361,16,26870,411,64,80,2022-03-29
317308,JAKARTA BARAT,KEMBANGAN,30210,25,29721,332,132,157,2022-03-29
310102,KAB.ADM.KEP.SERIBU,KEP. SERIBU SELATAN,748,0,738,10,0,0,2022-03-29
310101,KAB.ADM.KEP.SERIBU,KEP. SERIBU UTARA,741,0,735,6,0,0,2022-03-29
317203,JAKARTA UTARA,KOJA,23154,6,22750,355,43,49,2022-03-29
317504,JAKARTA TIMUR,KRAMAT JATI,29660,15,29125,431,89,104,2022-03-29
111111,LUAR DKI JAKARTA,LUAR DKI JAKARTA,95346,300,93393,618,1035,1335,2022-03-29
317508,JAKARTA TIMUR,MAKASAR,24688,15,24269,322,82,97,2022-03-29
317403,JAKARTA SELATAN,MAMPANG PRAPATAN,16499,5,16243,188,63,68,2022-03-29
317501,JAKARTA TIMUR,MATRAMAN,19984,12,19609,310,53,65,2022-03-29
317106,JAKARTA PUSAT,MENTENG,9523,5,9355,132,31,36,2022-03-29
317205,JAKARTA UTARA,PADEMANGAN,17578,17,17311,189,61,78,2022-03-29
317307,JAKARTA BARAT,PALMERAH,22081,13,21635,363,70,83,2022-03-29
317408,JAKARTA SELATAN,PANCORAN,21247,16,20888,247,96,112,2022-03-29
317404,JAKARTA SELATAN,PASAR MINGGU,34539,31,33859,464,185,216,2022-03-29
317505,JAKARTA TIMUR,PASAR REBO,23586,11,23172,348,55,66,2022-03-29
317201,JAKARTA UTARA,PENJARINGAN,29407,25,28982,254,146,171,2022-03-29
317410,JAKARTA SELATAN,PESANGGRAHAN,23326,12,22923,282,109,121,2022-03-29
111111,PROSES UPDATE DATA,PROSES UPDATE DATA,102500,279,100567,949,705,984,2022-03-29
317502,JAKARTA TIMUR,PULO GADUNG,32621,26,31956,459,180,206,2022-03-29
317102,JAKARTA PUSAT,SAWAH BESAR,13684,16,13439,188,41,57,2022-03-29
317104,JAKARTA PUSAT,SENEN,13383,8,13155,177,43,51,2022-03-29
317402,JAKARTA SELATAN,SETIA BUDI,17094,7,16835,199,53,60,2022-03-29
317303,JAKARTA BARAT,TAMAN SARI,13107,4,12902,167,34,38,2022-03-29
317304,JAKARTA BARAT,TAMBORA,20833,16,20488,288,41,57,2022-03-29
317107,JAKARTA PUSAT,TANAH ABANG,15869,12,15561,246,50,62,2022-03-29
317202,JAKARTA UTARA,TANJUNG PRIOK,36778,24,36156,455,143,167,2022-03-29
317401,JAKARTA SELATAN,TEBET,25548,20,25082,315,131,151,2022-03-29
